Date_hour,casual_riders_count,member_riders_count,casual_rider_duration,member_rider_duration,count,travel_time,day_of_week,IsWeekend,IsHoliday,Temp(c),rel_humidity,wspd,pres,weather_condition
1/1/2022 0:00,28,97,554672,96509,125,651181,SATURDAY,1,1,6.7,89,7.6,1014.9,Cloudy
1/1/2022 1:00,31,61,46276,58472,92,104748,SATURDAY,1,1,6.7,89,7.6,1014.7,Cloudy
1/1/2022 2:00,32,41,377839,45191,73,423030,SATURDAY,1,1,6.7,89,7.6,1014.7,Cloudy
1/1/2022 3:00,54,41,2537734,37167,95,2574901,SATURDAY,1,1,6.7,96,5.4,1014.2,Cloudy
1/1/2022 4:00,49,42,911448,43178,91,954626,SATURDAY,1,1,7.2,93,5.4,1014.4,Cloudy
1/1/2022 5:00,62,62,3414185,56165,124,3470350,SATURDAY,1,1,7.8,93,0,1014.5,Cloudy
1/1/2022 6:00,121,53,2007480,56015,174,2063495,SATURDAY,1,1,7.2,97,5.4,1014.1,Cloudy
1/1/2022 7:00,68,41,465738,41134,109,506872,SATURDAY,1,1,7.2,97,7.6,1014.2,Cloudy
1/1/2022 8:00,29,14,497094,10648,43,507742,SATURDAY,1,1,7.2,97,0,1014.1,Cloudy
1/1/2022 9:00,9,4,10798,3163,13,13961,SATURDAY,1,1,6.7,100,7.6,1013.6,Cloudy
1/1/2022 10:00,9,7,54816,4826,16,59642,SATURDAY,1,1,6.7,100,9.4,1013.1,Cloudy
1/1/2022 11:00,8,23,299642,18872,31,318514,SATURDAY,1,1,7.2,100,9.4,1012.5,Cloudy
1/1/2022 12:00,6,26,17664,22487,32,40151,SATURDAY,1,1,6.7,100,5.4,1012.1,Cloudy
1/1/2022 13:00,5,35,17083,33407,40,50490,SATURDAY,1,1,7.8,100,7.6,1012.3,Cloudy
1/1/2022 14:00,12,39,26548,29423,51,55971,SATURDAY,1,1,7.8,100,11.2,1011.3,Cloudy
1/1/2022 15:00,23,58,63973,37372,81,101345,SATURDAY,1,1,7.8,100,7.6,1011.5,Cloudy
1/1/2022 16:00,16,64,31265,62492,80,93757,SATURDAY,1,1,7.8,100,7.6,1010.2,Rain
1/1/2022 17:00,29,50,42844,32514,79,75358,SATURDAY,1,1,7.8,100,5.4,1008.7,Rain
1/1/2022 18:00,22,72,29266,71432,94,100698,SATURDAY,1,1,8.3,97,5.4,1008,Cloudy
1/1/2022 19:00,38,84,70711,76327,122,147038,SATURDAY,1,1,8.9,100,0,1006,Cloudy
1/1/2022 20:00,55,107,131032,115862,162,246894,SATURDAY,1,1,9.4,100,0,1006.4,Cloudy
1/1/2022 21:00,45,101,255198,90554,146,345752,SATURDAY,1,1,10.6,96,0,1005.9,Cloudy
1/1/2022 22:00,38,89,82485,220272,127,302757,SATURDAY,1,1,10.6,100,5.4,1007,Cloudy
1/1/2022 23:00,40,83,70952,67655,123,138607,SATURDAY,1,1,10,100,0,1007,Cloudy
1/2/2022 0:00,30,73,49029,56849,103,105878,SUNDAY,1,0,9.4,100,5.4,1006.8,Cloudy
1/2/2022 1:00,10,51,17018,39684,61,56702,SUNDAY,1,0,9.4,97,5.4,1006.8,Rain
1/2/2022 2:00,14,50,135888,24375,64,160263,SUNDAY,1,0,8.9,96,7.6,1005.8,Rain
1/2/2022 3:00,12,30,144967,24655,42,169622,SUNDAY,1,0,8.9,96,0,1005.2,Rain
1/2/2022 4:00,3,25,211414,24140,28,235554,SUNDAY,1,0,7.8,96,5.4,1004,Rain
1/2/2022 5:00,2,11,3491,4680,13,8171,SUNDAY,1,0,7.8,96,5.4,1003.8,Rain
1/2/2022 6:00,8,10,568111,10176,18,578287,SUNDAY,1,0,7.2,100,7.6,1002.7,Rain
1/2/2022 7:00,3,5,56321,4712,8,61033,SUNDAY,1,0,7.2,100,14.8,1001,Cloudy
1/2/2022 8:00,0,1,0,2969,1,2969,SUNDAY,1,0,7.2,100,13,1001.4,Cloudy
1/2/2022 9:00,1,1,721,733,2,1454,SUNDAY,1,0,7.2,97,11.2,1001.8,Rain
1/2/2022 10:00,3,13,3214,6703,16,9917,SUNDAY,1,0,6.7,96,9.4,1000.5,Cloudy
1/2/2022 11:00,1,15,225,9118,16,9343,SUNDAY,1,0,6.7,96,7.6,1000.8,Rain
1/2/2022 12:00,3,23,1978,15784,26,17762,SUNDAY,1,0,6.7,93,5.4,1001.1,Cloudy
1/2/2022 13:00,1,37,433,30035,38,30468,SUNDAY,1,0,6.7,96,7.6,1000.7,Cloudy
1/2/2022 14:00,7,60,8153,47337,67,55490,SUNDAY,1,0,6.7,96,5.4,1001.2,Cloudy
1/2/2022 15:00,17,80,47690,61059,97,108749,SUNDAY,1,0,6.7,96,11.2,1001.3,Cloudy
1/2/2022 16:00,39,116,63064,97475,155,160539,SUNDAY,1,0,7.2,97,7.6,1000.9,Cloudy
1/2/2022 17:00,34,133,45831,106680,167,152511,SUNDAY,1,0,7.8,93,13,1000.7,Cloudy
1/2/2022 18:00,42,145,55653,111629,187,167282,SUNDAY,1,0,7.2,97,14.8,1001,Cloudy
1/2/2022 19:00,52,149,67905,127127,201,195032,SUNDAY,1,0,7.2,97,9.4,1000.8,Cloudy
1/2/2022 20:00,35,128,146331,112313,163,258644,SUNDAY,1,0,7.2,93,13,1002.3,Cloudy
1/2/2022 21:00,43,143,74881,116265,186,191146,SUNDAY,1,0,7.2,90,14.8,1003.5,Cloudy
1/2/2022 22:00,37,110,46342,85541,147,131883,SUNDAY,1,0,6.1,86,20.5,1004.5,Cloudy
1/2/2022 23:00,23,111,24399,94201,134,118600,SUNDAY,1,0,5.6,82,16.6,1005.9,Cloudy
1/3/2022 0:00,20,93,43640,66861,113,110501,MONDAY,0,0,5,79,25.9,1008.2,Cloudy
1/3/2022 1:00,14,71,48130,53641,85,101771,MONDAY,0,0,3.3,76,27.7,1010.2,Cloudy
1/3/2022 2:00,11,71,7870,38481,82,46351,MONDAY,0,0,2.8,76,27.7,1011.2,Cloudy
1/3/2022 3:00,6,31,10032,18939,37,28971,MONDAY,0,0,1.7,66,22.3,1012.2,Cloudy
1/3/2022 4:00,7,15,4809,9562,22,14371,MONDAY,0,0,1.1,67,18.4,1013.1,Cloudy
1/3/2022 5:00,1,6,410,2715,7,3125,MONDAY,0,0,0.6,66,22.3,1013.9,Cloudy
1/3/2022 6:00,2,6,2359,5458,8,7817,MONDAY,0,0,0,66,20.5,1015.1,Cloudy
1/3/2022 7:00,0,3,0,3404,3,3404,MONDAY,0,0,-0.6,58,25.9,1016.6,Snow
1/3/2022 8:00,0,3,0,624,3,624,MONDAY,0,0,-1.1,51,25.9,1018,Cloudy
1/3/2022 9:00,3,3,2729,2410,6,5139,MONDAY,0,0,-1.7,51,29.5,1019,Cloudy
1/3/2022 10:00,3,28,2476,17174,31,19650,MONDAY,0,0,-2.2,51,24.1,1019.4,Cloudy
1/3/2022 11:00,2,60,3780,81997,62,85777,MONDAY,0,0,-2.8,48,27.7,1019.1,Cloudy
1/3/2022 12:00,6,121,3420,100124,127,103544,MONDAY,0,0,-3.3,48,20.5,1021,Cloudy
1/3/2022 13:00,15,197,11151,144491,212,155642,MONDAY,0,0,-3.3,46,18.4,1021.6,Cloudy
1/3/2022 14:00,11,148,10974,96519,159,107493,MONDAY,0,0,-3.9,48,20.5,1022.1,Cloudy
1/3/2022 15:00,12,132,13819,78272,144,92091,MONDAY,0,0,-3.3,48,20.5,1022.2,Cloudy
1/3/2022 16:00,9,115,10702,80584,124,91286,MONDAY,0,0,-3.3,50,18.4,1021.4,Cloudy
1/3/2022 17:00,23,143,572510,101357,166,673867,MONDAY,0,0,-3.3,50,18.4,1020.6,Cloudy
1/3/2022 18:00,13,145,15891,90113,158,106004,MONDAY,0,0,-3.3,57,24.1,1019,Cloudy
1/3/2022 19:00,12,167,14889,127184,179,142073,MONDAY,0,0,-2.8,60,20.5,1019.1,Cloudy
1/3/2022 20:00,20,167,23460,106896,187,130356,MONDAY,0,0,-2.8,58,22.3,1019,Cloudy
1/3/2022 21:00,25,195,25475,131163,220,156638,MONDAY,0,0,-2.8,55,24.1,1018.1,Cloudy
1/3/2022 22:00,24,258,30214,277462,282,307676,MONDAY,0,0,-3.3,52,22.3,1018.5,Cloudy
1/3/2022 23:00,28,179,1303845,108689,207,1412534,MONDAY,0,0,-3.9,48,25.9,1018.9,Cloudy
1/4/2022 0:00,16,129,16954,77678,145,94632,TUESDAY,0,0,-3.9,48,18.4,1019.3,Cloudy
1/4/2022 1:00,4,59,7529,38739,63,46268,TUESDAY,0,0,-3.9,46,22.3,1019.6,Cloudy
1/4/2022 2:00,10,54,9729,123003,64,132732,TUESDAY,0,0,-4.4,43,27.7,1020.2,Cloudy
1/4/2022 3:00,5,30,3144,63675,35,66819,TUESDAY,0,0,-4.4,46,22.3,1020.8,Cloudy
1/4/2022 4:00,0,15,0,8873,15,8873,TUESDAY,0,0,-5,52,25.9,1021.5,Fair
1/4/2022 5:00,2,11,3430,5999,13,9429,TUESDAY,0,0,-6.1,54,14.8,1021.3,Fair
1/4/2022 6:00,1,2,949,785,3,1734,TUESDAY,0,0,-6.7,52,24.1,1021.9,Fair
1/4/2022 7:00,0,1,0,932,1,932,TUESDAY,0,0,-7.2,49,20.5,1022.8,Fair
1/4/2022 8:00,0,2,0,2606,2,2606,TUESDAY,0,0,-7.8,47,20.5,1023.6,Clear
1/4/2022 9:00,1,10,1206,6046,11,7252,TUESDAY,0,0,-8.3,44,24.1,1024.1,Clear
1/4/2022 10:00,1,27,694,16560,28,17254,TUESDAY,0,0,-8.3,44,20.5,1025.2,Clear
1/4/2022 11:00,1,57,523,41221,58,41744,TUESDAY,0,0,-8.3,44,14.8,1026.8,Fair
1/4/2022 12:00,17,114,16121,81121,131,97242,TUESDAY,0,0,-8.3,46,18.4,1027.5,Rain
1/4/2022 13:00,9,187,8463,152260,196,160723,TUESDAY,0,0,-7.8,41,14.8,1027.8,Fair
1/4/2022 14:00,5,143,6058,103405,148,109463,TUESDAY,0,0,-6.7,39,14.8,1028.5,Fair
1/4/2022 15:00,7,109,11903,86276,116,98179,TUESDAY,0,0,-5.6,36,13,1029,Fair
1/4/2022 16:00,3,111,203577,76140,114,279717,TUESDAY,0,0,-4.4,34,13,1028.5,Fair
1/4/2022 17:00,16,147,27446,377207,163,404653,TUESDAY,0,0,-2.8,34,11.2,1027.2,Fair
1/4/2022 18:00,28,136,40849,115599,164,156448,TUESDAY,0,0,-1.7,34,7.6,1026.2,Fair
1/4/2022 19:00,25,173,40900,150764,198,191664,TUESDAY,0,0,-1.1,37,7.6,1026.9,Fair
1/4/2022 20:00,23,209,1072443,161390,232,1233833,TUESDAY,0,0,-0.6,34,11.2,1026.7,Fair
1/4/2022 21:00,28,233,27526,179125,261,206651,TUESDAY,0,0,-1.1,36,11.2,1027.1,Fair
1/4/2022 22:00,27,252,92466,195555,279,288021,TUESDAY,0,0,-1.7,41,18.4,1027.1,Fair
1/4/2022 23:00,19,227,21242,149609,246,170851,TUESDAY,0,0,-1.1,41,18.4,1027.2,Fair
1/5/2022 0:00,13,134,11304,91112,147,102416,WEDNESDAY,0,0,-1.7,43,18.4,1027.3,Fair
1/5/2022 1:00,4,97,2604,64367,101,66971,WEDNESDAY,0,0,-2.2,46,18.4,1027.3,Fair
1/5/2022 2:00,4,52,2593,31125,56,33718,WEDNESDAY,0,0,-2.2,46,16.6,1027.1,Clear
1/5/2022 3:00,7,40,7304,29124,47,36428,WEDNESDAY,0,0,-2.8,50,16.6,1026.8,Clear
1/5/2022 4:00,4,20,2062,15504,24,17566,WEDNESDAY,0,0,-2.8,60,13,1026.5,Clear
1/5/2022 5:00,0,8,0,4421,8,4421,WEDNESDAY,0,0,-2.2,66,16.6,1025.6,Clear
1/5/2022 6:00,1,8,1503,5671,9,7174,WEDNESDAY,0,0,-2.2,66,22.3,1024.7,Clear
1/5/2022 7:00,0,5,0,3211,5,3211,WEDNESDAY,0,0,-2.2,69,13,1024.7,Fair
1/5/2022 8:00,0,1,0,616,1,616,WEDNESDAY,0,0,-2.2,78,11.2,1023.9,Fair
1/5/2022 9:00,1,6,1380,5548,7,6928,WEDNESDAY,0,0,-2.8,81,11.2,1022.6,Fair
1/5/2022 10:00,4,27,3216,18017,31,21233,WEDNESDAY,0,0,-2.8,89,9.4,1021.6,Fair
1/5/2022 11:00,3,70,1444,46452,73,47896,WEDNESDAY,0,0,-2.2,88,7.6,1020.4,Cloudy
1/5/2022 12:00,11,155,440393,104381,166,544774,WEDNESDAY,0,0,0,88,11.2,1018.9,Cloudy
1/5/2022 13:00,15,282,18078,187288,297,205366,WEDNESDAY,0,0,2.2,89,9.4,1017.8,Cloudy
1/5/2022 14:00,15,177,14521,130053,192,144574,WEDNESDAY,0,0,4.4,89,16.6,1016.8,Cloudy
1/5/2022 15:00,17,136,48146,85042,153,133188,WEDNESDAY,0,0,7.2,86,18.4,1015.6,Cloudy
1/5/2022 16:00,12,93,13965,66905,105,80870,WEDNESDAY,0,0,10,77,25.9,1013.8,Cloudy
1/5/2022 17:00,14,101,20734,64533,115,85267,WEDNESDAY,0,0,10,83,29.5,1012.3,Cloudy
1/5/2022 18:00,15,110,14015,90915,125,104930,WEDNESDAY,0,0,10,86,31.7,1010.5,Cloudy
1/5/2022 19:00,8,93,11878,61909,101,73787,WEDNESDAY,0,0,10.6,89,25.9,1009.4,Cloudy
1/5/2022 20:00,17,142,16819,103863,159,120682,WEDNESDAY,0,0,10.6,92,22.3,1008.8,Rain
1/5/2022 21:00,25,189,80664,144969,214,225633,WEDNESDAY,0,0,10.6,89,18.4,1008,Rain
1/5/2022 22:00,19,227,32977,182687,246,215664,WEDNESDAY,0,0,10,93,16.6,1007.8,Rain
1/5/2022 23:00,27,208,23368,145086,235,168454,WEDNESDAY,0,0,10,89,18.4,1007,Rain
1/6/2022 0:00,15,170,13491,112523,185,126014,THURSDAY,0,0,9.4,90,25.9,1006.5,Rain
1/6/2022 1:00,9,103,12739,80213,112,92952,THURSDAY,0,0,8.9,86,22.3,1005.8,Rain
1/6/2022 2:00,9,82,13642,55997,91,69639,THURSDAY,0,0,8.3,86,18.4,1006,Cloudy
1/6/2022 3:00,14,37,56208,26985,51,83193,THURSDAY,0,0,7.8,86,14.8,1005,Cloudy
1/6/2022 4:00,7,21,6327,13874,28,20201,THURSDAY,0,0,6.7,85,14.8,1004.4,Rain
1/6/2022 5:00,6,18,5485,18904,24,24389,THURSDAY,0,0,6.1,89,13,1003.8,Cloudy
1/6/2022 6:00,2,12,2019,9081,14,11100,THURSDAY,0,0,5.6,89,11.2,1003.5,Cloudy
1/6/2022 7:00,2,6,2214,7683,8,9897,THURSDAY,0,0,5,89,14.8,1003.6,Cloudy
1/6/2022 8:00,1,2,2988,3084,3,6072,THURSDAY,0,0,5,89,13,1003.6,Fair
1/6/2022 9:00,0,7,0,5388,7,5388,THURSDAY,0,0,4.4,86,13,1003.2,Fair
1/6/2022 10:00,2,20,1006,15229,22,16235,THURSDAY,0,0,4.4,83,18.4,1003.8,Clear
1/6/2022 11:00,6,70,5140,701647,76,706787,THURSDAY,0,0,2.8,89,20.5,1004.1,Fair
1/6/2022 12:00,12,165,10486,130113,177,140599,THURSDAY,0,0,4.4,73,22.3,1005.4,Fair
1/6/2022 13:00,18,280,14772,222292,298,237064,THURSDAY,0,0,3.3,73,16.6,1007.1,Fair
1/6/2022 14:00,18,187,39623,129110,205,168733,THURSDAY,0,0,3.3,64,20.5,1008,Fair
1/6/2022 15:00,29,151,43100,108877,180,151977,THURSDAY,0,0,3.9,57,25.9,1008.6,Fair
1/6/2022 16:00,22,152,44588,113859,174,158447,THURSDAY,0,0,4.4,51,20.5,1008.7,Cloudy
1/6/2022 17:00,21,181,25869,136255,202,162124,THURSDAY,0,0,3.3,48,27.7,1008.6,Cloudy
1/6/2022 18:00,26,172,29176,112872,198,142048,THURSDAY,0,0,3.3,46,27.7,1009.3,Cloudy
1/6/2022 19:00,21,206,33903,266868,227,300771,THURSDAY,0,0,2.8,48,25.9,1016.3,Cloudy
1/6/2022 20:00,37,244,55723,170752,281,226475,THURSDAY,0,0,2.8,46,24.1,1017.7,Cloudy
1/6/2022 21:00,39,289,43167,225442,328,268609,THURSDAY,0,0,1.7,47,14.8,1017.7,Cloudy
1/6/2022 22:00,25,327,23570,261612,352,285182,THURSDAY,0,0,1.7,45,16.6,1017.7,Cloudy
1/6/2022 23:00,36,257,50784,246791,293,297575,THURSDAY,0,0,1.7,47,18.4,1019.4,Cloudy
1/7/2022 0:00,21,215,97956,140764,236,238720,FRIDAY,0,0,1.1,50,18.4,1019.7,Cloudy
1/7/2022 1:00,13,123,16892,78133,136,95025,FRIDAY,0,0,1.1,50,14.8,1020.1,Cloudy
1/7/2022 2:00,9,97,6783,72632,106,79415,FRIDAY,0,0,1.1,50,7.6,1020.4,Cloudy
1/7/2022 3:00,11,66,962477,45072,77,1007549,FRIDAY,0,0,0.6,51,11.2,1020.4,Snow
1/7/2022 4:00,7,30,4895,26875,37,31770,FRIDAY,0,0,0.6,51,7.6,1020.4,Cloudy
1/7/2022 5:00,1,21,9443,17202,22,26645,FRIDAY,0,0,0.6,51,7.6,1020.4,Rain
1/7/2022 6:00,5,6,3658,3518,11,7176,FRIDAY,0,0,0.6,53,13,1020.4,Snow
1/7/2022 7:00,2,5,2008,5020,7,7028,FRIDAY,0,0,0,54,5.4,1018.7,Snow
1/7/2022 8:00,0,6,0,3816,6,3816,FRIDAY,0,0,0,58,14.8,1017.3,Snow
1/7/2022 9:00,0,1,0,1032,1,1032,FRIDAY,0,0,-1.7,85,14.8,1016.7,Snow
1/7/2022 10:00,2,6,2321,6915,8,9236,FRIDAY,0,0,-2.2,96,13,1007,Snow
1/7/2022 11:00,1,9,467,7997,10,8464,FRIDAY,0,0,-1.7,96,11.2,1012.9,Snow
1/7/2022 12:00,1,17,640,18534,18,19174,FRIDAY,0,0,-1.7,96,18.4,1011.2,Snow
1/7/2022 13:00,0,18,0,21134,18,21134,FRIDAY,0,0,-1.7,96,22.3,1009.9,Snow
1/7/2022 14:00,1,17,1539,20442,18,21981,FRIDAY,0,0,-1.1,92,22.3,1009.2,Snow
1/7/2022 15:00,2,12,1367,10198,14,11565,FRIDAY,0,0,-1.1,92,25.9,1008.5,Snow
1/7/2022 16:00,0,16,0,19530,16,19530,FRIDAY,0,0,-1.1,88,25.9,1008.9,Snow
1/7/2022 17:00,3,33,76055,27823,36,103878,FRIDAY,0,0,-1.1,85,31.7,1008.2,Snow
1/7/2022 18:00,2,25,1435,21864,27,23299,FRIDAY,0,0,-1.1,81,29.5,1008.5,Snow
1/7/2022 19:00,3,35,2504,25247,38,27751,FRIDAY,0,0,-1.1,85,25.9,1003.8,Snow
1/7/2022 20:00,3,40,83933,57549,43,141482,FRIDAY,0,0,-1.1,81,29.5,1005,Snow
1/7/2022 21:00,3,70,4069,65807,73,69876,FRIDAY,0,0,-0.6,78,24.1,1006.7,Snow
1/7/2022 22:00,3,69,5443,59209,72,64652,FRIDAY,0,0,-0.6,72,24.1,1008.3,Cloudy
1/7/2022 23:00,3,66,2011,127238,69,129249,FRIDAY,0,0,-0.6,69,24.1,1009.9,Cloudy
1/8/2022 0:00,4,61,3060,50507,65,53567,SATURDAY,1,0,-1.1,66,25.9,1011.6,Cloudy
1/8/2022 1:00,2,28,1711,25337,30,27048,SATURDAY,1,0,-1.7,69,18.4,1012.9,Fair
1/8/2022 2:00,2,21,1312,15635,23,16947,SATURDAY,1,0,-2.2,66,20.5,1013.7,Fair
1/8/2022 3:00,2,20,1256,15821,22,17077,SATURDAY,1,0,-3.3,60,24.1,1014.7,Fair
1/8/2022 4:00,2,10,2232,9174,12,11406,SATURDAY,1,0,-4.4,60,24.1,1016,Fair
1/8/2022 5:00,1,14,794,9302,15,10096,SATURDAY,1,0,-5,59,25.9,1017.3,Clear
1/8/2022 6:00,2,11,2327,9585,13,11912,SATURDAY,1,0,-5.6,60,24.1,1018.3,Clear
1/8/2022 7:00,1,1,520,582,2,1102,SATURDAY,1,0,-6.1,62,25.9,1019.7,Clear
1/8/2022 8:00,0,4,0,5786,4,5786,SATURDAY,1,0,-6.1,59,18.4,1021.2,Clear
1/8/2022 9:00,1,2,910,1264,3,2174,SATURDAY,1,0,-6.7,57,20.5,1022.2,Clear
1/8/2022 10:00,2,6,1697,7985,8,9682,SATURDAY,1,0,-7.2,59,24.1,1024,Clear
1/8/2022 11:00,0,4,0,35012,4,35012,SATURDAY,1,0,-7.8,56,27.7,1025.8,Fair
1/8/2022 12:00,0,20,0,11040,20,11040,SATURDAY,1,0,-8.3,59,22.3,1027.4,Fair
1/8/2022 13:00,2,31,952,20811,33,21763,SATURDAY,1,0,-8.3,62,25.9,1029,Fair
1/8/2022 14:00,5,60,5068,43703,65,48771,SATURDAY,1,0,-7.8,59,25.9,1029.7,Fair
1/8/2022 15:00,11,82,12369,97175,93,109544,SATURDAY,1,0,-6.7,54,20.5,1031.3,Fair
1/8/2022 16:00,12,104,30375,98196,116,128571,SATURDAY,1,0,-5.6,52,13,1032.9,Fair
1/8/2022 17:00,12,119,16097,100022,131,116119,SATURDAY,1,0,-4.4,50,18.4,1032.7,Fair
1/8/2022 18:00,16,116,19860,92767,132,112627,SATURDAY,1,0,-3.3,48,20.5,1033,Fair
1/8/2022 19:00,9,122,10534,247546,131,258080,SATURDAY,1,0,-2.2,39,16.6,1033.3,Fair
1/8/2022 20:00,18,142,21925,255308,160,277233,SATURDAY,1,0,-2.2,39,11.2,1033.9,Fair
1/8/2022 21:00,16,112,22059,85749,128,107808,SATURDAY,1,0,-2.2,35,9.4,1034.4,Fair
1/8/2022 22:00,13,102,12327,79775,115,92102,SATURDAY,1,0,-2.8,37,11.2,1035,Fair
1/8/2022 23:00,12,111,16290,75351,123,91641,SATURDAY,1,0,-2.8,35,9.4,1035,Fair
1/9/2022 0:00,5,68,6065,47505,73,53570,SUNDAY,1,0,-3.3,42,9.4,1035.6,Fair
1/9/2022 1:00,8,48,65818,36095,56,101913,SUNDAY,1,0,-5,48,9.4,1035.4,Fair
1/9/2022 2:00,5,37,6109,27768,42,33877,SUNDAY,1,0,-5.6,57,11.2,1035.4,Clear
1/9/2022 3:00,7,27,7039,17890,34,24929,SUNDAY,1,0,-6.1,59,11.2,1035.6,Clear
1/9/2022 4:00,14,15,68997,10152,29,79149,SUNDAY,1,0,-5.6,55,13,1035.2,Fair
1/9/2022 5:00,5,12,4930,8269,17,13199,SUNDAY,1,0,-5,59,18.4,1033.6,Fair
1/9/2022 6:00,6,15,1497338,8789,21,1506127,SUNDAY,1,0,-4.4,52,13,1032.8,Fair
1/9/2022 7:00,4,5,3118,3859,9,6977,SUNDAY,1,0,-4.4,55,13,1032.5,Cloudy
1/9/2022 8:00,2,5,778,3358,7,4136,SUNDAY,1,0,-5,57,16.6,1031.8,Cloudy
1/9/2022 9:00,0,1,0,841,1,841,SUNDAY,1,0,-3.9,60,14.8,1030.2,Cloudy
1/9/2022 10:00,1,7,389,4893,8,5282,SUNDAY,1,0,-1.7,63,22.3,1028.6,Cloudy
1/9/2022 11:00,2,10,1111,7688,12,8799,SUNDAY,1,0,-1.1,66,14.8,1027.6,Cloudy
1/9/2022 12:00,4,20,2820,9963,24,12783,SUNDAY,1,0,-0.6,72,20.5,1026.4,Cloudy
1/9/2022 13:00,5,38,5185,30762,43,35947,SUNDAY,1,0,-0.6,72,27.7,1025,Cloudy
1/9/2022 14:00,7,64,5659,40546,71,46205,SUNDAY,1,0,0.6,75,27.7,1023.3,Cloudy
1/9/2022 15:00,11,79,8030,56322,90,64352,SUNDAY,1,0,1.7,78,31.7,1022.3,Cloudy
1/9/2022 16:00,15,101,34077,82744,116,116821,SUNDAY,1,0,3.3,76,29.5,1020.5,Cloudy
1/9/2022 17:00,27,96,364629,74217,123,438846,SUNDAY,1,0,4.4,73,27.7,1018,Cloudy
1/9/2022 18:00,18,121,31327,84244,139,115571,SUNDAY,1,0,5.6,67,31.7,1015.5,Cloudy
1/9/2022 19:00,23,114,36710,81739,137,118449,SUNDAY,1,0,6.1,65,37.1,1013.8,Cloudy
1/9/2022 20:00,27,178,242849,117803,205,360652,SUNDAY,1,0,6.1,68,48.2,1012.7,Cloudy
1/9/2022 21:00,25,131,28783,93098,156,121881,SUNDAY,1,0,6.1,70,31.7,1012.1,Rain
1/9/2022 22:00,23,130,75145,103403,153,178548,SUNDAY,1,0,5.6,73,24.1,1012.2,Rain
1/9/2022 23:00,16,96,288773,66258,112,355031,SUNDAY,1,0,5.6,73,27.7,1011.8,Rain
1/10/2022 0:00,3,79,2417,64544,82,66961,MONDAY,0,0,5,79,29.5,1011,Rain
1/10/2022 1:00,5,49,3789,33020,54,36809,MONDAY,0,0,4.4,83,29.5,1010.7,Rain
1/10/2022 2:00,5,38,8277,25599,43,33876,MONDAY,0,0,4.4,86,27.7,1009.8,Rain
1/10/2022 3:00,6,37,8478,24312,43,32790,MONDAY,0,0,4.4,86,27.7,1009.8,Rain
1/10/2022 4:00,2,22,36802,16279,24,53081,MONDAY,0,0,4.4,83,24.1,1009.8,Rain
1/10/2022 5:00,1,10,1058,7714,11,8772,MONDAY,0,0,4.4,79,24.1,1010.1,Cloudy
1/10/2022 6:00,0,6,0,2519,6,2519,MONDAY,0,0,3.9,57,27.7,1010.3,Cloudy
1/10/2022 7:00,2,6,2136,3201,8,5337,MONDAY,0,0,3.3,50,42.5,1010.9,Snow
1/10/2022 8:00,0,2,0,1338,2,1338,MONDAY,0,0,2.2,48,35.3,1011.6,Cloudy
1/10/2022 9:00,0,2,0,2862,2,2862,MONDAY,0,0,1.7,49,37.1,1012.3,Cloudy
1/10/2022 10:00,2,22,916,12140,24,13056,MONDAY,0,0,0.6,53,29.5,1013,Cloudy
1/10/2022 11:00,7,71,7559,46950,78,54509,MONDAY,0,0,-0.6,39,27.7,1014.3,Fair
1/10/2022 12:00,8,127,5876,96638,135,102514,MONDAY,0,0,-1.1,41,25.9,1015.5,Fair
1/10/2022 13:00,13,228,11038,160815,241,171853,MONDAY,0,0,-1.7,41,20.5,1016.3,Fair
1/10/2022 14:00,10,173,9330,114326,183,123656,MONDAY,0,0,-2.2,35,29.5,1017.6,Fair
1/10/2022 15:00,9,108,7921,83446,117,91367,MONDAY,0,0,-2.2,32,35.3,1018.4,Fair
1/10/2022 16:00,10,127,16962,96931,137,113893,MONDAY,0,0,-1.7,34,25.9,1018,Fair
1/10/2022 17:00,10,146,13093,106710,156,119803,MONDAY,0,0,-1.7,32,22.3,1016.9,Fair
1/10/2022 18:00,10,149,9531,103677,159,113208,MONDAY,0,0,-1.7,32,24.1,1016.3,Fair
1/10/2022 19:00,12,141,99895,88159,153,188054,MONDAY,0,0,-2.2,35,25.9,1016.1,Fair
1/10/2022 20:00,19,168,38711,116301,187,155012,MONDAY,0,0,-2.2,34,25.9,1015.7,Cloudy
1/10/2022 21:00,19,218,20466,219203,237,239669,MONDAY,0,0,-2.8,39,20.5,1016.5,Cloudy
1/10/2022 22:00,15,284,14389,726554,299,740943,MONDAY,0,0,-3.3,40,25.9,1017.2,Cloudy
1/10/2022 23:00,10,226,8032,165609,236,173641,MONDAY,0,0,-3.3,42,20.5,1017.7,Fair
1/11/2022 0:00,10,153,8162,91805,163,99967,TUESDAY,0,0,-3.9,42,25.9,1018.1,Fair
1/11/2022 1:00,2,86,931,46558,88,47489,TUESDAY,0,0,-4.4,46,24.1,1018.3,Fair
1/11/2022 2:00,4,49,4701,28641,53,33342,TUESDAY,0,0,-4.4,48,22.3,1018.1,Fair
1/11/2022 3:00,6,45,3244,34694,51,37938,TUESDAY,0,0,-5,57,20.5,1018.1,Fair
1/11/2022 4:00,2,20,3209,10119,22,13328,TUESDAY,0,0,-5,52,27.7,1018.1,Fair
1/11/2022 5:00,5,13,3513,7514,18,11027,TUESDAY,0,0,-5.6,48,27.7,1018.2,Fair
1/11/2022 6:00,0,4,0,3563,4,3563,TUESDAY,0,0,-6.1,47,18.4,1019.1,Fair
1/11/2022 9:00,0,3,0,1774,3,1774,TUESDAY,0,0,-9.4,64,29.5,1022.8,Fair
1/11/2022 10:00,0,15,0,12796,15,12796,TUESDAY,0,0,-9.4,61,24.1,1024.3,Fair
1/11/2022 11:00,0,34,0,23443,34,23443,TUESDAY,0,0,-11.1,55,22.3,1026.2,Fair
1/11/2022 12:00,7,68,6738,43413,75,50151,TUESDAY,0,0,-12.8,50,24.1,1028.1,Fair
1/11/2022 13:00,2,120,3249,80963,122,84212,TUESDAY,0,0,-13.3,47,27.7,1030,Fair
1/11/2022 14:00,7,83,9106,61908,90,71014,TUESDAY,0,0,-13.3,45,20.5,1030.8,Fair
1/11/2022 15:00,6,57,3550,40326,63,43876,TUESDAY,0,0,-12.8,37,35.3,1031.6,Fair
1/11/2022 16:00,9,67,10093,38708,76,48801,TUESDAY,0,0,-12.2,34,33.5,1031.5,Fair
1/11/2022 17:00,2,76,1123,117275,78,118398,TUESDAY,0,0,-11.7,34,27.7,1031.2,Fair
1/11/2022 18:00,2,84,1091,59219,86,60310,TUESDAY,0,0,-11.1,31,24.1,1031.2,Fair
1/11/2022 19:00,10,87,9526,61065,97,70591,TUESDAY,0,0,-10.6,30,25.9,1031.4,Fair
1/11/2022 20:00,3,99,1758,64623,102,66381,TUESDAY,0,0,-10.6,30,20.5,1031.4,Fair
1/11/2022 21:00,11,144,9531,98952,155,108483,TUESDAY,0,0,-10.6,30,16.6,1032,Fair
1/11/2022 22:00,6,146,6591,84119,152,90710,TUESDAY,0,0,-11.1,33,18.4,1032.9,Fair
1/11/2022 23:00,7,122,3330,71271,129,74601,TUESDAY,0,0,-11.1,34,18.4,1033.3,Fair
1/12/2022 0:00,5,91,4610,62451,96,67061,WEDNESDAY,0,0,-11.7,34,16.6,1033.8,Clear
1/12/2022 1:00,2,58,1511,29570,60,31081,WEDNESDAY,0,0,-11.7,36,14.8,1033.6,Clear
1/12/2022 2:00,2,28,2045,18265,30,20310,WEDNESDAY,0,0,-11.7,38,13,1033.5,Clear
1/12/2022 3:00,3,26,16106,16035,29,32141,WEDNESDAY,0,0,-12.2,41,7.6,1032.9,Clear
1/12/2022 4:00,0,19,0,11502,19,11502,WEDNESDAY,0,0,-12.2,45,14.8,1032.7,Rain
1/12/2022 5:00,0,3,0,2484,3,2484,WEDNESDAY,0,0,-12.2,48,11.2,1032,Clear
1/12/2022 6:00,1,2,375,1071,3,1446,WEDNESDAY,0,0,-12.2,52,11.2,1030.9,Fair
1/12/2022 7:00,1,1,416,425,2,841,WEDNESDAY,0,0,-11.7,50,18.4,1030.5,Fair
1/12/2022 9:00,1,0,445,0,1,445,WEDNESDAY,0,0,-11.1,53,16.6,1029.2,Cloudy
1/12/2022 10:00,2,11,1275,7484,13,8759,WEDNESDAY,0,0,-10.6,56,20.5,1027.9,Cloudy
1/12/2022 11:00,3,44,2711,25549,47,28260,WEDNESDAY,0,0,-10,64,18.4,1026.1,Cloudy
1/12/2022 12:00,6,91,4494,59866,97,64360,WEDNESDAY,0,0,-8.9,64,20.5,1024.9,Cloudy
1/12/2022 13:00,10,199,7882,136739,209,144621,WEDNESDAY,0,0,-7.2,70,16.6,1023.5,Cloudy
1/12/2022 14:00,8,131,108120,76080,139,184200,WEDNESDAY,0,0,-3.3,63,22.3,1022.7,Cloudy
1/12/2022 15:00,6,126,14005,87276,132,101281,WEDNESDAY,0,0,-0.6,61,27.7,1021.4,Cloudy
1/12/2022 16:00,8,112,8086,84699,120,92785,WEDNESDAY,0,0,1.7,56,37.1,1019.9,Cloudy
1/12/2022 17:00,15,155,25003,112017,170,137020,WEDNESDAY,0,0,2.8,52,33.5,1018.3,Cloudy
1/12/2022 18:00,13,154,14449,115174,167,129623,WEDNESDAY,0,0,4.4,43,29.5,1017,Cloudy
1/12/2022 19:00,9,155,9397,111390,164,120787,WEDNESDAY,0,0,5,39,37.1,1016.5,Cloudy
1/12/2022 20:00,17,197,17886,138828,214,156714,WEDNESDAY,0,0,5.6,38,25.9,1016.5,Cloudy
1/12/2022 21:00,27,251,35363,183715,278,219078,WEDNESDAY,0,0,5,39,18.4,1016.9,Cloudy
1/12/2022 22:00,20,311,23101,243376,331,266477,WEDNESDAY,0,0,3.9,41,13,1017.1,Fair
1/12/2022 23:00,21,280,23594,198154,301,221748,WEDNESDAY,0,0,3.9,42,18.4,1017.6,Fair
1/13/2022 0:00,21,208,45160,130570,229,175730,THURSDAY,0,0,3.3,44,14.8,1018.2,Fair
1/13/2022 1:00,14,117,23153,72055,131,95208,THURSDAY,0,0,2.8,46,20.5,1018.4,Cloudy
1/13/2022 2:00,12,100,15551,66625,112,82176,THURSDAY,0,0,2.2,46,22.3,1018.6,Cloudy
1/13/2022 3:00,6,58,3058,36861,64,39919,THURSDAY,0,0,1.7,49,16.6,1018.9,Cloudy
1/13/2022 4:00,3,19,1315,10809,22,12124,THURSDAY,0,0,1.1,52,16.6,1018.9,Cloudy
1/13/2022 5:00,2,11,1037,8576,13,9613,THURSDAY,0,0,1.1,52,9.4,1018.3,Cloudy
1/13/2022 6:00,2,6,889,2933,8,3822,THURSDAY,0,0,0.6,53,13,1018.2,Cloudy
1/13/2022 7:00,0,7,0,4368,7,4368,THURSDAY,0,0,1.1,54,7.6,1018.3,Cloudy
1/13/2022 8:00,0,3,0,3348,3,3348,THURSDAY,0,0,0.6,56,0,1018,Cloudy
1/13/2022 9:00,0,6,0,3640,6,3640,THURSDAY,0,0,-1.7,69,11.2,1017.6,Cloudy
1/13/2022 10:00,1,24,612,16975,25,17587,THURSDAY,0,0,-0.6,63,13,1017.4,Cloudy
1/13/2022 11:00,3,73,2107,100769,76,102876,THURSDAY,0,0,-1.1,72,5.4,1017.9,Cloudy
1/13/2022 12:00,10,156,34698,118821,166,153519,THURSDAY,0,0,-0.6,76,7.6,1018.1,Cloudy
1/13/2022 13:00,15,280,12988,189746,295,202734,THURSDAY,0,0,0,69,0,1018.2,Cloudy
1/13/2022 14:00,14,220,13447,265814,234,279261,THURSDAY,0,0,2.2,56,0,1018.4,Cloudy
1/13/2022 15:00,19,158,60842,111955,177,172797,THURSDAY,0,0,2.8,54,7.6,1018.5,Cloudy
1/13/2022 16:00,21,179,40190,135617,200,175807,THURSDAY,0,0,2.8,59,5.4,1017.6,Cloudy
1/13/2022 17:00,30,215,64314,151555,245,215869,THURSDAY,0,0,5,55,7.6,1016.5,Cloudy
1/13/2022 18:00,33,213,32129,173702,246,205831,THURSDAY,0,0,6.1,55,11.2,1015.7,Cloudy
1/13/2022 19:00,35,215,1504442,180216,250,1684658,THURSDAY,0,0,7.8,55,18.4,1014.9,Cloudy
1/13/2022 20:00,57,251,129886,191102,308,320988,THURSDAY,0,0,7.2,58,9.4,1014.4,Cloudy
1/13/2022 21:00,48,313,591649,243067,361,834716,THURSDAY,0,0,4.4,76,11.2,1014.4,Cloudy
1/13/2022 22:00,45,366,374338,350584,411,724922,THURSDAY,0,0,3.9,82,5.4,1014.3,Cloudy
1/13/2022 23:00,34,289,27573,229972,323,257545,THURSDAY,0,0,3.3,86,0,1014.3,Cloudy
1/14/2022 0:00,18,242,21831,175762,260,197593,FRIDAY,0,0,3.3,86,7.6,1014.5,Cloudy
1/14/2022 1:00,16,159,422353,103897,175,526250,FRIDAY,0,0,3.9,82,11.2,1014.4,Cloudy
1/14/2022 2:00,21,105,23459,75329,126,98788,FRIDAY,0,0,3.3,89,7.6,1014.1,Cloudy
1/14/2022 3:00,24,79,147831,52714,103,200545,FRIDAY,0,0,2.2,89,0,1013.8,Cloudy
1/14/2022 4:00,7,28,6151,18980,35,25131,FRIDAY,0,0,2.2,89,0,1013.3,Cloudy
1/14/2022 5:00,4,27,104959,17997,31,122956,FRIDAY,0,0,1.7,89,5.4,1012.8,Cloudy
1/14/2022 6:00,4,10,3567,9262,14,12829,FRIDAY,0,0,2.2,89,9.4,1012,Cloudy
1/14/2022 7:00,1,3,489,1966,4,2455,FRIDAY,0,0,2.2,89,7.6,1011.6,Cloudy
1/14/2022 8:00,1,2,1472,1695,3,3167,FRIDAY,0,0,2.2,89,11.2,1011.1,Cloudy
1/14/2022 9:00,0,1,0,441,1,441,FRIDAY,0,0,1.7,89,13,1010.4,Cloudy
1/14/2022 10:00,0,25,0,19761,25,19761,FRIDAY,0,0,1.1,88,16.6,1010.1,Cloudy
1/14/2022 11:00,4,59,2022,34561,63,36583,FRIDAY,0,0,1.7,85,16.6,1009.8,Cloudy
1/14/2022 12:00,11,137,9335,104447,148,113782,FRIDAY,0,0,1.7,85,18.4,1010.1,Cloudy
1/14/2022 13:00,20,254,37962,188146,274,226108,FRIDAY,0,0,2.2,82,18.4,1009.9,Cloudy
1/14/2022 14:00,14,198,15694,136205,212,151899,FRIDAY,0,0,2.2,85,20.5,1009.5,Cloudy
1/14/2022 15:00,11,147,12763,142610,158,155373,FRIDAY,0,0,2.8,82,22.3,1009.4,Cloudy
1/14/2022 16:00,15,184,19214,130603,199,149817,FRIDAY,0,0,4.4,76,24.1,1008.7,Cloudy
1/14/2022 17:00,21,202,22841,139075,223,161916,FRIDAY,0,0,4.4,76,29.5,1007.8,Cloudy
1/14/2022 18:00,25,208,27263,148375,233,175638,FRIDAY,0,0,4.4,65,31.7,1006.9,Cloudy
1/14/2022 19:00,34,191,36481,140969,225,177450,FRIDAY,0,0,5,60,31.7,1006.3,Cloudy
1/14/2022 20:00,34,221,38419,1203586,255,1242005,FRIDAY,0,0,5,57,42.5,1005.8,Cloudy
1/14/2022 21:00,31,290,30263,203311,321,233574,FRIDAY,0,0,4.4,60,29.5,1006.1,Snow
1/14/2022 22:00,24,289,167975,288676,313,456651,FRIDAY,0,0,2.8,57,35.3,1006.4,Cloudy
1/14/2022 23:00,27,230,27571,155771,257,183342,FRIDAY,0,0,1.1,52,35.3,1006.8,Cloudy
1/15/2022 0:00,11,173,12523,114296,184,126819,SATURDAY,1,0,-0.6,49,33.5,1007.4,Cloudy
1/15/2022 1:00,12,95,169636,62885,107,232521,SATURDAY,1,0,-2.2,44,38.9,1007.5,Cloudy
1/15/2022 2:00,10,50,12494,27698,60,40192,SATURDAY,1,0,-3.9,42,35.3,1007.7,Cloudy
1/15/2022 3:00,7,32,5424,14582,39,20006,SATURDAY,1,0,-6.1,39,31.7,1008.1,Cloudy
1/15/2022 4:00,6,22,25217,17636,28,42853,SATURDAY,1,0,-7.2,37,38.9,1008.5,Fair
1/15/2022 5:00,4,20,4692,13369,24,18061,SATURDAY,1,0,-9.4,40,42.5,1009.8,Fair
1/15/2022 6:00,4,17,4224,12917,21,17141,SATURDAY,1,0,-10.6,42,33.5,1011.1,Fair
1/15/2022 7:00,2,2,1466,864,4,2330,SATURDAY,1,0,-11.7,42,38.9,1012.3,Fair
1/15/2022 8:00,1,2,669,2651,3,3320,SATURDAY,1,0,-12.8,43,37.1,1013.4,Clear
1/15/2022 9:00,0,4,0,760,4,760,SATURDAY,1,0,-13.3,43,31.7,1014.4,Clear
1/15/2022 10:00,0,8,0,8164,8,8164,SATURDAY,1,0,-13.9,41,22.3,1016.2,Clear
1/15/2022 11:00,0,14,0,9350,14,9350,SATURDAY,1,0,-15,42,31.7,1017.6,Fair
1/15/2022 12:00,5,20,5969,13738,25,19707,SATURDAY,1,0,-15.6,44,24.1,1018.9,Fair
1/15/2022 13:00,0,32,0,32272,32,32272,SATURDAY,1,0,-15.6,40,27.7,1020,Fair
1/15/2022 14:00,7,69,6297,40020,76,46317,SATURDAY,1,0,-15,38,27.7,1020.7,Fair
1/15/2022 15:00,7,68,4908,50950,75,55858,SATURDAY,1,0,-14.4,36,27.7,1021.3,Fair
1/15/2022 16:00,9,78,6080,56600,87,62680,SATURDAY,1,0,-12.8,33,22.3,1021.8,Fair
1/15/2022 17:00,8,92,8891,68553,100,77444,SATURDAY,1,0,-11.7,29,27.7,1020.9,Fair
1/15/2022 18:00,9,96,9394,64830,105,74224,SATURDAY,1,0,-10.6,28,27.7,1020.9,Fair
1/15/2022 19:00,13,95,8966,71674,108,80640,SATURDAY,1,0,-9.4,26,25.9,1021.7,Fair
1/15/2022 20:00,19,104,21015,254412,123,275427,SATURDAY,1,0,-9.4,22,33.5,1022.5,Fair
1/15/2022 21:00,6,107,10989,67027,113,78016,SATURDAY,1,0,-10,26,33.5,1023.4,Fair
1/15/2022 22:00,9,82,10055,63822,91,73877,SATURDAY,1,0,-11.1,26,27.7,1024.5,Fair
1/15/2022 23:00,7,87,4579,227740,94,232319,SATURDAY,1,0,-11.1,28,27.7,1024.9,Fair
1/16/2022 0:00,8,52,66005,30624,60,96629,SUNDAY,1,0,-11.7,31,18.4,1025.8,Fair
1/16/2022 1:00,2,42,1954,24285,44,26239,SUNDAY,1,0,-12.2,32,25.9,1026.6,Clear
1/16/2022 2:00,1,23,621,13373,24,13994,SUNDAY,1,0,-12.8,35,24.1,1027.1,Clear
1/16/2022 3:00,5,28,3007,18726,33,21733,SUNDAY,1,0,-12.8,33,25.9,1027.7,Clear
1/16/2022 4:00,2,19,1665,10118,21,11783,SUNDAY,1,0,-13.3,37,22.3,1028,Clear
1/16/2022 5:00,1,13,493,8187,14,8680,SUNDAY,1,0,-13.9,39,22.3,1027.1,Clear
1/16/2022 6:00,2,8,1838,5030,10,6868,SUNDAY,1,0,-14.4,40,25.9,1028.7,Clear
1/16/2022 7:00,2,7,729,4648,9,5377,SUNDAY,1,0,-14.4,40,18.4,1029.7,Clear
1/16/2022 8:00,1,3,1476,1055,4,2531,SUNDAY,1,0,-14.4,42,13,1029.2,Clear
1/16/2022 9:00,1,3,904,2708,4,3612,SUNDAY,1,0,-14.4,44,13,1029.4,Clear
1/16/2022 10:00,2,6,1854,2993,8,4847,SUNDAY,1,0,-14.4,44,14.8,1029.3,Clear
1/16/2022 11:00,1,8,1191,4112,9,5303,SUNDAY,1,0,-14.4,42,13,1029.9,Fair
1/16/2022 12:00,2,15,2472,9413,17,11885,SUNDAY,1,0,-14.4,42,13,1030.3,Fair
1/16/2022 13:00,0,30,0,17473,30,17473,SUNDAY,1,0,-13.3,41,9.4,1031,Fair
1/16/2022 14:00,13,45,16761,23308,58,40069,SUNDAY,1,0,-12.2,41,11.2,1031.1,Fair
1/16/2022 15:00,6,69,5026,41496,75,46522,SUNDAY,1,0,-10.6,36,7.6,1031.5,Fair
1/16/2022 16:00,19,120,18353,80322,139,98675,SUNDAY,1,0,-8.3,32,7.6,1030.4,Fair
1/16/2022 17:00,32,145,54767,105478,177,160245,SUNDAY,1,0,-7.2,34,9.4,1028.6,Fair
1/16/2022 18:00,29,145,144138,111962,174,256100,SUNDAY,1,0,-7.2,45,9.4,1027.8,Fair
1/16/2022 19:00,34,192,284384,149081,226,433465,SUNDAY,1,0,-6.1,39,0,1027.6,Fair
1/16/2022 20:00,42,176,158104,221720,218,379824,SUNDAY,1,0,-3.9,33,0,1026.7,Cloudy
1/16/2022 21:00,22,134,315629,110176,156,425805,SUNDAY,1,0,-5,43,11.2,1026.6,Cloudy
1/16/2022 22:00,16,114,10665,87172,130,97837,SUNDAY,1,0,-4.4,62,11.2,1025.7,Cloudy
1/16/2022 23:00,10,130,10866,87106,140,97972,SUNDAY,1,0,-3.9,60,18.4,1025.1,Cloudy
1/17/2022 0:00,26,83,19753,53611,109,73364,MONDAY,0,1,-3.3,60,13,1025.1,Cloudy
1/17/2022 1:00,9,56,18319,47984,65,66303,MONDAY,0,1,-3.3,60,7.6,1023.5,Cloudy
1/17/2022 2:00,7,38,8997,24857,45,33854,MONDAY,0,1,-2.2,69,11.2,1022.8,Cloudy
1/17/2022 3:00,10,43,11397,28881,53,40278,MONDAY,0,1,-0.6,69,18.4,1021.1,Snow
1/17/2022 4:00,6,27,5898,18674,33,24572,MONDAY,0,1,1.1,67,31.7,1019.7,Snow
1/17/2022 5:00,1,17,457,9564,18,10021,MONDAY,0,1,1.7,69,35.3,1017.8,Snow
1/17/2022 6:00,10,7,5724,4154,17,9878,MONDAY,0,1,2.2,73,37.1,1015.3,Snow
1/17/2022 7:00,1,5,466,5500,6,5966,MONDAY,0,1,2.8,78,40.7,1012.6,Rain
1/17/2022 8:00,1,4,1787,3502,5,5289,MONDAY,0,1,2.8,89,46.4,1009.4,Rain
1/17/2022 9:00,0,3,0,3142,3,3142,MONDAY,0,1,3.3,89,50,1006.3,Rain
1/17/2022 10:00,0,4,0,3208,4,3208,MONDAY,0,1,3.9,89,50,1003.5,Rain
1/17/2022 11:00,0,4,0,2281,4,2281,MONDAY,0,1,4.4,93,59.4,999.7,Rain
1/17/2022 12:00,0,10,0,7952,10,7952,MONDAY,0,1,5.6,92,61.2,995.8,Rain
1/17/2022 13:00,2,21,1341,15760,23,17101,MONDAY,0,1,6.7,93,64.8,991,Rain
1/17/2022 14:00,4,40,12488,20186,44,32674,MONDAY,0,1,6.7,96,59.4,988,Rain
1/17/2022 15:00,3,64,4464,39261,67,43725,MONDAY,0,1,7.2,97,44.6,985.9,Rain
1/17/2022 16:00,12,114,13968,73801,126,87769,MONDAY,0,1,7.8,93,31.7,984.6,Rain
1/17/2022 17:00,28,163,37320,121470,191,158790,MONDAY,0,1,8.9,80,35.3,984.1,Rain
1/17/2022 18:00,48,205,79515,158258,253,237773,MONDAY,0,1,8.9,58,38.9,982.5,Rain
1/17/2022 19:00,50,221,70009,190535,271,260544,MONDAY,0,1,7.2,65,33.5,983.2,Rain
1/17/2022 20:00,41,226,57550,162414,267,219964,MONDAY,0,1,6.1,68,37.1,984,Rain
1/17/2022 21:00,45,186,67749,130178,231,197927,MONDAY,0,1,5,70,37.1,984.5,Cloudy
1/17/2022 22:00,24,193,28279,126291,217,154570,MONDAY,0,1,3.9,79,24.1,985.3,Cloudy
1/17/2022 23:00,22,176,69489,119771,198,189260,MONDAY,0,1,2.8,85,25.9,986,Cloudy
1/18/2022 0:00,14,154,19710,100738,168,120448,TUESDAY,0,0,2.8,82,24.1,987.1,Cloudy
1/18/2022 1:00,10,104,7212,70373,114,77585,TUESDAY,0,0,2.8,78,20.5,987.2,Cloudy
1/18/2022 2:00,11,79,8509,86868,90,95377,TUESDAY,0,0,2.8,76,24.1,987.3,Cloudy
1/18/2022 3:00,14,44,24086,37729,58,61815,TUESDAY,0,0,2.2,82,31.7,987.8,Cloudy
1/18/2022 4:00,5,35,5115,27336,40,32451,TUESDAY,0,0,1.7,85,24.1,987.9,Rain
1/18/2022 5:00,1,14,1562,6857,15,8419,TUESDAY,0,0,2.2,73,27.7,988.6,Cloudy
1/18/2022 6:00,7,4,11820,1713,11,13533,TUESDAY,0,0,0.6,56,35.3,989.5,Cloudy
1/18/2022 7:00,0,5,0,2900,5,2900,TUESDAY,0,0,0,56,27.7,990.7,Cloudy
1/18/2022 8:00,0,3,0,3331,3,3331,TUESDAY,0,0,-0.6,58,22.3,991.9,Cloudy
1/18/2022 9:00,0,7,0,29300,7,29300,TUESDAY,0,0,-1.1,58,25.9,993.3,Cloudy
1/18/2022 10:00,3,23,1107,16485,26,17592,TUESDAY,0,0,-1.1,55,33.5,994.9,Fair
1/18/2022 11:00,4,59,2825,39348,63,42173,TUESDAY,0,0,-1.7,53,37.1,997.1,Cloudy
1/18/2022 12:00,8,173,34451,119568,181,154019,TUESDAY,0,0,-2.2,53,31.7,999.1,Fair
1/18/2022 13:00,22,288,18312,365614,310,383926,TUESDAY,0,0,-2.8,50,37.1,1000.7,Fair
1/18/2022 14:00,11,192,16043,132335,203,148378,TUESDAY,0,0,-2.2,46,35.3,1002.7,Fair
1/18/2022 15:00,6,130,4747,95324,136,100071,TUESDAY,0,0,-2.2,42,37.1,1004.4,Fair
1/18/2022 16:00,16,132,124822,91292,148,216114,TUESDAY,0,0,-1.7,41,29.5,1005.4,Fair
1/18/2022 17:00,12,165,18058,120949,177,139007,TUESDAY,0,0,-1.1,37,35.3,1005.7,Fair
1/18/2022 18:00,21,150,19076,104476,171,123552,TUESDAY,0,0,-1.1,34,38.9,1006.5,Fair
1/18/2022 19:00,12,163,14682,125842,175,140524,TUESDAY,0,0,-1.1,34,37.1,1007.6,Fair
1/18/2022 20:00,30,174,101753,124930,204,226683,TUESDAY,0,0,-1.1,32,31.7,1008.9,Fair
1/18/2022 21:00,21,208,19918,157338,229,177256,TUESDAY,0,0,-1.7,34,35.3,1010.3,Fair
1/18/2022 22:00,19,327,22527,237859,346,260386,TUESDAY,0,0,-2.2,34,25.9,1012.2,Fair
1/18/2022 23:00,14,267,14164,192933,281,207097,TUESDAY,0,0,-3.3,38,20.5,1014,Clear
1/19/2022 0:00,14,198,11153,133722,212,144875,WEDNESDAY,0,0,-3.9,40,20.5,1015.6,Clear
1/19/2022 1:00,11,118,9678,70197,129,79875,WEDNESDAY,0,0,-4.4,40,25.9,1016.9,Clear
1/19/2022 2:00,5,77,4452,49760,82,54212,WEDNESDAY,0,0,-5,42,27.7,1018,Clear
1/19/2022 3:00,4,59,3975,43384,63,47359,WEDNESDAY,0,0,-5.6,38,18.4,1018.9,Clear
1/19/2022 4:00,3,24,1261,12202,27,13463,WEDNESDAY,0,0,-6.1,41,20.5,1020.5,Clear
1/19/2022 5:00,2,21,2670,8899,23,11569,WEDNESDAY,0,0,-6.1,43,14.8,1020.7,Clear
1/19/2022 6:00,2,3,800,745,5,1545,WEDNESDAY,0,0,-6.1,45,16.6,1021.5,Clear
1/19/2022 7:00,2,5,1173,3032,7,4205,WEDNESDAY,0,0,-6.1,49,16.6,1022.1,Clear
1/19/2022 8:00,1,2,337,1229,3,1566,WEDNESDAY,0,0,-5.6,50,13,1021.9,Clear
1/19/2022 9:00,2,3,960,1027,5,1987,WEDNESDAY,0,0,-5.6,50,14.8,1021.6,Fair
1/19/2022 10:00,1,24,411,17872,25,18283,WEDNESDAY,0,0,-6.1,54,14.8,1021.8,Clear
1/19/2022 11:00,1,71,1437,58599,72,60036,WEDNESDAY,0,0,-5.6,52,11.2,1021,Cloudy
1/19/2022 12:00,5,167,2268,119137,172,121405,WEDNESDAY,0,0,-5,50,13,1021.4,Cloudy
1/19/2022 13:00,15,345,20453,245864,360,266317,WEDNESDAY,0,0,-4.4,52,13,1021.2,Cloudy
1/19/2022 14:00,16,204,13719,135201,220,148920,WEDNESDAY,0,0,-2.8,50,20.5,1020.5,Cloudy
1/19/2022 15:00,13,151,9885,102161,164,112046,WEDNESDAY,0,0,0.6,56,24.1,1019.2,Cloudy
1/19/2022 16:00,18,182,22506,145354,200,167860,WEDNESDAY,0,0,2.8,57,27.7,1017.7,Cloudy
1/19/2022 17:00,31,179,45724,119992,210,165716,WEDNESDAY,0,0,5,57,33.5,1015.6,Cloudy
1/19/2022 18:00,23,214,21983,146213,237,168196,WEDNESDAY,0,0,6.1,53,37.1,1013.7,Cloudy
1/19/2022 19:00,29,214,59405,508516,243,567921,WEDNESDAY,0,0,7.8,47,35.3,1012.6,Cloudy
1/19/2022 20:00,20,252,22138,191438,272,213576,WEDNESDAY,0,0,7.8,49,40.7,1012,Cloudy
1/19/2022 21:00,39,318,55875,263359,357,319234,WEDNESDAY,0,0,7.2,56,33.5,1011.9,Cloudy
1/19/2022 22:00,39,436,47548,300851,475,348399,WEDNESDAY,0,0,7.2,56,29.5,1012.2,Cloudy
1/19/2022 23:00,37,359,56569,259212,396,315781,WEDNESDAY,0,0,6.1,60,27.7,1012.6,Cloudy
1/20/2022 0:00,20,250,14706,739294,270,754000,THURSDAY,0,0,5.6,62,24.1,1013.3,Cloudy
1/20/2022 1:00,25,168,527023,110806,193,637829,THURSDAY,0,0,5.6,62,22.3,1013.3,Cloudy
1/20/2022 2:00,9,109,7288,67666,118,74954,THURSDAY,0,0,4.4,68,20.5,1013.5,Cloudy
1/20/2022 3:00,23,89,22207,61861,112,84068,THURSDAY,0,0,4.4,68,18.4,1013.8,Cloudy
1/20/2022 4:00,5,51,43561,32587,56,76148,THURSDAY,0,0,4.4,70,16.6,1013.7,Cloudy
1/20/2022 5:00,7,25,5616,18138,32,23754,THURSDAY,0,0,3.9,73,14.8,1013.7,Cloudy
1/20/2022 6:00,5,3,7685,1227,8,8912,THURSDAY,0,0,3.9,73,11.2,1013.6,Cloudy
1/20/2022 7:00,0,4,0,2182,4,2182,THURSDAY,0,0,2.8,78,7.6,1013.1,Cloudy
1/20/2022 8:00,0,6,0,4984,6,4984,THURSDAY,0,0,2.8,78,5.4,1012.7,Cloudy
1/20/2022 9:00,0,4,0,2386,4,2386,THURSDAY,0,0,2.8,82,5.4,1013.8,Rain
1/20/2022 10:00,2,17,1087,11130,19,12217,THURSDAY,0,0,3.9,73,14.8,1014.7,Rain
1/20/2022 11:00,2,38,761,20782,40,21543,THURSDAY,0,0,3.3,83,11.2,1015.3,Rain
1/20/2022 12:00,9,116,6105,77334,125,83439,THURSDAY,0,0,2.2,89,13,1015.7,Rain
1/20/2022 13:00,11,200,8499,132247,211,140746,THURSDAY,0,0,2.8,89,9.4,1016.8,Snow
1/20/2022 14:00,8,131,7825,89237,139,97062,THURSDAY,0,0,2.8,85,13,1017.6,Snow
1/20/2022 15:00,8,121,7960,86801,129,94761,THURSDAY,0,0,2.2,89,24.1,1018.9,Snow
1/20/2022 16:00,13,126,22478,93255,139,115733,THURSDAY,0,0,2.2,82,9.4,1018.9,Snow
1/20/2022 17:00,16,181,28338,119431,197,147769,THURSDAY,0,0,2.8,78,13,1018.2,Snow
1/20/2022 18:00,18,214,15883,149688,232,165571,THURSDAY,0,0,2.8,72,16.6,1018.2,Cloudy
1/20/2022 19:00,24,184,29692,129129,208,158821,THURSDAY,0,0,2.2,56,24.1,1018.8,Cloudy
1/20/2022 20:00,36,218,33608,164417,254,198025,THURSDAY,0,0,2.8,40,20.5,1019.4,Cloudy
1/20/2022 21:00,37,274,47273,191284,311,238557,THURSDAY,0,0,1.7,49,18.4,1020.6,Cloudy
1/20/2022 22:00,34,394,31134,301517,428,332651,THURSDAY,0,0,0.6,36,20.5,1022,Cloudy
1/20/2022 23:00,33,312,36554,190197,345,226751,THURSDAY,0,0,-1.1,47,22.3,1023,Cloudy
1/21/2022 0:00,18,237,68603,146980,255,215583,FRIDAY,0,0,-2.2,44,22.3,1024.3,Cloudy
1/21/2022 1:00,9,135,11480,478456,144,489936,FRIDAY,0,0,-2.8,44,25.9,1025.6,Cloudy
1/21/2022 2:00,20,90,1125653,62991,110,1188644,FRIDAY,0,0,-4.4,40,29.5,1026.5,Cloudy
1/21/2022 3:00,8,82,5291,48292,90,53583,FRIDAY,0,0,-5.6,41,27.7,1027.5,Cloudy
1/21/2022 4:00,6,39,5008,23079,45,28087,FRIDAY,0,0,-6.7,43,25.9,1028.3,Cloudy
1/21/2022 5:00,3,20,75356,8801,23,84157,FRIDAY,0,0,-7.2,43,31.7,1028.8,Cloudy
1/21/2022 6:00,1,8,917,4127,9,5044,FRIDAY,0,0,-8.3,44,24.1,1029.8,Cloudy
1/21/2022 7:00,4,3,3560,1503,7,5063,FRIDAY,0,0,-8.9,47,20.5,1030.3,Cloudy
1/21/2022 8:00,0,5,0,4833,5,4833,FRIDAY,0,0,-10,51,20.5,1030.7,Fair
1/21/2022 9:00,0,4,0,2611,4,2611,FRIDAY,0,0,-10.6,48,24.1,1031.1,Fair
1/21/2022 10:00,1,26,638,17442,27,18080,FRIDAY,0,0,-11.1,50,24.1,1031.4,Cloudy
1/21/2022 11:00,1,43,378,66723,44,67101,FRIDAY,0,0,-12.2,52,29.5,1032.4,Cloudy
1/21/2022 12:00,8,101,4947,64909,109,69856,FRIDAY,0,0,-12.2,52,24.1,1033.5,Cloudy
1/21/2022 13:00,15,206,13657,118376,221,132033,FRIDAY,0,0,-12.2,52,20.5,1034.5,Cloudy
1/21/2022 14:00,6,165,4477,104561,171,109038,FRIDAY,0,0,-11.7,53,22.3,1035.2,Cloudy
1/21/2022 15:00,13,128,8539,88108,141,96647,FRIDAY,0,0,-10,51,18.4,1035.7,Cloudy
1/21/2022 16:00,15,123,17192,70547,138,87739,FRIDAY,0,0,-8.9,44,18.4,1035.6,Cloudy
1/21/2022 17:00,10,149,50732,98320,159,149052,FRIDAY,0,0,-8.3,44,16.6,1034.9,Cloudy
1/21/2022 18:00,29,162,39192,108405,191,147597,FRIDAY,0,0,-6.7,45,9.4,1034.1,Fair
1/21/2022 19:00,13,155,15624,104693,168,120317,FRIDAY,0,0,-6.1,47,14.8,1034.1,Fair
1/21/2022 20:00,29,206,33173,133228,235,166401,FRIDAY,0,0,-5.6,45,11.2,1034.2,Fair
1/21/2022 21:00,19,237,179164,169092,256,348256,FRIDAY,0,0,-6.1,43,7.6,1034.5,Fair
1/21/2022 22:00,35,281,32698,192633,316,225331,FRIDAY,0,0,-7.2,45,11.2,1035,Fair
1/21/2022 23:00,24,206,40476,140476,230,180952,FRIDAY,0,0,-7.2,39,16.6,1035.3,Fair
1/22/2022 0:00,14,158,9051,108341,172,117392,SATURDAY,1,0,-8.3,42,11.2,1035.5,Fair
1/22/2022 1:00,16,99,14855,63203,115,78058,SATURDAY,1,0,-7.8,39,14.8,1036,Fair
1/22/2022 2:00,5,57,5401,37371,62,42772,SATURDAY,1,0,-8.3,40,13,1035.9,Fair
1/22/2022 3:00,27,51,76358,43807,78,120165,SATURDAY,1,0,-8.3,38,16.6,1035.7,Fair
1/22/2022 4:00,7,42,4775,28882,49,33657,SATURDAY,1,0,-8.3,40,13,1035.1,Cloudy
1/22/2022 5:00,5,36,4621,59880,41,64501,SATURDAY,1,0,-8.9,42,18.4,1034.2,Cloudy
1/22/2022 6:00,24,31,76133,15634,55,91767,SATURDAY,1,0,-9.4,44,18.4,1034.1,Cloudy
1/22/2022 7:00,9,8,8687,6287,17,14974,SATURDAY,1,0,-9.4,51,16.6,1033.6,Cloudy
1/22/2022 8:00,1,7,338,40667,8,41005,SATURDAY,1,0,-10,58,20.5,1032.8,Cloudy
1/22/2022 9:00,0,9,0,5846,9,5846,SATURDAY,1,0,-10,64,20.5,1031.9,Fair
1/22/2022 10:00,0,7,0,6172,7,6172,SATURDAY,1,0,-10,70,22.3,1031.1,Cloudy
1/22/2022 11:00,3,5,2454,3517,8,5971,SATURDAY,1,0,-9.4,70,24.1,1030.8,Cloudy
1/22/2022 12:00,2,26,3192,13043,28,16235,SATURDAY,1,0,-10,70,24.1,1031.3,Cloudy
1/22/2022 13:00,1,40,576,23169,41,23745,SATURDAY,1,0,-10,67,24.1,1030.9,Cloudy
1/22/2022 14:00,3,91,6294,66963,94,73257,SATURDAY,1,0,-9.4,70,20.5,1031.2,Cloudy
1/22/2022 15:00,22,112,22861,82618,134,105479,SATURDAY,1,0,-8.3,56,18.4,1030.4,Cloudy
1/22/2022 16:00,24,160,36934,107496,184,144430,SATURDAY,1,0,-6.7,52,18.4,1029.9,Fair
1/22/2022 17:00,30,209,32912,147266,239,180178,SATURDAY,1,0,-5,50,20.5,1028.3,Fair
1/22/2022 18:00,22,166,16988,128331,188,145319,SATURDAY,1,0,-3.9,48,13,1027.2,Fair
1/22/2022 19:00,32,218,56241,161435,250,217676,SATURDAY,1,0,-3.3,46,13,1026.2,Fair
1/22/2022 20:00,68,203,216678,151101,271,367779,SATURDAY,1,0,-3.9,48,7.6,1024.8,Fair
1/22/2022 21:00,41,235,41063,182981,276,224044,SATURDAY,1,0,-4.4,50,7.6,1024.2,Fair
1/22/2022 22:00,40,180,52695,123492,220,176187,SATURDAY,1,0,-5.6,57,5.4,1023.4,Fair
1/22/2022 23:00,25,135,35887,94501,160,130388,SATURDAY,1,0,-5.6,57,7.6,1022.5,Cloudy
1/23/2022 0:00,16,114,13430,99179,130,112609,SUNDAY,1,0,-5,57,7.6,1022.4,Cloudy
1/23/2022 1:00,22,84,52779,54894,106,107673,SUNDAY,1,0,-6.1,62,7.6,1021.2,Cloudy
1/23/2022 2:00,18,66,32399,45912,84,78311,SUNDAY,1,0,-5.6,62,0,1020.4,Cloudy
1/23/2022 3:00,17,51,26118,34013,68,60131,SUNDAY,1,0,-5.6,75,7.6,1019.6,Cloudy
1/23/2022 4:00,4,38,5106,22158,42,27264,SUNDAY,1,0,-6.7,77,9.4,1018.6,Rain
1/23/2022 5:00,12,37,366888,34868,49,401756,SUNDAY,1,0,-6.7,77,13,1017.5,Cloudy
1/23/2022 6:00,20,27,20146,22612,47,42758,SUNDAY,1,0,-6.7,81,16.6,1016.5,Cloudy
1/23/2022 7:00,12,19,14915,15451,31,30366,SUNDAY,1,0,-6.7,77,16.6,1016,Fair
1/23/2022 8:00,2,9,3313,34732,11,38045,SUNDAY,1,0,-6.7,77,22.3,1015.4,Fair
1/23/2022 9:00,0,2,0,1437,2,1437,SUNDAY,1,0,-6.1,78,22.3,1014.3,Fair
1/23/2022 10:00,1,10,97725,5606,11,103331,SUNDAY,1,0,-6.1,74,20.5,1014,Cloudy
1/23/2022 11:00,2,16,1850,9948,18,11798,SUNDAY,1,0,-6.1,74,16.6,1013.7,Cloudy
1/23/2022 12:00,2,19,3349,12512,21,15861,SUNDAY,1,0,-5.6,65,18.4,1014,Cloudy
1/23/2022 13:00,4,46,5238,36787,50,42025,SUNDAY,1,0,-5,59,14.8,1013.4,Cloudy
1/23/2022 14:00,7,92,5082,55715,99,60797,SUNDAY,1,0,-4.4,55,14.8,1012.8,Cloudy
1/23/2022 15:00,26,146,27615,100896,172,128511,SUNDAY,1,0,-3.3,50,16.6,1012.4,Cloudy
1/23/2022 16:00,27,189,35093,150604,216,185697,SUNDAY,1,0,-1.7,45,14.8,1011.7,Cloudy
1/23/2022 17:00,36,244,55644,177116,280,232760,SUNDAY,1,0,0.6,38,18.4,1010.3,Cloudy
1/23/2022 18:00,37,233,56869,182336,270,239205,SUNDAY,1,0,1.1,38,16.6,1009.3,Cloudy
1/23/2022 19:00,36,218,54458,155093,254,209551,SUNDAY,1,0,1.7,35,22.3,1008.4,Cloudy
1/23/2022 20:00,42,246,63560,213859,288,277419,SUNDAY,1,0,1.1,35,18.4,1007.9,Cloudy
1/23/2022 21:00,60,226,409472,177723,286,587195,SUNDAY,1,0,1.1,36,13,1007.6,Cloudy
1/23/2022 22:00,32,210,27998,215496,242,243494,SUNDAY,1,0,0,43,16.6,1008,Cloudy
1/23/2022 23:00,28,164,43946,119099,192,163045,SUNDAY,1,0,-0.6,45,11.2,1008.1,Cloudy
1/24/2022 0:00,16,121,18123,83107,137,101230,MONDAY,0,0,0,45,5.4,1008.4,Cloudy
1/24/2022 1:00,8,86,13775,58318,94,72093,MONDAY,0,0,0.6,45,14.8,1008.8,Cloudy
1/24/2022 2:00,10,68,10072,46567,78,56639,MONDAY,0,0,0,51,14.8,1008.7,Cloudy
1/24/2022 3:00,7,49,4260,27711,56,31971,MONDAY,0,0,-0.6,51,20.5,1009,Snow
1/24/2022 4:00,2,19,1628,11794,21,13422,MONDAY,0,0,-2.2,81,11.2,1009.4,Cloudy
1/24/2022 5:00,0,10,0,5169,10,5169,MONDAY,0,0,-2.2,85,7.6,1009,Cloudy
1/24/2022 6:00,1,5,1684,5429,6,7113,MONDAY,0,0,-2.2,78,7.6,1008.7,Cloudy
1/24/2022 7:00,2,6,1367,4107,8,5474,MONDAY,0,0,-2.2,78,11.2,1008.8,Cloudy
1/24/2022 8:00,0,4,0,1797,4,1797,MONDAY,0,0,-2.2,78,9.4,1009,Cloudy
1/24/2022 9:00,0,4,0,2467,4,2467,MONDAY,0,0,-3.3,77,11.2,1009.6,Cloudy
1/24/2022 10:00,3,23,1200,16205,26,17405,MONDAY,0,0,-3.3,74,11.2,1010.2,Fair
1/24/2022 11:00,2,63,1224,41642,65,42866,MONDAY,0,0,-3.9,74,16.6,1011.2,Fair
1/24/2022 12:00,7,129,5748,103495,136,109243,MONDAY,0,0,-5,74,13,1012.2,Fair
1/24/2022 13:00,14,298,10930,206394,312,217324,MONDAY,0,0,-5,68,18.4,1012.9,Fair
1/24/2022 14:00,12,215,12738,158347,227,171085,MONDAY,0,0,-5,62,16.6,1013.6,Fair
1/24/2022 15:00,15,161,19942,104237,176,124179,MONDAY,0,0,-3.3,52,16.6,1013.9,Fair
1/24/2022 16:00,19,138,18869,99453,157,118322,MONDAY,0,0,-3.3,52,13,1014,Cloudy
1/24/2022 17:00,25,160,27905,98441,185,126346,MONDAY,0,0,-2.8,44,11.2,1013.5,Cloudy
1/24/2022 18:00,21,162,22414,113166,183,135580,MONDAY,0,0,-2.2,44,5.4,1012.6,Cloudy
1/24/2022 19:00,25,213,39149,153963,238,193112,MONDAY,0,0,-1.1,41,0,1012.2,Cloudy
1/24/2022 20:00,20,191,22593,128886,211,151479,MONDAY,0,0,-2.2,46,9.4,1012.3,Cloudy
1/24/2022 21:00,25,263,159903,186944,288,346847,MONDAY,0,0,-2.2,48,13,1011.9,Cloudy
1/24/2022 22:00,23,382,32741,784372,405,817113,MONDAY,0,0,-2.8,53,9.4,1012.2,Cloudy
1/24/2022 23:00,25,327,30268,285736,352,316004,MONDAY,0,0,-2.2,55,13,1012.9,Cloudy
1/25/2022 0:00,14,234,17445,146416,248,163861,TUESDAY,0,0,-2.2,60,14.8,1013.4,Cloudy
1/25/2022 1:00,11,152,8316,105258,163,113574,TUESDAY,0,0,-1.7,61,13,1013.5,Cloudy
1/25/2022 2:00,12,106,12214,77173,118,89387,TUESDAY,0,0,-1.7,66,16.6,1013.1,Cloudy
1/25/2022 3:00,5,52,4850,33246,57,38096,TUESDAY,0,0,-1.1,69,14.8,1012.8,Snow
1/25/2022 4:00,4,23,10333,16234,27,26567,TUESDAY,0,0,-1.7,82,9.4,1013.1,Snow
1/25/2022 5:00,0,6,0,3256,6,3256,TUESDAY,0,0,-2.2,92,11.2,1013.1,Snow
1/25/2022 6:00,1,8,400,4225,9,4625,TUESDAY,0,0,-2.2,96,7.6,1012.6,Snow
1/25/2022 7:00,1,2,923,1224,3,2147,TUESDAY,0,0,-1.7,92,11.2,1012.3,Snow
1/25/2022 8:00,0,3,0,1296,3,1296,TUESDAY,0,0,-1.7,92,11.2,1011.9,Snow
1/25/2022 9:00,0,7,0,5894,7,5894,TUESDAY,0,0,-1.1,88,9.4,1011.6,Snow
1/25/2022 10:00,1,20,684,11094,21,11778,TUESDAY,0,0,-1.1,92,13,1011.1,Snow
1/25/2022 11:00,3,51,1791,35356,54,37147,TUESDAY,0,0,-0.6,92,13,1010.9,Cloudy
1/25/2022 12:00,11,174,8775,148175,185,156950,TUESDAY,0,0,0,92,7.6,1011.1,Cloudy
1/25/2022 13:00,16,292,18261,242017,308,260278,TUESDAY,0,0,0.6,92,9.4,1011.4,Cloudy
1/25/2022 14:00,11,219,17318,139601,230,156919,TUESDAY,0,0,1.1,88,9.4,1011.9,Cloudy
1/25/2022 15:00,20,172,19228,113672,192,132900,TUESDAY,0,0,2.2,82,14.8,1012.5,Cloudy
1/25/2022 16:00,13,160,10931,107184,173,118115,TUESDAY,0,0,3.3,70,20.5,1012.8,Cloudy
1/25/2022 17:00,18,227,90778,148521,245,239299,TUESDAY,0,0,3.3,67,18.4,1012.6,Cloudy
1/25/2022 18:00,37,231,36051,155829,268,191880,TUESDAY,0,0,3.3,67,18.4,1012.4,Cloudy
1/25/2022 19:00,31,213,32587,151269,244,183856,TUESDAY,0,0,4.4,57,9.4,1012.1,Cloudy
1/25/2022 20:00,32,258,34542,330877,290,365419,TUESDAY,0,0,3.9,59,16.6,1013.2,Cloudy
1/25/2022 21:00,34,328,35169,245744,362,280913,TUESDAY,0,0,3.9,55,11.2,1013.6,Cloudy
1/25/2022 22:00,44,477,60853,360852,521,421705,TUESDAY,0,0,2.8,54,16.6,1014.6,Fair
1/25/2022 23:00,36,345,531221,247982,381,779203,TUESDAY,0,0,2.2,52,20.5,1015.9,Cloudy
1/26/2022 0:00,27,267,22012,215368,294,237380,WEDNESDAY,0,0,0.6,51,16.6,1017.2,Fair
1/26/2022 1:00,14,163,9494,102350,177,111844,WEDNESDAY,0,0,0,43,20.5,1018,Fair
1/26/2022 2:00,15,112,34476,73722,127,108198,WEDNESDAY,0,0,-0.6,41,22.3,1018.6,Fair
1/26/2022 3:00,15,84,16803,50372,99,67175,WEDNESDAY,0,0,-1.1,44,16.6,1019.2,Fair
1/26/2022 4:00,7,36,4430,20689,43,25119,WEDNESDAY,0,0,-1.7,46,13,1019.7,Clear
1/26/2022 5:00,7,13,4209,7688,20,11897,WEDNESDAY,0,0,-2.2,48,16.6,1019.8,Fair
1/26/2022 6:00,8,4,10296,1850,12,12146,WEDNESDAY,0,0,-2.8,48,20.5,1020,Clear
1/26/2022 7:00,0,2,0,978,2,978,WEDNESDAY,0,0,-3.9,48,20.5,1020.7,Clear
1/26/2022 8:00,0,6,0,6428,6,6428,WEDNESDAY,0,0,-4.4,43,14.8,1021.5,Clear
1/26/2022 9:00,0,2,0,649,2,649,WEDNESDAY,0,0,-5,45,16.6,1021.9,Clear
1/26/2022 10:00,2,29,1407,17217,31,18624,WEDNESDAY,0,0,-5.6,50,14.8,1022.6,Clear
1/26/2022 11:00,3,76,1525,48262,79,49787,WEDNESDAY,0,0,-5.6,45,16.6,1022.9,Fair
1/26/2022 12:00,7,177,5336,117872,184,123208,WEDNESDAY,0,0,-6.7,47,16.6,1023.8,Fair
1/26/2022 13:00,23,353,16317,231710,376,248027,WEDNESDAY,0,0,-6.1,43,16.6,1024.2,Fair
1/26/2022 14:00,17,235,13747,151387,252,165134,WEDNESDAY,0,0,-5.6,41,18.4,1024.9,Fair
1/26/2022 15:00,9,171,7257,126417,180,133674,WEDNESDAY,0,0,-5,39,14.8,1025.5,Fair
1/26/2022 16:00,16,160,10230,105003,176,115233,WEDNESDAY,0,0,-5,39,20.5,1025.6,Fair
1/26/2022 17:00,17,180,12273,132896,197,145169,WEDNESDAY,0,0,-4.4,38,18.4,1025,Fair
1/26/2022 18:00,16,208,14301,138672,224,152973,WEDNESDAY,0,0,-4.4,36,22.3,1024.3,Fair
1/26/2022 19:00,16,205,10923,136075,221,146998,WEDNESDAY,0,0,-3.9,35,25.9,1024.5,Fair
1/26/2022 20:00,12,216,11600,143132,228,154732,WEDNESDAY,0,0,-4.4,33,22.3,1024.9,Fair
1/26/2022 21:00,16,263,16479,183713,279,200192,WEDNESDAY,0,0,-5,31,20.5,1025.7,Fair
1/26/2022 22:00,32,360,36687,261012,392,297699,WEDNESDAY,0,0,-6.1,32,24.1,1026.9,Fair
1/26/2022 23:00,24,301,21100,182036,325,203136,WEDNESDAY,0,0,-6.7,32,24.1,1028.1,Fair
1/27/2022 0:00,14,202,12825,120683,216,133508,THURSDAY,0,0,-7.2,34,27.7,1029.7,Fair
1/27/2022 1:00,9,136,7248,82643,145,89891,THURSDAY,0,0,-8.3,33,25.9,1030.5,Clear
1/27/2022 2:00,9,87,19061,48647,96,67708,THURSDAY,0,0,-8.9,33,18.4,1031,Clear
1/27/2022 3:00,6,62,2971,43338,68,46309,THURSDAY,0,0,-10,34,16.6,1031.4,Clear
1/27/2022 4:00,4,48,2516,21448,52,23964,THURSDAY,0,0,-10.6,36,14.8,1031.8,Clear
1/27/2022 5:00,1,11,537,6608,12,7145,THURSDAY,0,0,-11.1,40,18.4,1031.7,Clear
1/27/2022 6:00,1,8,1036,5869,9,6905,THURSDAY,0,0,-11.1,38,14.8,1031.9,Clear
1/27/2022 7:00,0,3,0,4401,3,4401,THURSDAY,0,0,-11.7,39,16.6,1032.3,Clear
1/27/2022 8:00,0,4,0,1769,4,1769,THURSDAY,0,0,-12.2,43,7.6,1032.3,Clear
1/27/2022 9:00,1,6,558,3896,7,4454,THURSDAY,0,0,-12.8,45,11.2,1032.2,Clear
1/27/2022 10:00,0,25,0,15418,25,15418,THURSDAY,0,0,-12.8,45,11.2,1032.2,Clear
1/27/2022 11:00,4,46,2813,27358,50,30171,THURSDAY,0,0,-12.2,45,11.2,1032.5,Fair
1/27/2022 12:00,7,131,3157,84412,138,87569,THURSDAY,0,0,-12.2,48,11.2,1032.8,Fair
1/27/2022 13:00,18,249,12066,167747,267,179813,THURSDAY,0,0,-11.7,48,7.6,1033.1,Fair
1/27/2022 14:00,9,219,6212,183987,228,190199,THURSDAY,0,0,-10.6,44,7.6,1032.9,Fair
1/27/2022 15:00,8,171,4792,107443,179,112235,THURSDAY,0,0,-8.3,37,0,1032.4,Fair
1/27/2022 16:00,14,143,12501,101324,157,113825,THURSDAY,0,0,-7.2,34,0,1031.6,Cloudy
1/27/2022 17:00,22,173,390225,115158,195,505383,THURSDAY,0,0,-5.6,30,14.8,1030.1,Cloudy
1/27/2022 18:00,18,195,17486,117427,213,134913,THURSDAY,0,0,-4.4,27,11.2,1028.6,Cloudy
1/27/2022 19:00,32,189,30412,138395,221,168807,THURSDAY,0,0,-3.3,25,18.4,1027.6,Cloudy
1/27/2022 20:00,27,208,46635,140687,235,187322,THURSDAY,0,0,-3.3,26,22.3,1026.9,Cloudy
1/27/2022 21:00,25,279,27474,192985,304,220459,THURSDAY,0,0,-3.3,29,20.5,1026.3,Cloudy
1/27/2022 22:00,29,392,100218,289830,421,390048,THURSDAY,0,0,-3.9,33,20.5,1026.3,Fair
1/27/2022 23:00,19,294,18081,208450,313,226531,THURSDAY,0,0,-3.9,46,18.4,1025.9,Fair
1/28/2022 0:00,16,245,13218,240561,261,253779,FRIDAY,0,0,-4.4,52,20.5,1025.9,Fair
1/28/2022 1:00,25,148,21352,101562,173,122914,FRIDAY,0,0,-5,52,14.8,1025.4,Fair
1/28/2022 2:00,9,117,9113,115767,126,124880,FRIDAY,0,0,-5,54,20.5,1024.7,Cloudy
1/28/2022 3:00,10,69,4775,44535,79,49310,FRIDAY,0,0,-5,59,18.4,1024.1,Cloudy
1/28/2022 4:00,11,43,8567,28276,54,36843,FRIDAY,0,0,-5,65,14.8,1023.3,Cloudy
1/28/2022 5:00,5,17,3881,7182,22,11063,FRIDAY,0,0,-3.3,65,18.4,1022.5,Cloudy
1/28/2022 6:00,11,22,10385,14699,33,25084,FRIDAY,0,0,-3.3,65,14.8,1021.8,Cloudy
1/28/2022 7:00,4,5,3795,11347,9,15142,FRIDAY,0,0,-2.8,69,14.8,1021.4,Cloudy
1/28/2022 8:00,0,4,0,1949,4,1949,FRIDAY,0,0,-2.8,66,18.4,1020.7,Cloudy
1/28/2022 9:00,1,7,649,2919,8,3568,FRIDAY,0,0,-2.2,63,20.5,1020.4,Cloudy
1/28/2022 10:00,3,24,1801,16079,27,17880,FRIDAY,0,0,-1.7,58,18.4,1020.1,Cloudy
1/28/2022 11:00,4,64,4006,42633,68,46639,FRIDAY,0,0,-2.2,58,16.6,1020.5,Cloudy
1/28/2022 12:00,7,181,3738,131536,188,135274,FRIDAY,0,0,-2.2,55,16.6,1020.9,Cloudy
1/28/2022 13:00,19,284,18004,203998,303,222002,FRIDAY,0,0,-1.7,53,14.8,1020.8,Cloudy
1/28/2022 14:00,10,232,31561,150131,242,181692,FRIDAY,0,0,-1.1,51,14.8,1020.8,Cloudy
1/28/2022 15:00,16,183,32870,110258,199,143128,FRIDAY,0,0,-0.6,51,0,1020.4,Cloudy
1/28/2022 16:00,21,200,18066,126142,221,144208,FRIDAY,0,0,0,47,9.4,1020.4,Cloudy
1/28/2022 17:00,20,263,27497,182931,283,210428,FRIDAY,0,0,1.1,43,7.6,1019.7,Cloudy
1/28/2022 18:00,30,253,38894,164193,283,203087,FRIDAY,0,0,1.1,46,7.6,1019.3,Cloudy
1/28/2022 19:00,55,252,91861,165137,307,256998,FRIDAY,0,0,1.7,44,7.6,1019.2,Cloudy
1/28/2022 20:00,32,337,26081,224856,369,250937,FRIDAY,0,0,1.7,47,0,1019.3,Snow
1/28/2022 21:00,53,395,66911,278337,448,345248,FRIDAY,0,0,1.1,52,9.4,1019.2,Snow
1/28/2022 22:00,59,442,360597,343119,501,703716,FRIDAY,0,0,0.6,56,5.4,1019.1,Cloudy
1/28/2022 23:00,38,323,33413,223608,361,257021,FRIDAY,0,0,0,66,5.4,1019.5,Cloudy
1/29/2022 0:00,43,263,37563,202491,306,240054,SATURDAY,1,0,0,64,7.6,1019.4,Cloudy
1/29/2022 1:00,28,179,30563,134473,207,165036,SATURDAY,1,0,-1.1,63,11.2,1018.7,Snow
1/29/2022 2:00,15,90,11908,61083,105,72991,SATURDAY,1,0,-0.6,66,13,1018.9,Snow
1/29/2022 3:00,32,106,175674,67357,138,243031,SATURDAY,1,0,0,58,13,1018.5,Snow
1/29/2022 4:00,12,53,12530,36076,65,48606,SATURDAY,1,0,0,64,16.6,1017.7,Snow
1/29/2022 5:00,5,17,3631,9964,22,13595,SATURDAY,1,0,-1.7,89,20.5,1016.8,Snow
1/31/2022 10:00,1,17,498,15016,18,15514,MONDAY,0,0,-9.4,46,13,1024.4,Clear
1/31/2022 11:00,1,27,572,17841,28,18413,MONDAY,0,0,-10,51,14.8,1025.2,Fair
1/31/2022 12:00,9,68,7977,75716,77,83693,MONDAY,0,0,-9.4,51,14.8,1026,Fair
1/31/2022 13:00,10,158,10944,149028,168,159972,MONDAY,0,0,-8.3,49,9.4,1026.9,Fair
1/31/2022 14:00,8,161,5352,142459,169,147811,MONDAY,0,0,-6.7,43,7.6,1027.7,Fair
1/31/2022 15:00,6,93,6654,68224,99,74878,MONDAY,0,0,-6.1,47,0,1028.1,Fair
1/31/2022 16:00,4,79,5008,63689,83,68697,MONDAY,0,0,-3.9,38,0,1028.4,Fair
1/31/2022 17:00,5,98,8570,81379,103,89949,MONDAY,0,0,-2.8,39,5.4,1028.2,Fair
1/31/2022 18:00,13,108,20074,78609,121,98683,MONDAY,0,0,-2.2,37,7.6,1027.6,Fair
1/31/2022 19:00,6,149,26482,107293,155,133775,MONDAY,0,0,-1.1,36,5.4,1027.6,Fair
1/31/2022 20:00,16,152,23016,135444,168,158460,MONDAY,0,0,-1.7,37,7.6,1027.9,Fair
1/31/2022 21:00,13,214,37481,171273,227,208754,MONDAY,0,0,-2.2,46,13,1028.3,Fair
1/31/2022 22:00,19,279,21606,232807,298,254413,MONDAY,0,0,-3.3,44,11.2,1029.2,Fair
1/31/2022 23:00,15,217,14483,211713,232,226196,MONDAY,0,0,-3.3,48,9.4,1030,Fair
2/1/2022 0:00,8,134,7222,107862,142,115084,TUESDAY,0,0,-3.3,52,5.4,1030.8,Fair
2/1/2022 1:00,6,84,249606,64406,90,314012,TUESDAY,0,0,-3.3,50,7.6,1031.6,Fair
2/1/2022 2:00,4,68,7077,47936,72,55013,TUESDAY,0,0,-3.9,55,9.4,1032.2,Clear
2/1/2022 3:00,2,41,1611,28986,43,30597,TUESDAY,0,0,-5,57,0,1032.5,Clear
2/1/2022 4:00,1,25,643,95390,26,96033,TUESDAY,0,0,-4.4,55,9.4,1032.9,Clear
2/1/2022 5:00,2,13,5111,8491,15,13602,TUESDAY,0,0,-4.4,52,11.2,1033.1,Clear
2/1/2022 6:00,2,6,2301,34895,8,37196,TUESDAY,0,0,-6.1,59,7.6,1033.2,Clear
2/1/2022 7:00,0,1,0,953,1,953,TUESDAY,0,0,-6.1,57,11.2,1033.4,Clear
2/1/2022 8:00,0,2,0,428,2,428,TUESDAY,0,0,-6.1,54,11.2,1033.8,Clear
2/1/2022 9:00,0,4,0,2980,4,2980,TUESDAY,0,0,-6.7,59,13,1034.1,Clear
2/1/2022 10:00,0,13,0,13876,13,13876,TUESDAY,0,0,-7.2,64,16.6,1034.5,Fair
2/1/2022 11:00,0,48,0,33307,48,33307,TUESDAY,0,0,-7.8,67,16.6,1034.7,Fair
2/1/2022 12:00,7,123,6180,132715,130,138895,TUESDAY,0,0,-7.2,68,16.6,1035.2,Fair
2/1/2022 13:00,17,258,11992,193669,275,205661,TUESDAY,0,0,-6.7,68,14.8,1035.5,Fair
2/1/2022 14:00,9,210,6612,175669,219,182281,TUESDAY,0,0,-5.6,68,11.2,1036.1,Fair
2/1/2022 15:00,8,155,259500,96780,163,356280,TUESDAY,0,0,-4.4,65,13,1035.9,Fair
2/1/2022 16:00,1,111,766,198686,112,199452,TUESDAY,0,0,-1.7,63,16.6,1036.1,Cloudy
2/1/2022 17:00,12,164,25274,100328,176,125602,TUESDAY,0,0,-1.1,60,14.8,1036.3,Cloudy
2/1/2022 18:00,12,118,10882,87590,130,98472,TUESDAY,0,0,0,64,11.2,1035.4,Cloudy
2/1/2022 19:00,13,165,14611,114241,178,128852,TUESDAY,0,0,1.7,66,18.4,1034.7,Cloudy
2/1/2022 20:00,12,157,9052,118709,169,127761,TUESDAY,0,0,1.1,73,18.4,1034.5,Cloudy
2/1/2022 21:00,17,271,18091,1716606,288,1734697,TUESDAY,0,0,1.7,72,16.6,1034.2,Cloudy
2/1/2022 22:00,11,316,11404,236928,327,248332,TUESDAY,0,0,1.7,78,16.6,1034.2,Cloudy
2/1/2022 23:00,14,285,15005,256836,299,271841,TUESDAY,0,0,1.1,82,9.4,1035.1,Cloudy
2/2/2022 0:00,13,204,8769,135680,217,144449,WEDNESDAY,0,0,1.7,75,13,1035.9,Cloudy
2/2/2022 1:00,12,119,13209,80684,131,93893,WEDNESDAY,0,0,1.7,72,24.1,1035.7,Cloudy
2/2/2022 2:00,5,112,3812,80051,117,83863,WEDNESDAY,0,0,1.7,75,20.5,1035.6,Cloudy
2/2/2022 3:00,4,72,3370,47116,76,50486,WEDNESDAY,0,0,1.1,82,13,1035.2,Cloudy
2/2/2022 4:00,2,33,7287,18510,35,25797,WEDNESDAY,0,0,1.1,73,5.4,1035.1,Cloudy
2/2/2022 5:00,3,13,6030,12136,16,18166,WEDNESDAY,0,0,1.7,69,5.4,1034.5,Cloudy
2/2/2022 6:00,0,8,0,3749,8,3749,WEDNESDAY,0,0,-0.6,85,0,1034.1,Cloudy
2/2/2022 7:00,2,3,1441,1957,5,3398,WEDNESDAY,0,0,0,81,0,1034.2,Snow
2/2/2022 8:00,2,3,23451,1808,5,25259,WEDNESDAY,0,0,0.6,78,5.4,1034.1,Cloudy
2/2/2022 9:00,2,3,1103,2113,5,3216,WEDNESDAY,0,0,0,81,0,1033.3,Cloudy
2/2/2022 10:00,1,23,444,17473,24,17917,WEDNESDAY,0,0,0,79,0,1033.2,Cloudy
2/2/2022 11:00,2,72,1618,48386,74,50004,WEDNESDAY,0,0,0.6,78,0,1033.4,Cloudy
2/2/2022 12:00,9,163,9603,124774,172,134377,WEDNESDAY,0,0,0.6,78,0,1033.2,Cloudy
2/2/2022 13:00,21,336,19435,416443,357,435878,WEDNESDAY,0,0,0.6,78,7.6,1033.7,Cloudy
2/2/2022 14:00,15,243,15476,161566,258,177042,WEDNESDAY,0,0,0.6,85,7.6,1033.4,Cloudy
2/2/2022 15:00,9,156,8432,193920,165,202352,WEDNESDAY,0,0,1.1,85,0,1033.3,Cloudy
2/2/2022 16:00,4,156,2878,116181,160,119059,WEDNESDAY,0,0,1.7,85,0,1033.1,Cloudy
2/2/2022 17:00,10,197,9603,132982,207,142585,WEDNESDAY,0,0,3.9,82,0,1032.1,Cloudy
2/2/2022 18:00,16,193,27858,244770,209,272628,WEDNESDAY,0,0,3.9,86,0,1031,Cloudy
2/2/2022 19:00,13,228,10703,157502,241,168205,WEDNESDAY,0,0,4.4,86,0,1030.7,Cloudy
2/2/2022 20:00,22,225,27344,163512,247,190856,WEDNESDAY,0,0,3.9,86,14.8,1029.7,Cloudy
2/2/2022 21:00,32,324,30237,249023,356,279260,WEDNESDAY,0,0,3.9,86,7.6,1029.5,Cloudy
2/2/2022 22:00,19,404,16356,312994,423,329350,WEDNESDAY,0,0,4.4,89,0,1029.4,Cloudy
2/2/2022 23:00,33,306,166325,221043,339,387368,WEDNESDAY,0,0,3.3,97,5.4,1028.8,Cloudy
2/3/2022 0:00,26,250,26261,182745,276,209006,THURSDAY,0,0,3.3,100,0,1028.7,Cloudy
2/3/2022 1:00,17,161,18651,120777,178,139428,THURSDAY,0,0,3.3,97,0,1028.4,Cloudy
2/3/2022 2:00,22,143,29118,100574,165,129692,THURSDAY,0,0,3.9,93,0,1027.9,Cloudy
2/3/2022 3:00,14,106,17264,80823,120,98087,THURSDAY,0,0,3.3,93,0,1027.1,Cloudy
2/3/2022 4:00,10,53,10291,32808,63,43099,THURSDAY,0,0,1.7,100,9.4,1026.1,Cloudy
2/3/2022 5:00,6,22,4218,11819,28,16037,THURSDAY,0,0,2.2,97,5.4,1025.1,Cloudy
2/3/2022 6:00,7,8,4885,6383,15,11268,THURSDAY,0,0,3.3,97,5.4,1025.1,Cloudy
2/3/2022 7:00,0,6,0,3732,6,3732,THURSDAY,0,0,3.9,93,16.6,1025.2,Cloudy
2/3/2022 8:00,0,5,0,2968,5,2968,THURSDAY,0,0,2.8,100,13,1024.9,Cloudy
2/3/2022 9:00,2,6,2914,2869,8,5783,THURSDAY,0,0,3.3,97,18.4,1024.8,Cloudy
2/3/2022 10:00,2,27,1440,20972,29,22412,THURSDAY,0,0,2.2,100,13,1024.3,Cloudy
2/3/2022 11:00,4,70,2529,43213,74,45742,THURSDAY,0,0,3.3,97,14.8,1024.8,Cloudy
2/3/2022 12:00,13,188,13317,134413,201,147730,THURSDAY,0,0,3.9,96,16.6,1024.9,Cloudy
2/3/2022 13:00,12,328,6994,220546,340,227540,THURSDAY,0,0,4.4,97,18.4,1025.1,Cloudy
2/3/2022 14:00,9,262,10560,166813,271,177373,THURSDAY,0,0,5,96,18.4,1025.5,Cloudy
2/3/2022 15:00,10,207,10300,164079,217,174379,THURSDAY,0,0,5,96,16.6,1025.7,Rain
2/3/2022 16:00,9,163,6578,109646,172,116224,THURSDAY,0,0,5,96,13,1025.3,Rain
2/3/2022 17:00,14,201,14298,151491,215,165789,THURSDAY,0,0,7.2,86,16.6,1024.2,Rain
2/3/2022 18:00,14,162,15088,199664,176,214752,THURSDAY,0,0,8.3,86,11.2,1023.6,Rain
2/3/2022 19:00,22,175,19282,123922,197,143204,THURSDAY,0,0,5.6,96,13,1023.3,Rain
2/3/2022 20:00,15,169,10924,116944,184,127868,THURSDAY,0,0,6.1,100,7.6,1023.5,Rain
2/3/2022 21:00,15,185,21252,129576,200,150828,THURSDAY,0,0,5.6,100,11.2,1022.5,Rain
2/3/2022 22:00,21,264,35180,200687,285,235867,THURSDAY,0,0,7.2,97,7.6,1022.8,Rain
2/3/2022 23:00,15,209,177392,149642,224,327034,THURSDAY,0,0,5.6,100,9.4,1022.9,Rain
2/4/2022 0:00,16,191,31260,122659,207,153919,FRIDAY,0,0,5.6,96,0,1022.4,Cloudy
2/4/2022 1:00,11,121,8438,90662,132,99100,FRIDAY,0,0,4.4,100,11.2,1021.3,Rain
2/4/2022 2:00,5,109,5169,74398,114,79567,FRIDAY,0,0,3.3,100,5.4,1020.5,Rain
2/4/2022 3:00,14,83,18532,55536,97,74068,FRIDAY,0,0,2.8,100,9.4,1019.3,Cloudy
2/4/2022 4:00,7,52,26098,85538,59,111636,FRIDAY,0,0,3.9,100,7.6,1018.5,Rain
2/4/2022 5:00,4,26,2841,18955,30,21796,FRIDAY,0,0,3.3,100,11.2,1017.8,Rain
2/4/2022 6:00,7,18,7578,10677,25,18255,FRIDAY,0,0,3.9,100,7.6,1017.1,Rain
2/4/2022 7:00,9,10,10134,5420,19,15554,FRIDAY,0,0,4.4,97,11.2,1016.2,Rain
2/4/2022 8:00,2,8,5007,6914,10,11921,FRIDAY,0,0,3.9,100,7.6,1015.2,Rain
2/4/2022 9:00,2,0,586,0,2,586,FRIDAY,0,0,3.3,100,13,1014.6,Rain
2/4/2022 10:00,1,10,161,8831,11,8992,FRIDAY,0,0,3.3,97,20.5,1014.5,Rain
2/4/2022 11:00,1,22,1036,12179,23,13215,FRIDAY,0,0,1.7,96,22.3,1014.2,Rain
2/4/2022 12:00,4,53,2703,37376,57,40079,FRIDAY,0,0,1.1,92,24.1,1014.8,Rain
2/4/2022 13:00,3,88,2032,56704,91,58736,FRIDAY,0,0,0.6,92,31.7,1014.8,Rain
2/4/2022 14:00,4,69,4729,39391,73,44120,FRIDAY,0,0,0,92,24.1,1014.8,Snow
2/4/2022 15:00,5,58,5011,35953,63,40964,FRIDAY,0,0,-0.6,92,24.1,1015.6,Snow
2/4/2022 16:00,2,62,1348,42090,64,43438,FRIDAY,0,0,-0.6,92,18.4,1014.8,Rain
2/4/2022 17:00,2,77,4099,51837,79,55936,FRIDAY,0,0,-1.1,92,24.1,1014.1,Snow
2/4/2022 18:00,5,38,6367,24005,43,30372,FRIDAY,0,0,-1.7,89,25.9,1014,Snow
2/4/2022 19:00,7,58,12054,37785,65,49839,FRIDAY,0,0,-2.2,88,22.3,1013.7,Snow
2/4/2022 20:00,3,44,5325,28826,47,34151,FRIDAY,0,0,-2.8,81,18.4,1013.7,Snow
2/4/2022 21:00,6,82,5425,53991,88,59416,FRIDAY,0,0,-3.3,88,14.8,1013.8,Snow
2/4/2022 22:00,5,95,3349,316498,100,319847,FRIDAY,0,0,-2.8,92,16.6,1014,Snow
2/4/2022 23:00,4,69,5701,58150,73,63851,FRIDAY,0,0,-3.3,88,20.5,1014.2,Snow
2/5/2022 0:00,2,56,1097,42136,58,43233,SATURDAY,1,0,-3.9,88,20.5,1015.2,Snow
2/5/2022 1:00,4,41,3572,32634,45,36206,SATURDAY,1,0,-4.4,84,16.6,1015.7,Snow
2/5/2022 2:00,4,26,4552,20337,30,24889,SATURDAY,1,0,-5,81,20.5,1014.8,Snow
2/5/2022 3:00,1,19,322,12301,20,12623,SATURDAY,1,0,-5,81,18.4,1016,Snow
2/5/2022 4:00,6,16,5957,15240,22,21197,SATURDAY,1,0,-5.6,81,20.5,1015.1,Snow
2/5/2022 5:00,4,19,4951,18368,23,23319,SATURDAY,1,0,-5.6,81,18.4,1014.1,Cloudy
2/5/2022 6:00,28,18,326874,17804,46,344678,SATURDAY,1,0,-5.6,85,14.8,1014.4,Snow
2/5/2022 7:00,9,12,11086,8167,21,19253,SATURDAY,1,0,-6.1,84,16.6,1014.2,Cloudy
2/5/2022 8:00,3,4,1358,3160,7,4518,SATURDAY,1,0,-6.1,81,14.8,1013.9,Cloudy
2/5/2022 9:00,1,5,393,4836,6,5229,SATURDAY,1,0,-6.1,84,13,1013.5,Cloudy
2/5/2022 10:00,0,6,0,6160,6,6160,SATURDAY,1,0,-6.1,81,11.2,1014.8,Cloudy
2/5/2022 11:00,0,8,0,3860,8,3860,SATURDAY,1,0,-5.6,81,14.8,1014.6,Cloudy
2/5/2022 12:00,2,19,1192,13868,21,15060,SATURDAY,1,0,-5.6,78,20.5,1015.7,Cloudy
2/5/2022 13:00,5,36,5162,26150,41,31312,SATURDAY,1,0,-6.1,71,20.5,1016.7,Snow
2/5/2022 14:00,3,67,1227,45913,70,47140,SATURDAY,1,0,-6.1,74,24.1,1017.5,Cloudy
2/5/2022 15:00,8,84,8406,59549,92,67955,SATURDAY,1,0,-6.1,62,35.3,1018.7,Cloudy
2/5/2022 16:00,5,108,3473,91865,113,95338,SATURDAY,1,0,-5.6,65,24.1,1019.1,Rain
2/5/2022 17:00,9,138,18129,106760,147,124889,SATURDAY,1,0,-5,57,25.9,1019.2,Fair
2/5/2022 18:00,17,122,16137,88432,139,104569,SATURDAY,1,0,-5,52,33.5,1019.9,Fair
2/5/2022 19:00,15,148,16734,140878,163,157612,SATURDAY,1,0,-4.4,52,31.7,1021.2,Fair
2/5/2022 20:00,19,157,29086,118018,176,147104,SATURDAY,1,0,-4.4,50,25.9,1022.6,Fair
2/5/2022 21:00,24,178,17735,129194,202,146929,SATURDAY,1,0,-4.4,48,24.1,1024,Fair
2/5/2022 22:00,23,141,17901,99289,164,117190,SATURDAY,1,0,-5,48,18.4,1025.9,Clear
2/5/2022 23:00,7,119,5960,81060,126,87020,SATURDAY,1,0,-6.1,45,27.7,1027.5,Clear
2/6/2022 0:00,16,105,22427,76120,121,98547,SUNDAY,1,0,-6.7,43,27.7,1029,Clear
2/6/2022 1:00,9,75,10740,52245,84,62985,SUNDAY,1,0,-6.7,45,24.1,1030.3,Clear
2/6/2022 2:00,8,63,10621,38151,71,48772,SUNDAY,1,0,-7.2,47,20.5,1031.9,Clear
2/6/2022 3:00,11,52,12752,41646,63,54398,SUNDAY,1,0,-7.8,47,27.7,1032.5,Clear
2/6/2022 4:00,5,37,5955,22272,42,28227,SUNDAY,1,0,-8.9,49,24.1,1032.8,Clear
2/6/2022 5:00,5,36,5777,23980,41,29757,SUNDAY,1,0,-9.4,44,22.3,1033.6,Clear
2/6/2022 6:00,21,30,913645,20470,51,934115,SUNDAY,1,0,-10.6,48,22.3,1034.2,Clear
2/6/2022 7:00,21,24,1088284,20781,45,1109065,SUNDAY,1,0,-10.6,46,18.4,1035,Clear
2/6/2022 8:00,3,5,4403,2142,8,6545,SUNDAY,1,0,-11.1,48,16.6,1035.7,Clear
2/6/2022 9:00,1,6,560,3972,7,4532,SUNDAY,1,0,-11.7,50,18.4,1036.3,Clear
2/6/2022 10:00,0,6,0,3342,6,3342,SUNDAY,1,0,-12.2,52,14.8,1036.5,Clear
2/6/2022 11:00,3,14,3586,8797,17,12383,SUNDAY,1,0,-12.2,52,14.8,1037.3,Fair
2/6/2022 12:00,3,11,1844,7072,14,8916,SUNDAY,1,0,-12.2,55,11.2,1037.9,Fair
2/6/2022 13:00,4,28,3755,15498,32,19253,SUNDAY,1,0,-11.1,50,9.4,1038.5,Fair
2/6/2022 14:00,5,80,5300,49561,85,54861,SUNDAY,1,0,-10,56,11.2,1038.5,Fair
2/6/2022 15:00,17,115,23362,78915,132,102277,SUNDAY,1,0,-8.3,56,9.4,1039.3,Fair
2/6/2022 16:00,21,131,21368,95018,152,116386,SUNDAY,1,0,-5.6,55,5.4,1038.9,Cloudy
2/6/2022 17:00,18,167,27036,117821,185,144857,SUNDAY,1,0,-4.4,57,0,1038.4,Cloudy
2/6/2022 18:00,23,182,30004,144041,205,174045,SUNDAY,1,0,-5.6,71,7.6,1037.4,Cloudy
2/6/2022 19:00,31,177,39139,153345,208,192484,SUNDAY,1,0,-4.4,68,7.6,1036.5,Cloudy
2/6/2022 20:00,24,146,34205,108569,170,142774,SUNDAY,1,0,-3.9,66,9.4,1035.9,Cloudy
2/6/2022 21:00,21,184,97096,135502,205,232598,SUNDAY,1,0,-3.3,68,9.4,1035.8,Cloudy
2/6/2022 22:00,11,202,13146,141664,213,154810,SUNDAY,1,0,-3.3,65,7.6,1035.8,Cloudy
2/6/2022 23:00,15,153,63380,99649,168,163029,SUNDAY,1,0,-3.3,65,7.6,1035.5,Cloudy
2/7/2022 0:00,11,83,175481,57056,94,232537,MONDAY,0,0,-3.3,65,18.4,1035.4,Cloudy
2/7/2022 1:00,12,105,12603,66071,117,78674,MONDAY,0,0,-3.9,72,13,1035,Cloudy
2/7/2022 2:00,9,59,5423,36255,68,41678,MONDAY,0,0,-3.9,72,14.8,1034.4,Cloudy
2/7/2022 3:00,9,47,6012,27912,56,33924,MONDAY,0,0,-4.4,71,7.6,1034.5,Cloudy
2/7/2022 4:00,3,27,2158,14575,30,16733,MONDAY,0,0,-3.9,72,7.6,1034.5,Rain
2/7/2022 5:00,2,9,818,7793,11,8611,MONDAY,0,0,-4.4,74,11.2,1034,Cloudy
2/7/2022 6:00,0,3,0,2042,3,2042,MONDAY,0,0,-4.4,74,11.2,1033.8,Cloudy
2/7/2022 7:00,0,4,0,1249,4,1249,MONDAY,0,0,-5,78,5.4,1033.1,Cloudy
2/7/2022 9:00,4,5,2013,4120,9,6133,MONDAY,0,0,-4.4,88,0,1031.4,Cloudy
2/7/2022 10:00,2,26,609,19621,28,20230,MONDAY,0,0,-5.6,89,7.6,1031.1,Cloudy
2/7/2022 11:00,1,62,3627,42464,63,46091,MONDAY,0,0,-3.3,81,0,1031.2,Cloudy
2/7/2022 12:00,8,154,8754,112593,162,121347,MONDAY,0,0,-2.8,81,7.6,1030.8,Cloudy
2/7/2022 13:00,18,298,22731,208294,316,231025,MONDAY,0,0,-1.7,78,9.4,1030.6,Cloudy
2/7/2022 14:00,11,229,43896,153855,240,197751,MONDAY,0,0,-1.1,81,0,1030.2,Cloudy
2/7/2022 15:00,14,172,17457,149480,186,166937,MONDAY,0,0,0,81,5.4,1029.7,Cloudy
2/7/2022 16:00,11,169,7284,116836,180,124120,MONDAY,0,0,0.6,88,5.4,1028.8,Cloudy
2/7/2022 17:00,13,214,17012,131430,227,148442,MONDAY,0,0,0.6,88,0,1027.7,Cloudy
2/7/2022 18:00,11,158,18166,96710,169,114876,MONDAY,0,0,1.7,85,0,1026.4,Cloudy
2/7/2022 19:00,25,182,49437,111974,207,161411,MONDAY,0,0,1.7,89,9.4,1025.5,Cloudy
2/7/2022 20:00,22,168,37600,116923,190,154523,MONDAY,0,0,2.8,85,9.4,1024.5,Rain
2/7/2022 21:00,18,253,20432,171900,271,192332,MONDAY,0,0,2.8,93,14.8,1023.4,Rain
2/7/2022 22:00,22,282,20355,205250,304,225605,MONDAY,0,0,3.3,93,5.4,1023.6,Cloudy
2/7/2022 23:00,21,262,26137,185005,283,211142,MONDAY,0,0,3.9,93,11.2,1022.6,Rain
2/8/2022 0:00,26,191,25234,121424,217,146658,TUESDAY,0,0,3.3,97,16.6,1021.7,Rain
2/8/2022 1:00,2,91,2473,48819,93,51292,TUESDAY,0,0,3.9,93,13,1020.9,Rain
2/8/2022 2:00,2,74,1288,42316,76,43604,TUESDAY,0,0,4.4,93,0,1020.4,Rain
2/8/2022 3:00,3,36,2243,22622,39,24865,TUESDAY,0,0,3.3,100,13,1019.2,Rain
2/8/2022 4:00,5,29,8244,16337,34,24581,TUESDAY,0,0,3.3,100,14.8,1017.6,Rain
2/8/2022 5:00,1,12,520,7932,13,8452,TUESDAY,0,0,3.9,100,5.4,1017.1,Rain
2/8/2022 6:00,2,5,882,2931,7,3813,TUESDAY,0,0,3.9,100,9.4,1015.4,Rain
2/8/2022 7:00,2,4,1209,2295,6,3504,TUESDAY,0,0,3.3,100,9.4,1013.9,Rain
2/8/2022 8:00,0,1,0,492,1,492,TUESDAY,0,0,2.8,100,7.6,1012.6,Rain
2/8/2022 9:00,0,1,0,303,1,303,TUESDAY,0,0,2.8,96,13,1011.3,Rain
2/8/2022 10:00,2,12,455,8889,14,9344,TUESDAY,0,0,2.8,96,13,1010.7,Rain
2/8/2022 11:00,3,46,2657,29191,49,31848,TUESDAY,0,0,2.8,96,13,1010.3,Rain
2/8/2022 12:00,8,130,6894,89443,138,96337,TUESDAY,0,0,2.8,96,16.6,1008.9,Rain
2/8/2022 13:00,17,330,20725,219610,347,240335,TUESDAY,0,0,2.8,93,16.6,1009.3,Cloudy
2/8/2022 14:00,13,269,10115,203112,282,213227,TUESDAY,0,0,2.2,97,16.6,1009.5,Cloudy
2/8/2022 15:00,14,185,16515,128555,199,145070,TUESDAY,0,0,2.8,93,18.4,1009,Cloudy
2/8/2022 16:00,15,199,27808,130550,214,158358,TUESDAY,0,0,3.3,93,16.6,1009,Rain
2/8/2022 17:00,20,220,33454,154728,240,188182,TUESDAY,0,0,3.9,89,13,1008.2,Cloudy
2/8/2022 18:00,15,186,25769,125574,201,151343,TUESDAY,0,0,3.9,89,20.5,1007.9,Cloudy
2/8/2022 19:00,16,207,25756,144461,223,170217,TUESDAY,0,0,5,82,16.6,1007.7,Cloudy
2/8/2022 20:00,19,228,22851,156754,247,179605,TUESDAY,0,0,5,82,14.8,1008.1,Cloudy
2/8/2022 21:00,29,306,29536,216275,335,245811,TUESDAY,0,0,5,73,24.1,1008.3,Cloudy
2/8/2022 22:00,39,449,49171,345281,488,394452,TUESDAY,0,0,5,67,18.4,1008.9,Cloudy
2/8/2022 23:00,25,380,33798,274596,405,308394,TUESDAY,0,0,4.4,68,20.5,1009.2,Cloudy
2/9/2022 0:00,27,291,28464,195460,318,223924,WEDNESDAY,0,0,3.3,70,25.9,1010.4,Fair
2/9/2022 1:00,22,165,36765,103168,187,139933,WEDNESDAY,0,0,2.8,70,25.9,1010.2,Fair
2/9/2022 2:00,14,121,14578,80346,135,94924,WEDNESDAY,0,0,2.8,67,25.9,1010.6,Fair
2/9/2022 3:00,15,96,159228,67637,111,226865,WEDNESDAY,0,0,2.2,67,22.3,1011.2,Fair
2/9/2022 4:00,7,57,773591,44301,64,817892,WEDNESDAY,0,0,2.2,64,29.5,1011.3,Fair
2/9/2022 5:00,3,19,3082,13562,22,16644,WEDNESDAY,0,0,1.7,56,25.9,1012.4,Fair
2/9/2022 6:00,2,6,1915,2433,8,4348,WEDNESDAY,0,0,1.1,54,29.5,1012.6,Fair
2/9/2022 7:00,0,8,0,5867,8,5867,WEDNESDAY,0,0,0.6,58,20.5,1013.4,Snow
2/9/2022 8:00,1,5,1422,5334,6,6756,WEDNESDAY,0,0,0,58,16.6,1013.6,Clear
2/9/2022 9:00,1,5,2513,4181,6,6694,WEDNESDAY,0,0,-0.6,58,22.3,1014.6,Clear
2/9/2022 10:00,3,26,1105,17585,29,18690,WEDNESDAY,0,0,-0.6,58,22.3,1015.6,Fair
2/9/2022 11:00,4,85,6637,55364,89,62001,WEDNESDAY,0,0,-1.1,60,22.3,1016.9,Fair
2/9/2022 12:00,8,203,20292,152827,211,173119,WEDNESDAY,0,0,-1.1,60,13,1017.3,Fair
2/9/2022 13:00,29,420,22489,304995,449,327484,WEDNESDAY,0,0,-1.1,60,22.3,1017.7,Fair
2/9/2022 14:00,17,305,13607,207152,322,220759,WEDNESDAY,0,0,0,56,18.4,1018.1,Fair
2/9/2022 15:00,15,194,14736,145119,209,159855,WEDNESDAY,0,0,1.1,52,9.4,1018.3,Fair
2/9/2022 16:00,23,202,69936,186294,225,256230,WEDNESDAY,0,0,2.2,48,9.4,1017.5,Fair
2/9/2022 17:00,23,247,31981,184573,270,216554,WEDNESDAY,0,0,2.8,50,13,1017.2,Fair
2/9/2022 18:00,35,252,430696,495222,287,925918,WEDNESDAY,0,0,4.4,43,13,1016.4,Fair
2/9/2022 19:00,42,258,79230,162578,300,241808,WEDNESDAY,0,0,5,45,14.8,1015.8,Fair
2/9/2022 20:00,41,287,407171,198045,328,605216,WEDNESDAY,0,0,6.1,41,13,1015.4,Fair
2/9/2022 21:00,51,406,73690,291464,457,365154,WEDNESDAY,0,0,6.1,43,13,1014.8,Fair
2/9/2022 22:00,54,509,63795,385067,563,448862,WEDNESDAY,0,0,4.4,53,13,1014.9,Fair
2/9/2022 23:00,52,400,59678,272894,452,332572,WEDNESDAY,0,0,3.3,59,16.6,1015.2,Fair
2/10/2022 0:00,27,277,23306,188360,304,211666,THURSDAY,0,0,2.2,62,18.4,1015.6,Fair
2/10/2022 1:00,27,181,25158,124016,208,149174,THURSDAY,0,0,1.7,66,11.2,1015.9,Fair
2/10/2022 2:00,15,136,10089,91371,151,101460,THURSDAY,0,0,1.7,66,16.6,1015.7,Fair
2/10/2022 3:00,17,85,15433,56143,102,71576,THURSDAY,0,0,1.7,69,11.2,1015.2,Fair
2/10/2022 4:00,9,58,5938,41407,67,47345,THURSDAY,0,0,1.1,75,9.4,1014.7,Clear
2/10/2022 5:00,3,23,2578,12423,26,15001,THURSDAY,0,0,0.6,78,11.2,1014.4,Fair
2/10/2022 6:00,2,9,1238,6489,11,7727,THURSDAY,0,0,0,81,7.6,1013.8,Fair
2/10/2022 7:00,2,6,745,4415,8,5160,THURSDAY,0,0,0,85,0,1013.2,Clear
2/10/2022 8:00,2,2,4839,994,4,5833,THURSDAY,0,0,0.6,85,0,1012.8,Clear
2/10/2022 9:00,2,5,1561,3425,7,4986,THURSDAY,0,0,0,88,7.6,1012.2,Rain
2/10/2022 10:00,3,23,4181,14141,26,18322,THURSDAY,0,0,0,92,0,1012.2,Clear
2/10/2022 11:00,4,96,2391,69023,100,71414,THURSDAY,0,0,-0.6,96,7.6,1011.7,Cloudy
2/10/2022 12:00,16,216,9632,162439,232,172071,THURSDAY,0,0,0,96,5.4,1011.4,Cloudy
2/10/2022 13:00,24,460,55432,323117,484,378549,THURSDAY,0,0,1.1,97,9.4,1011.3,Cloudy
2/10/2022 14:00,24,304,20960,234971,328,255931,THURSDAY,0,0,2.8,96,14.8,1011,Cloudy
2/10/2022 15:00,27,275,42206,235341,302,277547,THURSDAY,0,0,4.4,89,18.4,1010.7,Cloudy
2/10/2022 16:00,29,245,35647,187925,274,223572,THURSDAY,0,0,6.7,82,18.4,1009.9,Cloudy
2/10/2022 17:00,31,283,38675,193570,314,232245,THURSDAY,0,0,8.9,71,31.7,1008.3,Cloudy
2/10/2022 18:00,36,224,55623,177985,260,233608,THURSDAY,0,0,10,63,37.1,1006.8,Cloudy
2/10/2022 19:00,47,279,133713,268167,326,401880,THURSDAY,0,0,10,61,27.7,1006.2,Cloudy
2/10/2022 20:00,32,307,477894,209857,339,687751,THURSDAY,0,0,10,56,18.4,1006.1,Fair
2/10/2022 21:00,51,426,1635810,306204,477,1942014,THURSDAY,0,0,10,44,27.7,1006.8,Fair
2/10/2022 22:00,56,541,72689,410995,597,483684,THURSDAY,0,0,9.4,39,22.3,1007.6,Fair
2/10/2022 23:00,53,436,199668,327712,489,527380,THURSDAY,0,0,7.8,42,20.5,1009,Fair
2/11/2022 0:00,34,268,36048,181912,302,217960,FRIDAY,0,0,7.2,45,13,1010.2,Fair
2/11/2022 1:00,28,208,34542,172376,236,206918,FRIDAY,0,0,5.6,53,14.8,1010.9,Fair
2/11/2022 2:00,22,136,20647,222002,158,242649,FRIDAY,0,0,5,53,14.8,1011.8,Fair
2/11/2022 3:00,35,118,36146,78524,153,114670,FRIDAY,0,0,5,57,14.8,1012.8,Clear
2/11/2022 4:00,16,70,27460,51847,86,79307,FRIDAY,0,0,5,60,16.6,1013,Clear
2/11/2022 5:00,17,33,16821,26976,50,43797,FRIDAY,0,0,4.4,60,18.4,1013.4,Clear
2/11/2022 6:00,16,23,18386,11070,39,29456,FRIDAY,0,0,1.7,69,11.2,1013.7,Clear
2/11/2022 7:00,6,9,12460,4073,15,16533,FRIDAY,0,0,1.7,69,14.8,1014.1,Clear
2/11/2022 8:00,1,6,1643,3504,7,5147,FRIDAY,0,0,0.6,75,13,1014.4,Clear
2/11/2022 9:00,4,6,4737,2645,10,7382,FRIDAY,0,0,0.6,75,0,1014.6,Clear
2/11/2022 10:00,1,22,944,17723,23,18667,FRIDAY,0,0,1.7,69,13,1015.3,Clear
2/11/2022 11:00,8,65,5790,45674,73,51464,FRIDAY,0,0,0.6,72,13,1015.8,Fair
2/11/2022 12:00,18,188,12745,153703,206,166448,FRIDAY,0,0,-0.6,76,5.4,1016.4,Fair
2/11/2022 13:00,26,369,29452,273204,395,302656,FRIDAY,0,0,2.2,64,7.6,1017,Fair
2/11/2022 14:00,27,335,28004,201647,362,229651,FRIDAY,0,0,3.9,59,11.2,1017,Fair
2/11/2022 15:00,27,230,34317,164932,257,199249,FRIDAY,0,0,7.2,47,9.4,1016.9,Fair
2/11/2022 16:00,39,262,84092,184782,301,268874,FRIDAY,0,0,8.3,46,18.4,1016.6,Fair
2/11/2022 17:00,45,286,53002,195847,331,248849,FRIDAY,0,0,9.4,42,20.5,1015.6,Fair
2/11/2022 18:00,58,354,106407,263160,412,369567,FRIDAY,0,0,10.6,38,20.5,1014.6,Fair
2/11/2022 19:00,88,328,209876,235866,416,445742,FRIDAY,0,0,11.1,36,29.5,1013.9,Fair
2/11/2022 20:00,93,404,187627,298464,497,486091,FRIDAY,0,0,10.6,39,25.9,1013,Fair
2/11/2022 21:00,122,449,221137,357063,571,578200,FRIDAY,0,0,10,42,24.1,1012.9,Fair
2/11/2022 22:00,94,551,148928,391002,645,539930,FRIDAY,0,0,8.3,49,22.3,1013.1,Fair
2/11/2022 23:00,67,373,127626,280018,440,407644,FRIDAY,0,0,7.2,51,27.7,1013.2,Fair
2/12/2022 0:00,62,316,63661,212738,378,276399,SATURDAY,1,0,6.7,58,25.9,1013.5,Fair
2/12/2022 1:00,48,226,281438,160710,274,442148,SATURDAY,1,0,5.6,62,16.6,1013.8,Cloudy
2/12/2022 2:00,34,177,46408,123066,211,169474,SATURDAY,1,0,4.4,68,13,1014,Cloudy
2/12/2022 3:00,56,135,64691,87776,191,152467,SATURDAY,1,0,4.4,73,9.4,1013.7,Cloudy
2/12/2022 4:00,30,96,31422,64712,126,96134,SATURDAY,1,0,5,79,16.6,1013.1,Cloudy
2/12/2022 5:00,43,76,412460,49949,119,462409,SATURDAY,1,0,6.1,76,18.4,1012.5,Cloudy
2/12/2022 6:00,86,73,546799,58885,159,605684,SATURDAY,1,0,7.2,76,24.1,1011.8,Cloudy
2/12/2022 7:00,54,29,122304,22934,83,145238,SATURDAY,1,0,7.8,73,27.7,1011.2,Cloudy
2/12/2022 8:00,3,15,3364,9892,18,13256,SATURDAY,1,0,7.8,71,22.3,1010.6,Cloudy
2/12/2022 9:00,2,7,1549,4516,9,6065,SATURDAY,1,0,7.8,68,20.5,1010.2,Cloudy
2/12/2022 10:00,0,11,0,5295,11,5295,SATURDAY,1,0,8.9,63,20.5,1010.2,Fair
2/12/2022 11:00,3,31,2155,26828,34,28983,SATURDAY,1,0,8.9,63,22.3,1010.2,Cloudy
2/12/2022 12:00,14,45,20861,35259,59,56120,SATURDAY,1,0,8.3,65,20.5,1010.2,Cloudy
2/12/2022 13:00,13,127,10720,290681,140,301401,SATURDAY,1,0,9.4,61,11.2,1010.4,Cloudy
2/12/2022 14:00,34,242,44780,169251,276,214031,SATURDAY,1,0,10,56,18.4,1010.6,Cloudy
2/12/2022 15:00,100,292,547086,232320,392,779406,SATURDAY,1,0,11.1,52,25.9,1010.5,Cloudy
2/12/2022 16:00,132,361,250420,312554,493,562974,SATURDAY,1,0,13.9,44,31.7,1010.2,Cloudy
2/12/2022 17:00,270,426,762107,427784,696,1189891,SATURDAY,1,0,15,41,25.9,1009.5,Cloudy
2/12/2022 18:00,312,464,889221,476363,776,1365584,SATURDAY,1,0,15.6,37,31.7,1009.1,Cloudy
2/12/2022 19:00,370,525,980084,516596,895,1496680,SATURDAY,1,0,15.6,37,29.5,1009.2,Cloudy
2/12/2022 20:00,331,483,991865,493648,814,1485513,SATURDAY,1,0,15,36,38.9,1009.9,Cloudy
2/12/2022 21:00,313,407,1725767,407212,720,2132979,SATURDAY,1,0,13.3,34,20.5,1011,Cloudy
2/12/2022 22:00,163,345,546774,439035,508,985809,SATURDAY,1,0,12.2,34,24.1,1011.8,Fair
2/12/2022 23:00,86,284,555983,562980,370,1118963,SATURDAY,1,0,11.1,41,14.8,1013,Cloudy
2/13/2022 0:00,52,197,157302,142457,249,299759,SUNDAY,1,0,8.9,42,29.5,1015.4,Cloudy
2/13/2022 1:00,49,172,58795,129238,221,188033,SUNDAY,1,0,6.7,47,24.1,1016.5,Cloudy
2/13/2022 2:00,38,124,37978,76438,162,114416,SUNDAY,1,0,6.1,47,14.8,1017.6,Cloudy
2/13/2022 3:00,51,88,417856,67338,139,485194,SUNDAY,1,0,5.6,46,22.3,1018.5,Cloudy
2/13/2022 4:00,64,64,278696,39951,128,318647,SUNDAY,1,0,4.4,46,20.5,1018.7,Cloudy
2/13/2022 5:00,36,65,35355,277803,101,313158,SUNDAY,1,0,3.9,42,18.4,1019.3,Cloudy
2/13/2022 6:00,102,70,1522385,62709,172,1585094,SUNDAY,1,0,3.3,44,16.6,1019.9,Cloudy
2/13/2022 7:00,34,35,289898,27510,69,317408,SUNDAY,1,0,2.2,44,20.5,1019.2,Cloudy
2/13/2022 8:00,5,11,9132,10714,16,19846,SUNDAY,1,0,2.2,42,18.4,1019.9,Cloudy
2/13/2022 9:00,5,8,10806,4643,13,15449,SUNDAY,1,0,1.7,45,18.4,1020.4,Cloudy
2/13/2022 10:00,2,5,2834,6234,7,9068,SUNDAY,1,0,0.6,58,22.3,1020.8,Rain
2/13/2022 11:00,1,7,996,4796,8,5792,SUNDAY,1,0,-1.1,81,11.2,1021.5,Snow
2/13/2022 12:00,3,18,5449,14697,21,20146,SUNDAY,1,0,-1.7,85,7.6,1022.5,Snow
2/13/2022 13:00,2,20,1579,13344,22,14923,SUNDAY,1,0,-1.7,89,9.4,1023.1,Snow
2/13/2022 14:00,8,52,9433,35690,60,45123,SUNDAY,1,0,-1.7,89,7.6,1022.9,Snow
2/13/2022 15:00,11,60,9584,42428,71,52012,SUNDAY,1,0,-1.1,85,7.6,1022.8,Snow
2/13/2022 16:00,6,78,10073,48191,84,58264,SUNDAY,1,0,-1.1,88,9.4,1022.4,Snow
2/13/2022 17:00,9,73,25333,60147,82,85480,SUNDAY,1,0,-1.7,89,18.4,1020.8,Snow
2/13/2022 18:00,6,83,6793,55307,89,62100,SUNDAY,1,0,-2.2,85,20.5,1020.1,Snow
2/13/2022 19:00,7,92,6593,59679,99,66272,SUNDAY,1,0,-2.2,85,18.4,1019.4,Snow
2/13/2022 20:00,12,92,19760,59946,104,79706,SUNDAY,1,0,-2.2,85,14.8,1018.9,Snow
2/13/2022 21:00,5,86,4717,392295,91,397012,SUNDAY,1,0,-2.8,85,20.5,1018.3,Snow
2/13/2022 22:00,8,105,11650,73985,113,85635,SUNDAY,1,0,-2.8,81,18.4,1018,Snow
2/13/2022 23:00,9,114,7576,89425,123,97001,SUNDAY,1,0,-3.3,84,16.6,1017.9,Snow
2/14/2022 0:00,6,42,4935,24977,48,29912,MONDAY,0,0,-3.3,88,16.6,1017.9,Snow
2/14/2022 1:00,3,44,6932,33587,47,40519,MONDAY,0,0,-3.3,84,18.4,1017.3,Snow
2/14/2022 2:00,2,19,1930,14005,21,15935,MONDAY,0,0,-3.3,84,20.5,1016.9,Snow
2/14/2022 3:00,13,50,43129,40413,63,83542,MONDAY,0,0,-3.9,88,18.4,1016.2,Snow
2/14/2022 4:00,2,28,1674,18996,30,20670,MONDAY,0,0,-3.9,88,20.5,1015.8,Snow
2/14/2022 5:00,4,11,2240,6207,15,8447,MONDAY,0,0,-3.9,85,18.4,1014.9,Snow
2/14/2022 6:00,3,9,3066,6026,12,9092,MONDAY,0,0,-4.4,84,22.3,1014.4,Snow
2/14/2022 8:00,1,1,1867,571,2,2438,MONDAY,0,0,-5.6,71,20.5,1013.9,Snow
2/14/2022 9:00,0,4,0,2649,4,2649,MONDAY,0,0,-6.1,68,18.4,1013.9,Snow
2/14/2022 10:00,3,17,1362,104998,20,106360,MONDAY,0,0,-7.2,64,20.5,1013.8,Cloudy
2/14/2022 11:00,3,38,1742,22549,41,24291,MONDAY,0,0,-7.2,62,20.5,1013.8,Cloudy
2/14/2022 12:00,6,82,5109,55354,88,60463,MONDAY,0,0,-7.2,64,20.5,1014.4,Snow
2/14/2022 13:00,9,200,16283,141548,209,157831,MONDAY,0,0,-7.2,77,18.4,1014.5,Snow
2/14/2022 14:00,8,189,6706,122059,197,128765,MONDAY,0,0,-7.2,74,22.3,1014.6,Cloudy
2/14/2022 15:00,9,149,8235,86969,158,95204,MONDAY,0,0,-6.7,65,27.7,1014.7,Cloudy
2/14/2022 16:00,10,130,11876,84784,140,96660,MONDAY,0,0,-6.1,57,24.1,1015,Fair
2/14/2022 17:00,12,174,11258,118127,186,129385,MONDAY,0,0,-6.1,49,24.1,1014.8,Fair
2/14/2022 18:00,10,139,8031,94577,149,102608,MONDAY,0,0,-5.6,41,27.7,1015,Fair
2/14/2022 19:00,11,155,73449,89550,166,162999,MONDAY,0,0,-6.1,39,27.7,1015.2,Fair
2/14/2022 20:00,12,164,14142,111516,176,125658,MONDAY,0,0,-6.1,39,25.9,1016.2,Fair
2/14/2022 21:00,22,246,16257,174015,268,190272,MONDAY,0,0,-6.7,39,33.5,1017.2,Fair
2/14/2022 22:00,16,312,14075,214306,328,228381,MONDAY,0,0,-7.8,41,33.5,1019,Fair
2/14/2022 23:00,27,228,32293,152766,255,185059,MONDAY,0,0,-8.3,37,27.7,1020.9,Fair
2/15/2022 0:00,15,170,13668,107156,185,120824,TUESDAY,0,0,-8.3,37,22.3,1022.4,Clear
2/15/2022 1:00,5,100,4927,149772,105,154699,TUESDAY,0,0,-8.9,38,16.6,1023.6,Clear
2/15/2022 2:00,5,68,3601,46784,73,50385,TUESDAY,0,0,-8.9,38,16.6,1025.1,Clear
2/15/2022 3:00,11,46,14580,30755,57,45335,TUESDAY,0,0,-8.9,37,24.1,1026.2,Clear
2/15/2022 4:00,21,37,85906,20997,58,106903,TUESDAY,0,0,-9.4,40,14.8,1026.7,Clear
2/15/2022 5:00,1,9,382,5539,10,5921,TUESDAY,0,0,-10,38,18.4,1027.5,Fair
2/15/2022 6:00,0,4,0,2041,4,2041,TUESDAY,0,0,-10.6,40,20.5,1028,Fair
2/15/2022 7:00,3,3,2182,2086,6,4268,TUESDAY,0,0,-10.6,40,18.4,1028.5,Fair
2/15/2022 8:00,0,1,0,2362,1,2362,TUESDAY,0,0,-11.1,41,20.5,1028.6,Fair
2/15/2022 9:00,0,1,0,759,1,759,TUESDAY,0,0,-11.1,40,18.4,1029.1,Fair
2/15/2022 10:00,3,19,887,19979,22,20866,TUESDAY,0,0,-11.1,40,16.6,1030.4,Fair
2/15/2022 11:00,4,50,3123,32035,54,35158,TUESDAY,0,0,-11.1,40,18.4,1031.6,Fair
2/15/2022 12:00,10,119,5090,77514,129,82604,TUESDAY,0,0,-11.7,42,22.3,1032.7,Fair
2/15/2022 13:00,17,306,12895,205156,323,218051,TUESDAY,0,0,-10.6,38,18.4,1034.1,Fair
2/15/2022 14:00,8,239,6785,156041,247,162826,TUESDAY,0,0,-10,38,20.5,1034.8,Fair
2/15/2022 15:00,7,155,2824,100802,162,103626,TUESDAY,0,0,-8.3,35,16.6,1035.3,Fair
2/15/2022 16:00,16,148,16827,86953,164,103780,TUESDAY,0,0,-7.2,35,14.8,1035.8,Fair
2/15/2022 17:00,18,163,11749,123921,181,135670,TUESDAY,0,0,-6.1,38,13,1035.3,Fair
2/15/2022 18:00,15,149,12856,90936,164,103792,TUESDAY,0,0,-5,33,11.2,1034.7,Fair
2/15/2022 19:00,15,187,13236,114782,202,128018,TUESDAY,0,0,-3.3,32,27.7,1034.5,Fair
2/15/2022 20:00,21,197,20268,181801,218,202069,TUESDAY,0,0,-3.3,33,22.3,1034.7,Fair
2/15/2022 21:00,32,284,29518,191593,316,221111,TUESDAY,0,0,-2.8,32,27.7,1035.1,Fair
2/15/2022 22:00,31,391,31816,333952,422,365768,TUESDAY,0,0,-2.8,34,18.4,1035.8,Fair
2/15/2022 23:00,31,297,25640,207137,328,232777,TUESDAY,0,0,-2.8,37,16.6,1036.7,Fair
2/16/2022 0:00,15,216,29252,132853,231,162105,WEDNESDAY,0,0,-3.3,38,14.8,1038.2,Fair
2/16/2022 1:00,6,145,4889,81558,151,86447,WEDNESDAY,0,0,-3.3,40,14.8,1038.9,Fair
2/16/2022 2:00,8,108,11909,68167,116,80076,WEDNESDAY,0,0,-3.9,42,14.8,1039.8,Clear
2/16/2022 3:00,6,78,4691,49738,84,54429,WEDNESDAY,0,0,-5,50,14.8,1040.6,Clear
2/16/2022 4:00,2,34,2273,22450,36,24723,WEDNESDAY,0,0,-5,50,13,1040.7,Clear
2/16/2022 5:00,1,22,502,11629,23,12131,WEDNESDAY,0,0,-5,48,13,1041.2,Clear
2/16/2022 6:00,0,3,0,942,3,942,WEDNESDAY,0,0,-5.6,52,7.6,1041.4,Clear
2/16/2022 7:00,1,4,766,1251,5,2017,WEDNESDAY,0,0,-6.7,54,9.4,1041.4,Clear
2/16/2022 8:00,1,5,401,4176,6,4577,WEDNESDAY,0,0,-6.7,54,0,1041.2,Clear
2/16/2022 9:00,0,5,0,2889,5,2889,WEDNESDAY,0,0,-6.7,54,9.4,1041.5,Clear
2/16/2022 10:00,1,27,345,23397,28,23742,WEDNESDAY,0,0,-6.7,57,11.2,1041.7,Clear
2/16/2022 11:00,5,66,2575,43458,71,46033,WEDNESDAY,0,0,-8.3,67,11.2,1042,Fair
2/16/2022 12:00,10,169,5993,388611,179,394604,WEDNESDAY,0,0,-7.8,67,11.2,1042.2,Fair
2/16/2022 13:00,28,396,27556,320676,424,348232,WEDNESDAY,0,0,-5.6,65,14.8,1042.3,Fair
2/16/2022 14:00,19,322,70741,202436,341,273177,WEDNESDAY,0,0,-3.3,57,20.5,1042,Fair
2/16/2022 15:00,9,196,7110,130393,205,137503,WEDNESDAY,0,0,-1.1,55,25.9,1041.2,Cloudy
2/16/2022 16:00,17,179,19411,108144,196,127555,WEDNESDAY,0,0,0.6,53,22.3,1040.8,Cloudy
2/16/2022 17:00,23,244,19660,153715,267,173375,WEDNESDAY,0,0,2.2,54,33.5,1038.9,Cloudy
2/16/2022 18:00,24,218,387256,158078,242,545334,WEDNESDAY,0,0,2.8,57,33.5,1037.1,Cloudy
2/16/2022 19:00,25,241,36761,162806,266,199567,WEDNESDAY,0,0,3.9,57,37.1,1035.8,Cloudy
2/16/2022 20:00,29,270,33848,188660,299,222508,WEDNESDAY,0,0,3.9,62,35.3,1034.7,Cloudy
2/16/2022 21:00,40,342,59909,240793,382,300702,WEDNESDAY,0,0,4.4,62,31.7,1033.5,Cloudy
2/16/2022 22:00,42,492,41850,349582,534,391432,WEDNESDAY,0,0,3.9,76,22.3,1033,Cloudy
2/16/2022 23:00,38,412,141262,280589,450,421851,WEDNESDAY,0,0,4.4,76,20.5,1032.3,Cloudy
2/17/2022 0:00,28,302,73640,200610,330,274250,THURSDAY,0,0,4.4,79,18.4,1031.5,Cloudy
2/17/2022 1:00,21,171,19054,120691,192,139745,THURSDAY,0,0,5,82,22.3,1030.7,Cloudy
2/17/2022 2:00,17,154,254313,110080,171,364393,THURSDAY,0,0,6.1,86,24.1,1029.7,Cloudy
2/17/2022 3:00,22,110,17871,74863,132,92734,THURSDAY,0,0,7.2,86,35.3,1029,Cloudy
2/17/2022 4:00,11,70,7751,46334,81,54085,THURSDAY,0,0,7.8,86,33.5,1028.2,Cloudy
2/17/2022 5:00,6,17,9524,11125,23,20649,THURSDAY,0,0,7.8,86,27.7,1027.3,Cloudy
2/17/2022 6:00,3,12,2128,10215,15,12343,THURSDAY,0,0,7.8,83,29.5,1026.7,Cloudy
2/17/2022 7:00,3,8,18220,6994,11,25214,THURSDAY,0,0,7.8,76,24.1,1026.1,Cloudy
2/17/2022 8:00,0,4,0,5521,4,5521,THURSDAY,0,0,7.8,73,22.3,1025.3,Cloudy
2/17/2022 9:00,0,9,0,9485,9,9485,THURSDAY,0,0,8.3,74,25.9,1024.3,Cloudy
2/17/2022 10:00,0,29,0,17715,29,17715,THURSDAY,0,0,8.3,74,18.4,1024.1,Cloudy
2/17/2022 11:00,12,80,8921,65957,92,74878,THURSDAY,0,0,6.7,79,9.4,1023.8,Cloudy
2/17/2022 12:00,19,277,14798,208074,296,222872,THURSDAY,0,0,8.9,73,22.3,1022.9,Cloudy
2/17/2022 13:00,38,536,49187,814325,574,863512,THURSDAY,0,0,10,74,31.7,1022.1,Cloudy
2/17/2022 14:00,24,344,22559,274278,368,296837,THURSDAY,0,0,12.8,64,38.9,1021.6,Cloudy
2/17/2022 15:00,28,280,44133,204245,308,248378,THURSDAY,0,0,14.4,60,29.5,1021.1,Cloudy
2/17/2022 16:00,47,300,72579,207022,347,279601,THURSDAY,0,0,13.3,64,27.7,1020.6,Cloudy
2/17/2022 17:00,48,301,75653,219461,349,295114,THURSDAY,0,0,16.1,56,33.5,1019,Cloudy
2/17/2022 18:00,60,271,231433,199342,331,430775,THURSDAY,0,0,14.4,62,29.5,1018.1,Cloudy
2/17/2022 19:00,65,304,117562,239161,369,356723,THURSDAY,0,0,15.6,57,35.3,1016.2,Cloudy
2/17/2022 20:00,94,342,144351,247098,436,391449,THURSDAY,0,0,15.6,57,33.5,1015.2,Cloudy
2/17/2022 21:00,105,499,181877,380433,604,562310,THURSDAY,0,0,15,64,24.1,1014,Cloudy
2/17/2022 22:00,110,588,226084,439850,698,665934,THURSDAY,0,0,13.9,69,31.7,1012.7,Cloudy
2/17/2022 23:00,81,484,87188,363451,565,450639,THURSDAY,0,0,11.7,80,22.3,1012.4,Cloudy
2/18/2022 0:00,70,359,106968,265597,429,372565,FRIDAY,0,0,12.8,80,25.9,1011.4,Cloudy
2/18/2022 1:00,43,230,61865,165336,273,227201,FRIDAY,0,0,13.9,77,31.7,1009.8,Rain
2/18/2022 2:00,43,190,77120,138231,233,215351,FRIDAY,0,0,13.3,84,31.7,1008.8,Rain
2/18/2022 3:00,32,139,29679,104022,171,133701,FRIDAY,0,0,12.8,89,27.7,1006.8,Rain
2/18/2022 4:00,23,58,104384,36144,81,140528,FRIDAY,0,0,13.3,90,29.5,1005,Cloudy
2/18/2022 5:00,10,23,7005,18474,33,25479,FRIDAY,0,0,13.3,93,29.5,1003,Rain
2/18/2022 6:00,8,19,6320,12938,27,19258,FRIDAY,0,0,13.9,90,37.1,1000.8,Rain
2/18/2022 7:00,5,6,2814,3982,11,6796,FRIDAY,0,0,13.3,90,35.3,998.7,Rain
2/18/2022 8:00,1,1,836,507,2,1343,FRIDAY,0,0,12.8,89,50,994,Rain
2/18/2022 9:00,1,3,696,1325,4,2021,FRIDAY,0,0,12.8,93,51.8,994,Rain
2/18/2022 10:00,2,22,1139,17592,24,18731,FRIDAY,0,0,13.9,90,46.4,992.3,Rain
2/18/2022 11:00,4,61,2108,39871,65,41979,FRIDAY,0,0,14.4,90,40.7,991,Rain
2/18/2022 12:00,17,169,14976,108964,186,123940,FRIDAY,0,0,15.6,90,48.2,990,Rain
2/18/2022 13:00,18,191,14393,119247,209,133640,FRIDAY,0,0,16.7,84,50,993,Rain
2/18/2022 14:00,14,260,16245,159831,274,176076,FRIDAY,0,0,13.9,81,40.7,992.5,Rain
2/18/2022 15:00,30,229,28018,156706,259,184724,FRIDAY,0,0,10.6,61,38.9,995.1,Cloudy
2/18/2022 16:00,33,224,49065,147232,257,196297,FRIDAY,0,0,8.9,56,44.6,998.3,Cloudy
2/18/2022 17:00,37,254,43805,163424,291,207229,FRIDAY,0,0,6.7,47,50,1000.7,Fair
2/18/2022 18:00,45,278,47878,188257,323,236135,FRIDAY,0,0,5.6,44,40.7,1002.7,Fair
2/18/2022 19:00,42,243,385639,163442,285,549081,FRIDAY,0,0,5.6,43,37.1,1004.4,Fair
2/18/2022 20:00,53,285,63009,313072,338,376081,FRIDAY,0,0,5,41,31.7,1006,Fair
2/18/2022 21:00,53,394,573872,357120,447,930992,FRIDAY,0,0,3.3,40,29.5,1007.9,Fair
2/18/2022 22:00,53,428,546546,296955,481,843501,FRIDAY,0,0,1.1,41,33.5,1009.8,Fair
2/18/2022 23:00,38,318,85975,250319,356,336294,FRIDAY,0,0,0,43,20.5,1011.8,Fair
2/19/2022 0:00,40,241,92855,161230,281,254085,SATURDAY,1,0,-0.6,41,18.4,1013.1,Fair
2/19/2022 1:00,22,159,66303,113267,181,179570,SATURDAY,1,0,-1.1,44,22.3,1014.5,Clear
2/19/2022 2:00,22,114,43441,72276,136,115717,SATURDAY,1,0,-2.2,44,22.3,1015.8,Clear
2/19/2022 3:00,20,88,20167,57147,108,77314,SATURDAY,1,0,-2.8,46,16.6,1016.7,Clear
2/19/2022 4:00,27,83,665566,56449,110,722015,SATURDAY,1,0,-3.3,46,14.8,1017.6,Clear
2/19/2022 5:00,27,59,64610,38591,86,103201,SATURDAY,1,0,-3.9,46,14.8,1017.9,Clear
2/19/2022 6:00,44,42,113855,31669,86,145524,SATURDAY,1,0,-4.4,43,16.6,1018.1,Clear
2/19/2022 7:00,20,31,48286,29245,51,77531,SATURDAY,1,0,-4.4,46,11.2,1018.3,Clear
2/19/2022 8:00,1,10,805,9810,11,10615,SATURDAY,1,0,-5,52,13,1017.8,Clear
2/19/2022 9:00,5,2,18714,636,7,19350,SATURDAY,1,0,-5.6,57,7.6,1017.2,Clear
2/19/2022 10:00,0,12,0,9690,12,9690,SATURDAY,1,0,-6.1,59,11.2,1017.4,Clear
2/19/2022 11:00,6,21,6162,11292,27,17454,SATURDAY,1,0,-6.1,57,11.2,1016.9,Fair
2/19/2022 12:00,9,51,33426,38725,60,72151,SATURDAY,1,0,-6.1,65,18.4,1016.6,Fair
2/19/2022 13:00,13,80,16167,51080,93,67247,SATURDAY,1,0,-5,62,14.8,1016.1,Fair
2/19/2022 14:00,24,139,43269,99729,163,142998,SATURDAY,1,0,-2.8,50,20.5,1014.8,Fair
2/19/2022 15:00,58,184,91764,123102,242,214866,SATURDAY,1,0,-1.1,44,24.1,1013.3,Fair
2/19/2022 16:00,47,236,57617,163903,283,221520,SATURDAY,1,0,1.1,43,35.3,1011.5,Cloudy
2/19/2022 17:00,71,256,128728,220766,327,349494,SATURDAY,1,0,2.8,42,42.5,1010.3,Cloudy
2/19/2022 18:00,64,259,78977,193949,323,272926,SATURDAY,1,0,3.3,44,31.7,1008.7,Cloudy
2/19/2022 19:00,48,239,226937,186788,287,413725,SATURDAY,1,0,3.3,46,33.5,1007.9,Cloudy
2/19/2022 20:00,40,230,58865,162206,270,221071,SATURDAY,1,0,1.1,67,27.7,1008.3,Cloudy
2/19/2022 21:00,67,162,441198,123005,229,564203,SATURDAY,1,0,0,79,24.1,1008.4,Cloudy
2/19/2022 22:00,40,170,290663,124345,210,415008,SATURDAY,1,0,0.6,69,27.7,1008.7,Snow
2/19/2022 23:00,17,171,22087,117434,188,139521,SATURDAY,1,0,-1.7,72,27.7,1010.5,Cloudy
2/20/2022 0:00,15,132,17182,80837,147,98019,SUNDAY,1,0,-1.7,41,40.7,1012.5,Cloudy
2/20/2022 1:00,14,112,14634,67025,126,81659,SUNDAY,1,0,-2.2,39,29.5,1013.8,Fair
2/20/2022 2:00,13,88,7603,49062,101,56665,SUNDAY,1,0,-2.8,39,38.9,1015.2,Fair
2/20/2022 3:00,16,75,20733,125690,91,146423,SUNDAY,1,0,-2.8,41,27.7,1016.5,Fair
2/20/2022 4:00,21,60,133901,41696,81,175597,SUNDAY,1,0,-4.4,46,25.9,1018.1,Fair
2/20/2022 5:00,30,25,82768,17393,55,100161,SUNDAY,1,0,-5,42,35.3,1019.6,Fair
2/20/2022 6:00,32,51,53649,73378,83,127027,SUNDAY,1,0,-5.6,41,25.9,1021.2,Clear
2/20/2022 7:00,21,18,140426,11356,39,151782,SUNDAY,1,0,-6.1,41,33.5,1022.9,Clear
2/20/2022 8:00,3,5,4253,2584,8,6837,SUNDAY,1,0,-6.7,43,25.9,1023.9,Clear
2/20/2022 9:00,1,6,1284,2628,7,3912,SUNDAY,1,0,-7.8,43,22.3,1025.5,Clear
2/20/2022 10:00,2,9,1182,7278,11,8460,SUNDAY,1,0,-8.3,42,27.7,1027,Clear
2/20/2022 11:00,1,12,467,5995,13,6462,SUNDAY,1,0,-8.3,42,16.6,1028.6,Fair
2/20/2022 12:00,5,29,3566,17341,34,20907,SUNDAY,1,0,-8.3,44,14.8,1029.5,Fair
2/20/2022 13:00,11,59,10645,41839,70,52484,SUNDAY,1,0,-7.8,41,20.5,1030.6,Fair
2/20/2022 14:00,12,97,10322,78114,109,88436,SUNDAY,1,0,-6.7,37,27.7,1031.4,Fair
2/20/2022 15:00,42,142,62181,90236,184,152417,SUNDAY,1,0,-5.6,34,25.9,1031.2,Fair
2/20/2022 16:00,55,174,76288,106587,229,182875,SUNDAY,1,0,-4.4,33,16.6,1030.6,Fair
2/20/2022 17:00,48,197,76210,145660,245,221870,SUNDAY,1,0,-3.9,32,18.4,1029.8,Cloudy
2/20/2022 18:00,58,213,62672,152048,271,214720,SUNDAY,1,0,-2.2,28,20.5,1028.7,Cloudy
2/20/2022 19:00,78,191,123857,135689,269,259546,SUNDAY,1,0,-1.1,26,14.8,1027.8,Cloudy
2/20/2022 20:00,57,231,167352,193742,288,361094,SUNDAY,1,0,0,24,18.4,1027,Cloudy
2/20/2022 21:00,54,239,180273,208857,293,389130,SUNDAY,1,0,0.6,25,22.3,1025.9,Fair
2/20/2022 22:00,46,224,60764,160807,270,221571,SUNDAY,1,0,0.6,29,27.7,1025.4,Fair
2/20/2022 23:00,34,199,29830,138219,233,168049,SUNDAY,1,0,0,34,22.3,1025,Fair
2/21/2022 0:00,30,138,170283,90207,168,260490,MONDAY,0,1,-1.1,44,27.7,1025.3,Fair
2/21/2022 1:00,23,101,32662,64106,124,96768,MONDAY,0,1,-1.7,51,33.5,1024.6,Fair
2/21/2022 2:00,14,78,14545,51642,92,66187,MONDAY,0,1,-1.7,56,38.9,1024.3,Clear
2/21/2022 3:00,14,66,18771,36586,80,55357,MONDAY,0,1,-1.1,58,33.5,1023.8,Clear
2/21/2022 4:00,15,59,10803,34182,74,44985,MONDAY,0,1,-0.6,63,40.7,1023.9,Clear
2/21/2022 5:00,3,19,2381,10118,22,12499,MONDAY,0,1,-0.6,66,31.7,1023.7,Clear
2/21/2022 6:00,11,25,10803,22022,36,32825,MONDAY,0,1,0,61,33.5,1023.9,Clear
2/21/2022 7:00,7,15,227731,48563,22,276294,MONDAY,0,1,0.6,56,35.3,1024,Clear
2/21/2022 8:00,11,8,14633,6496,19,21129,MONDAY,0,1,1.1,54,33.5,1023.8,Clear
2/21/2022 9:00,2,10,2934,6547,12,9481,MONDAY,0,1,1.1,54,31.7,1023.5,Clear
2/21/2022 10:00,1,16,149,13914,17,14063,MONDAY,0,1,1.1,54,33.5,1023.9,Clear
2/21/2022 11:00,3,29,2953,17995,32,20948,MONDAY,0,1,1.1,54,20.5,1024.4,Fair
2/21/2022 12:00,8,76,6104,57266,84,63370,MONDAY,0,1,0.6,56,13,1025.4,Fair
2/21/2022 13:00,30,146,34187,101458,176,135645,MONDAY,0,1,1.7,54,14.8,1026,Cloudy
2/21/2022 14:00,21,182,26723,121979,203,148702,MONDAY,0,1,3.9,46,18.4,1026.4,Cloudy
2/21/2022 15:00,54,212,86525,145030,266,231555,MONDAY,0,1,5.6,43,18.4,1026.6,Cloudy
2/21/2022 16:00,101,251,182987,194797,352,377784,MONDAY,0,1,7.8,37,14.8,1026.5,Cloudy
2/21/2022 17:00,137,312,619489,276607,449,896096,MONDAY,0,1,9.4,36,13,1026.2,Cloudy
2/21/2022 18:00,198,350,440275,334547,548,774822,MONDAY,0,1,10.6,32,9.4,1025.6,Cloudy
2/21/2022 19:00,209,340,476336,332062,549,808398,MONDAY,0,1,11.1,36,13,1025.1,Cloudy
2/21/2022 20:00,281,405,606371,401703,686,1008074,MONDAY,0,1,11.1,38,9.4,1025.2,Cloudy
2/21/2022 21:00,215,435,632916,398200,650,1031116,MONDAY,0,1,7.8,55,14.8,1025.5,Cloudy
2/21/2022 22:00,150,438,378144,378544,588,756688,MONDAY,0,1,6.1,68,9.4,1025.9,Fair
2/21/2022 23:00,86,357,120919,231565,443,352484,MONDAY,0,1,5.6,73,0,1026.5,Fair
2/22/2022 0:00,33,248,46192,207429,281,253621,TUESDAY,0,0,6.1,57,14.8,1027.2,Fair
2/22/2022 1:00,35,168,38989,110087,203,149076,TUESDAY,0,0,5.6,57,13,1027.9,Fair
2/22/2022 2:00,28,130,33518,131197,158,164715,TUESDAY,0,0,3.9,64,11.2,1028.9,Fair
2/22/2022 3:00,8,77,5468,50763,85,56231,TUESDAY,0,0,4.4,60,11.2,1029.7,Fair
2/22/2022 4:00,10,39,8768,26786,49,35554,TUESDAY,0,0,4.4,65,0,1029.5,Fair
2/22/2022 5:00,13,30,33530,17922,43,51452,TUESDAY,0,0,3.3,73,9.4,1029.5,Clear
2/22/2022 6:00,5,13,26113,6693,18,32806,TUESDAY,0,0,1.1,85,7.6,1029.8,Clear
2/22/2022 7:00,2,8,4229,10412,10,14641,TUESDAY,0,0,1.7,92,7.6,1030,Clear
2/22/2022 8:00,2,5,3668,3713,7,7381,TUESDAY,0,0,1.1,88,0,1029.5,Fair
2/22/2022 9:00,0,4,0,1979,4,1979,TUESDAY,0,0,0.6,92,9.4,1029.1,Cloudy
2/22/2022 10:00,3,26,6834,29952,29,36786,TUESDAY,0,0,1.1,92,0,1030.1,Cloudy
2/22/2022 11:00,5,83,4372,57140,88,61512,TUESDAY,0,0,1.1,97,7.6,1030.2,Cloudy
2/22/2022 12:00,14,216,10152,146152,230,156304,TUESDAY,0,0,2.8,100,5.4,1030.6,Cloudy
2/22/2022 13:00,37,480,31718,332909,517,364627,TUESDAY,0,0,2.8,93,0,1031,Cloudy
2/22/2022 14:00,16,362,26116,369387,378,395503,TUESDAY,0,0,3.3,93,5.4,1031.3,Cloudy
2/22/2022 15:00,25,264,28514,179368,289,207882,TUESDAY,0,0,4.4,89,5.4,1030.9,Cloudy
2/22/2022 16:00,32,239,66293,178259,271,244552,TUESDAY,0,0,6.1,82,9.4,1029.8,Cloudy
2/22/2022 17:00,38,278,319102,162465,316,481567,TUESDAY,0,0,4.4,89,9.4,1029.2,Cloudy
2/22/2022 18:00,41,252,78696,245674,293,324370,TUESDAY,0,0,6.7,79,14.8,1026.9,Rain
2/22/2022 19:00,29,189,117284,121680,218,238964,TUESDAY,0,0,5.6,89,11.2,1025.4,Rain
2/22/2022 20:00,12,146,36800,105517,158,142317,TUESDAY,0,0,5.6,92,16.6,1024,Rain
2/22/2022 21:00,24,266,22780,171901,290,194681,TUESDAY,0,0,5.6,96,13,1023.7,Cloudy
2/22/2022 22:00,19,266,15209,180298,285,195507,TUESDAY,0,0,5.6,96,7.6,1022.4,Rain
2/22/2022 23:00,8,202,6267,121266,210,127533,TUESDAY,0,0,5.6,96,7.6,1020.8,Rain
2/23/2022 0:00,14,138,15246,79986,152,95232,WEDNESDAY,0,0,7.8,96,13,1019.1,Rain
2/23/2022 1:00,1,91,519,57500,92,58019,WEDNESDAY,0,0,11.7,89,27.7,1017,Rain
2/23/2022 2:00,6,53,9732,38457,59,48189,WEDNESDAY,0,0,12.2,90,40.7,1015.6,Rain
2/23/2022 3:00,2,37,1946,23252,39,25198,WEDNESDAY,0,0,12.2,93,42.5,1014.3,Rain
2/23/2022 4:00,0,26,0,18107,26,18107,WEDNESDAY,0,0,12.2,93,42.5,1012.8,Rain
2/23/2022 5:00,1,22,905,11624,23,12529,WEDNESDAY,0,0,12.8,89,40.7,1011.4,Rain
2/23/2022 6:00,3,14,4831,12863,17,17694,WEDNESDAY,0,0,13.9,87,35.3,1011.1,Rain
2/23/2022 7:00,3,5,6112,6018,8,12130,WEDNESDAY,0,0,13.9,87,38.9,1010.3,Rain
2/23/2022 8:00,0,5,0,3290,5,3290,WEDNESDAY,0,0,13.9,87,31.7,1010.2,Rain
2/23/2022 9:00,0,8,0,6777,8,6777,WEDNESDAY,0,0,13.9,87,25.9,1010.3,Cloudy
2/23/2022 10:00,5,33,3170,26653,38,29823,WEDNESDAY,0,0,13.3,87,25.9,1010.5,Cloudy
2/23/2022 11:00,6,110,7554,72870,116,80424,WEDNESDAY,0,0,12.8,89,20.5,1010.4,Cloudy
2/23/2022 12:00,29,284,39217,238167,313,277384,WEDNESDAY,0,0,10.6,96,16.6,1010.2,Cloudy
2/23/2022 13:00,58,557,62671,400387,615,463058,WEDNESDAY,0,0,12.8,89,20.5,1010.2,Cloudy
2/23/2022 14:00,36,348,72369,260569,384,332938,WEDNESDAY,0,0,13.3,90,18.4,1009.8,Cloudy
2/23/2022 15:00,49,234,70713,180072,283,250785,WEDNESDAY,0,0,15,83,18.4,1009.2,Cloudy
2/23/2022 16:00,53,263,165049,217987,316,383036,WEDNESDAY,0,0,16.7,75,24.1,1008.5,Cloudy
2/23/2022 17:00,105,340,360421,283317,445,643738,WEDNESDAY,0,0,17.8,68,25.9,1007.8,Cloudy
2/23/2022 18:00,135,348,329800,278061,483,607861,WEDNESDAY,0,0,19.4,59,20.5,1007.2,Cloudy
2/23/2022 19:00,138,393,318522,324848,531,643370,WEDNESDAY,0,0,19.4,52,27.7,1007,Cloudy
2/23/2022 20:00,203,433,929403,370885,636,1300288,WEDNESDAY,0,0,19.4,51,22.3,1007.3,Cloudy
2/23/2022 21:00,196,544,390572,433347,740,823919,WEDNESDAY,0,0,18.9,45,44.6,1008,Fair
2/23/2022 22:00,175,685,306835,548913,860,855748,WEDNESDAY,0,0,13.9,47,37.1,1010.6,Fair
2/23/2022 23:00,73,460,123484,329467,533,452951,WEDNESDAY,0,0,8.9,46,35.3,1013.6,Fair
2/24/2022 0:00,49,341,38918,230880,390,269798,THURSDAY,0,0,6.7,40,27.7,1014.9,Fair
2/24/2022 1:00,23,224,29929,141439,247,171368,THURSDAY,0,0,4.4,46,38.9,1016.8,Fair
2/24/2022 2:00,22,147,15964,89907,169,105871,THURSDAY,0,0,3.3,44,37.1,1018,Fair
2/24/2022 3:00,16,109,14184,65563,125,79747,THURSDAY,0,0,2.8,44,29.5,1019.5,Fair
2/24/2022 4:00,7,43,5427,24800,50,30227,THURSDAY,0,0,1.7,44,24.1,1020.8,Cloudy
2/24/2022 5:00,9,19,408510,9629,28,418139,THURSDAY,0,0,0.6,43,31.7,1022.3,Cloudy
2/24/2022 6:00,3,7,1654,60891,10,62545,THURSDAY,0,0,-0.6,47,22.3,1024.4,Cloudy
2/24/2022 7:00,2,8,854,5843,10,6697,THURSDAY,0,0,-1.1,44,31.7,1025,Fair
2/24/2022 8:00,0,3,0,822,3,822,THURSDAY,0,0,-2.2,42,24.1,1025.8,Fair
2/24/2022 9:00,0,6,0,4628,6,4628,THURSDAY,0,0,-2.8,42,22.3,1026.5,Fair
2/24/2022 10:00,2,26,3875,29765,28,33640,THURSDAY,0,0,-3.9,42,22.3,1027.8,Cloudy
2/24/2022 11:00,3,75,2468,42761,78,45229,THURSDAY,0,0,-4.4,41,27.7,1029.7,Cloudy
2/24/2022 12:00,7,195,3419,140341,202,143760,THURSDAY,0,0,-5,39,27.7,1030.6,Cloudy
2/24/2022 13:00,26,417,18509,275191,443,293700,THURSDAY,0,0,-5.6,40,27.7,1031.9,Cloudy
2/24/2022 14:00,19,297,29012,191939,316,220951,THURSDAY,0,0,-5,38,20.5,1032.2,Cloudy
2/24/2022 15:00,14,223,16164,148782,237,164946,THURSDAY,0,0,-3.9,36,16.6,1032.3,Cloudy
2/24/2022 16:00,18,207,16698,150547,225,167245,THURSDAY,0,0,-3.9,36,13,1032.8,Cloudy
2/24/2022 17:00,22,237,38448,149903,259,188351,THURSDAY,0,0,-3.3,33,16.6,1032.6,Cloudy
2/24/2022 18:00,20,243,26276,144240,263,170516,THURSDAY,0,0,-2.2,31,18.4,1032.2,Cloudy
2/24/2022 19:00,31,232,41663,150528,263,192191,THURSDAY,0,0,-2.8,32,9.4,1032.4,Cloudy
2/24/2022 20:00,36,259,53777,166034,295,219811,THURSDAY,0,0,-2.2,29,5.4,1032.2,Cloudy
2/24/2022 21:00,40,374,57613,254163,414,311776,THURSDAY,0,0,-2.2,35,7.6,1031.9,Cloudy
2/24/2022 22:00,61,477,86103,685402,538,771505,THURSDAY,0,0,-2.8,39,7.6,1032.2,Cloudy
2/24/2022 23:00,45,367,49295,251279,412,300574,THURSDAY,0,0,-2.8,41,9.4,1032.6,Fair
2/25/2022 0:00,27,296,37804,270184,323,307988,FRIDAY,0,0,-2.8,41,5.4,1032.8,Fair
2/25/2022 1:00,16,217,14348,137163,233,151511,FRIDAY,0,0,-2.2,37,5.4,1033.2,Fair
2/25/2022 2:00,14,170,11206,101869,184,113075,FRIDAY,0,0,-2.2,42,5.4,1033.4,Cloudy
2/25/2022 3:00,6,101,8197,632996,107,641193,FRIDAY,0,0,-2.2,44,0,1033.1,Cloudy
2/25/2022 4:00,7,74,27036,44259,81,71295,FRIDAY,0,0,-1.7,43,11.2,1031.8,Cloudy
2/25/2022 5:00,12,25,24238,16176,37,40414,FRIDAY,0,0,-1.7,46,9.4,1031.5,Snow
2/25/2022 6:00,16,38,18636,27347,54,45983,FRIDAY,0,0,-1.7,51,13,1031,Snow
2/25/2022 7:00,11,10,291192,7625,21,298817,FRIDAY,0,0,-1.1,51,7.6,1030.4,Snow
2/25/2022 8:00,2,10,114346,5040,12,119386,FRIDAY,0,0,-1.1,58,13,1029.5,Snow
2/25/2022 9:00,0,3,0,1696,3,1696,FRIDAY,0,0,-1.7,78,20.5,1028,Snow
2/25/2022 10:00,0,9,0,8704,9,8704,FRIDAY,0,0,-1.7,85,20.5,1027.3,Snow
2/25/2022 11:00,1,13,1271,8252,14,9523,FRIDAY,0,0,-1.7,89,29.5,1025.6,Snow
2/25/2022 12:00,1,13,1030,11750,14,12780,FRIDAY,0,0,-1.7,96,33.5,1024.2,Snow
2/25/2022 13:00,3,17,59840,14661,20,74501,FRIDAY,0,0,-1.1,96,35.3,1023.5,Snow
2/25/2022 14:00,1,9,1641,76081,10,77722,FRIDAY,0,0,-1.1,96,31.7,1022.6,Snow
2/25/2022 15:00,1,16,1656,95008,17,96664,FRIDAY,0,0,-0.6,96,33.5,1019.6,Snow
2/25/2022 16:00,0,21,0,48869,21,48869,FRIDAY,0,0,-0.6,96,37.1,1016.8,Snow
2/25/2022 17:00,1,21,936,24418,22,25354,FRIDAY,0,0,0.6,92,33.5,1014.6,Snow
2/25/2022 18:00,2,22,903,36640,24,37543,FRIDAY,0,0,0.6,96,29.5,1012.8,Snow
2/25/2022 19:00,2,15,2176,70971,17,73147,FRIDAY,0,0,0.6,96,18.4,1014,Snow
2/25/2022 20:00,2,15,1468,13423,17,14891,FRIDAY,0,0,-3.3,88,24.1,1013.5,Snow
2/25/2022 21:00,2,25,2758,25497,27,28255,FRIDAY,0,0,-5,85,22.3,1014.5,Snow
2/25/2022 22:00,2,40,1471,50258,42,51729,FRIDAY,0,0,-6.1,81,24.1,1016.1,Snow
2/25/2022 23:00,3,49,47525,45472,52,92997,FRIDAY,0,0,-6.7,84,25.9,1018.7,Snow
2/26/2022 0:00,3,40,1486,34953,43,36439,SATURDAY,1,0,-6.1,78,22.3,1020.8,Snow
2/26/2022 1:00,1,29,695,114734,30,115429,SATURDAY,1,0,-6.7,81,25.9,1022.1,Snow
2/26/2022 2:00,6,41,57266,38972,47,96238,SATURDAY,1,0,-6.7,77,16.6,1023.3,Cloudy
2/26/2022 3:00,2,23,1359,19690,25,21049,SATURDAY,1,0,-6.7,74,18.4,1024.9,Cloudy
2/26/2022 4:00,1,25,1158,36078,26,37236,SATURDAY,1,0,-7.8,77,14.8,1025.6,Cloudy
2/26/2022 5:00,4,22,6980,75756,26,82736,SATURDAY,1,0,-7.2,74,11.2,1026.4,Fair
2/26/2022 6:00,11,16,17770,14996,27,32766,SATURDAY,1,0,-7.2,70,11.2,1026.9,Fair
2/26/2022 7:00,6,17,321343,18592,23,339935,SATURDAY,1,0,-7.2,74,13,1027.2,Fair
2/26/2022 8:00,2,2,2132,1523,4,3655,SATURDAY,1,0,-7.8,74,9.4,1027.2,Fair
2/26/2022 9:00,0,2,0,1167,2,1167,SATURDAY,1,0,-8.9,73,9.4,1027.4,Fair
2/26/2022 10:00,1,3,2240,1963,4,4203,SATURDAY,1,0,-8.9,77,9.4,1028.4,Fair
2/26/2022 11:00,2,12,999,7028,14,8027,SATURDAY,1,0,-9.4,73,5.4,1029.3,Fair
2/26/2022 12:00,4,26,4187,17382,30,21569,SATURDAY,1,0,-8.3,67,14.8,1029.6,Fair
2/26/2022 13:00,1,35,577,26442,36,27019,SATURDAY,1,0,-8.3,64,18.4,1030.4,Fair
2/26/2022 14:00,4,70,2648,55884,74,58532,SATURDAY,1,0,-7.8,62,16.6,1030.4,Fair
2/26/2022 15:00,13,84,13576,65447,97,79023,SATURDAY,1,0,-6.7,59,16.6,1030.2,Fair
2/26/2022 16:00,20,124,308210,105375,144,413585,SATURDAY,1,0,-5.6,57,14.8,1029.2,Fair
2/26/2022 17:00,21,137,31219,136085,158,167304,SATURDAY,1,0,-3.3,46,13,1028.2,Fair
2/26/2022 18:00,21,146,23717,122835,167,146552,SATURDAY,1,0,-2.2,42,0,1027.3,Fair
2/26/2022 19:00,31,213,65730,190016,244,255746,SATURDAY,1,0,-1.7,39,11.2,1026.4,Fair
2/26/2022 20:00,30,204,37383,155749,234,193132,SATURDAY,1,0,-1.7,39,5.4,1025.6,Fair
2/26/2022 21:00,29,180,35444,144499,209,179943,SATURDAY,1,0,-1.1,39,14.8,1024.8,Fair
2/26/2022 22:00,26,170,31646,141595,196,173241,SATURDAY,1,0,-1.1,41,14.8,1024.2,Fair
2/26/2022 23:00,33,149,45878,104956,182,150834,SATURDAY,1,0,-1.7,49,13,1024.2,Fair
2/27/2022 0:00,15,111,13720,79135,126,92855,SUNDAY,1,0,-1.7,49,14.8,1024.4,Fair
2/27/2022 1:00,13,98,16910,63682,111,80592,SUNDAY,1,0,-1.1,44,14.8,1023.9,Fair
2/27/2022 2:00,6,89,5369,56478,95,61847,SUNDAY,1,0,-3.3,60,14.8,1023.8,Clear
2/27/2022 3:00,14,68,57055,55795,82,112850,SUNDAY,1,0,-2.8,58,9.4,1023.6,Clear
2/27/2022 4:00,9,49,68911,30159,58,99070,SUNDAY,1,0,-2.2,48,16.6,1022.8,Fair
2/27/2022 5:00,15,47,23788,32401,62,56189,SUNDAY,1,0,-3.9,57,14.8,1021.7,Clear
2/27/2022 6:00,43,45,49843,38123,88,87966,SUNDAY,1,0,-2.8,48,18.4,1020.9,Clear
2/27/2022 7:00,30,28,43943,23128,58,67071,SUNDAY,1,0,-3.3,52,14.8,1019.8,Clear
2/27/2022 8:00,6,15,10792,8214,21,19006,SUNDAY,1,0,-4.4,57,14.8,1019,Clear
2/27/2022 9:00,3,9,3080,5509,12,8589,SUNDAY,1,0,-3.3,50,22.3,1018.3,Clear
2/27/2022 10:00,2,6,1564,4335,8,5899,SUNDAY,1,0,-4.4,60,18.4,1018.2,Clear
2/27/2022 11:00,1,8,1573,3646,9,5219,SUNDAY,1,0,-5,59,20.5,1017.1,Fair
2/27/2022 12:00,0,25,0,19944,25,19944,SUNDAY,1,0,-5.6,62,16.6,1016.6,Fair
2/27/2022 13:00,5,50,6190,33819,55,40009,SUNDAY,1,0,-5,62,18.4,1016.5,Fair
2/27/2022 14:00,15,96,111525,79195,111,190720,SUNDAY,1,0,-1.7,51,25.9,1015.3,Fair
2/27/2022 15:00,20,131,21985,99296,151,121281,SUNDAY,1,0,-0.6,49,29.5,1013.7,Fair
2/27/2022 16:00,30,177,52459,135325,207,187784,SUNDAY,1,0,0,45,24.1,1012.5,Fair
2/27/2022 17:00,19,180,18727,141764,199,160491,SUNDAY,1,0,1.7,44,20.5,1010.8,Fair
2/27/2022 18:00,26,202,29305,161264,228,190569,SUNDAY,1,0,2.2,40,37.1,1009.1,Fair
2/27/2022 19:00,44,209,77964,155686,253,233650,SUNDAY,1,0,3.9,37,25.9,1007.9,Fair
2/27/2022 20:00,38,220,86068,158149,258,244217,SUNDAY,1,0,4.4,36,31.7,1007,Cloudy
2/27/2022 21:00,45,231,59676,182477,276,242153,SUNDAY,1,0,4.4,34,29.5,1006.9,Cloudy
2/27/2022 22:00,46,216,65278,173221,262,238499,SUNDAY,1,0,3.9,37,22.3,1007.2,Fair
2/27/2022 23:00,32,197,46201,122341,229,168542,SUNDAY,1,0,3.9,39,22.3,1008,Fair
2/28/2022 0:00,9,153,7224,89819,162,97043,MONDAY,0,0,2.8,40,29.5,1008.3,Cloudy
2/28/2022 1:00,10,115,7892,84380,125,92272,MONDAY,0,0,2.8,42,33.5,1008.9,Cloudy
2/28/2022 2:00,6,64,3119,43654,70,46773,MONDAY,0,0,1.1,50,25.9,1010,Cloudy
2/28/2022 3:00,7,49,5928,28224,56,34152,MONDAY,0,0,-2.2,75,33.5,1012.4,Fair
2/28/2022 4:00,2,44,1417,30194,46,31611,MONDAY,0,0,-3.3,40,31.7,1013.4,Fair
2/28/2022 5:00,3,18,2072,12505,21,14577,MONDAY,0,0,-3.9,35,25.9,1014.3,Fair
2/28/2022 6:00,1,7,659,4406,8,5065,MONDAY,0,0,-4.4,38,18.4,1015,Clear
2/28/2022 7:00,0,5,0,2520,5,2520,MONDAY,0,0,-5,42,18.4,1015.5,Clear
2/28/2022 8:00,1,5,35274,3921,6,39195,MONDAY,0,0,-5.6,45,18.4,1016,Clear
2/28/2022 9:00,1,7,393,5014,8,5407,MONDAY,0,0,-5.6,45,16.6,1017,Clear
2/28/2022 10:00,0,23,0,19654,23,19654,MONDAY,0,0,-6.7,49,20.5,1018.5,Fair
2/28/2022 11:00,3,73,2140,45409,76,47549,MONDAY,0,0,-6.7,52,24.1,1019.6,Fair
2/28/2022 12:00,9,156,12408,108809,165,121217,MONDAY,0,0,-7.8,51,24.1,1020.7,Fair
2/28/2022 13:00,19,331,16738,240621,350,257359,MONDAY,0,0,-7.2,47,20.5,1022,Fair
2/28/2022 14:00,10,227,202509,146732,237,349241,MONDAY,0,0,-6.7,45,24.1,1022.8,Fair
2/28/2022 15:00,5,155,6411,132087,160,138498,MONDAY,0,0,-6.1,38,27.7,1023.2,Fair
2/28/2022 16:00,10,163,7230,100977,173,108207,MONDAY,0,0,-5,36,25.9,1023.6,Fair
2/28/2022 17:00,11,192,13323,114894,203,128217,MONDAY,0,0,-4.4,31,25.9,1023.3,Fair
2/28/2022 18:00,13,168,13241,112644,181,125885,MONDAY,0,0,-3.3,30,22.3,1023.1,Fair
2/28/2022 19:00,11,181,13006,117988,192,130994,MONDAY,0,0,-2.8,29,29.5,1022.9,Fair
2/28/2022 20:00,22,222,84418,154792,244,239210,MONDAY,0,0,-2.2,27,18.4,1023.4,Fair
2/28/2022 21:00,25,298,20967,202464,323,223431,MONDAY,0,0,-2.2,23,22.3,1023.9,Fair
2/28/2022 22:00,26,390,27035,271027,416,298062,MONDAY,0,0,-2.2,23,18.4,1024.5,Fair
2/28/2022 23:00,22,297,20863,197073,319,217936,MONDAY,0,0,-3.3,25,16.6,1025.3,Fair
3/1/2022 0:00,16,228,11329,291541,244,302870,TUESDAY,0,0,-3.9,26,20.5,1025.8,Fair
3/1/2022 1:00,10,142,12836,224122,152,236958,TUESDAY,0,0,-4.4,25,20.5,1026.4,Fair
3/1/2022 2:00,6,103,4945,56927,109,61872,TUESDAY,0,0,-5,27,13,1026.8,Fair
3/1/2022 3:00,6,51,3773,31198,57,34971,TUESDAY,0,0,-5,28,11.2,1026.9,Fair
3/1/2022 4:00,3,36,1830,15995,39,17825,TUESDAY,0,0,-5.6,28,7.6,1027.1,Fair
3/1/2022 5:00,1,21,974,8744,22,9718,TUESDAY,0,0,-5.6,28,5.4,1027.2,Fair
3/1/2022 6:00,0,1,0,362,1,362,TUESDAY,0,0,-7.2,39,5.4,1027.6,Clear
3/1/2022 7:00,0,8,0,4380,8,4380,TUESDAY,0,0,-6.7,41,5.4,1027.2,Fair
3/1/2022 8:00,0,4,0,1617,4,1617,TUESDAY,0,0,-7.2,47,7.6,1027.2,Fair
3/1/2022 9:00,1,3,592,1390,4,1982,TUESDAY,0,0,-6.7,45,7.6,1027,Fair
3/1/2022 10:00,3,22,2737,17945,25,20682,TUESDAY,0,0,-6.7,41,5.4,1027,Fair
3/1/2022 11:00,0,79,0,53713,79,53713,TUESDAY,0,0,-7.2,43,0,1027.4,Fair
3/1/2022 12:00,15,199,105457,137735,214,243192,TUESDAY,0,0,-7.2,54,13,1027.5,Fair
3/1/2022 13:00,26,410,27354,331668,436,359022,TUESDAY,0,0,-5,43,5.4,1027.4,Cloudy
3/1/2022 14:00,15,294,14475,185676,309,200151,TUESDAY,0,0,-3.9,44,11.2,1026.7,Cloudy
3/1/2022 15:00,15,209,13858,146540,224,160398,TUESDAY,0,0,-2.2,44,7.6,1025.7,Cloudy
3/1/2022 16:00,19,203,26129,138567,222,164696,TUESDAY,0,0,-0.6,49,18.4,1024.9,Cloudy
3/1/2022 17:00,21,228,20136,240442,249,260578,TUESDAY,0,0,0.6,49,18.4,1023.1,Cloudy
3/1/2022 18:00,17,159,14166,112217,176,126383,TUESDAY,0,0,1.7,47,20.5,1021.1,Cloudy
3/1/2022 19:00,16,195,100069,136932,211,237001,TUESDAY,0,0,1.7,52,24.1,1019.8,Cloudy
3/1/2022 20:00,25,227,22680,157921,252,180601,TUESDAY,0,0,2.8,52,31.7,1018.9,Cloudy
3/1/2022 21:00,39,379,58917,457054,418,515971,TUESDAY,0,0,2.8,61,25.9,1018.2,Cloudy
3/1/2022 22:00,42,436,39125,438613,478,477738,TUESDAY,0,0,2.8,72,25.9,1017.7,Cloudy
3/1/2022 23:00,32,320,37413,224794,352,262207,TUESDAY,0,0,2.2,82,25.9,1016.8,Cloudy
3/2/2022 0:00,21,231,22093,163524,252,185617,WEDNESDAY,0,0,2.2,85,20.5,1015.9,Rain
3/2/2022 1:00,21,168,28195,114457,189,142652,WEDNESDAY,0,0,2.8,82,27.7,1014.9,Rain
3/2/2022 2:00,10,103,9465,59606,113,69071,WEDNESDAY,0,0,2.8,82,22.3,1014,Rain
3/2/2022 3:00,11,53,9483,37122,64,46605,WEDNESDAY,0,0,2.8,85,14.8,1013.4,Rain
3/2/2022 4:00,3,32,3312,18346,35,21658,WEDNESDAY,0,0,2.8,93,13,1012.6,Rain
3/2/2022 5:00,1,15,750,8314,16,9064,WEDNESDAY,0,0,2.8,96,7.6,1011.6,Rain
3/2/2022 6:00,0,5,0,2633,5,2633,WEDNESDAY,0,0,3.9,93,16.6,1010.9,Rain
3/2/2022 7:00,1,6,1746,5343,7,7089,WEDNESDAY,0,0,3.9,93,18.4,1010.4,Snow
3/2/2022 8:00,4,3,9758,3235,7,12993,WEDNESDAY,0,0,5,82,20.5,1010.1,Cloudy
3/2/2022 9:00,0,6,0,4769,6,4769,WEDNESDAY,0,0,5,79,20.5,1010.3,Cloudy
3/2/2022 10:00,3,26,1075,21900,29,22975,WEDNESDAY,0,0,3.9,79,16.6,1011.3,Fair
3/2/2022 11:00,2,92,1282,68542,94,69824,WEDNESDAY,0,0,3.9,76,18.4,1012.1,Fair
3/2/2022 12:00,25,253,113128,715274,278,828402,WEDNESDAY,0,0,3.3,73,16.6,1012.8,Fair
3/2/2022 13:00,50,480,38289,346496,530,384785,WEDNESDAY,0,0,3.9,64,14.8,1013.6,Fair
3/2/2022 14:00,40,358,38778,268300,398,307078,WEDNESDAY,0,0,3.9,57,16.6,1014.3,Fair
3/2/2022 15:00,28,248,31604,161398,276,193002,WEDNESDAY,0,0,3.9,48,24.1,1014.2,Fair
3/2/2022 16:00,29,205,36704,136681,234,173385,WEDNESDAY,0,0,4.4,43,22.3,1014.3,Fair
3/2/2022 17:00,26,255,21761,187004,281,208765,WEDNESDAY,0,0,5.6,41,22.3,1014.4,Fair
3/2/2022 18:00,44,251,90826,162196,295,253022,WEDNESDAY,0,0,5,41,18.4,1013.1,Fair
3/2/2022 19:00,24,273,819489,212102,297,1031591,WEDNESDAY,0,0,5.6,41,18.4,1012.7,Fair
3/2/2022 20:00,40,265,50637,188610,305,239247,WEDNESDAY,0,0,5.6,41,22.3,1012.9,Fair
3/2/2022 21:00,57,422,71901,309600,479,381501,WEDNESDAY,0,0,5.6,39,24.1,1013.2,Fair
3/2/2022 22:00,71,546,78315,423425,617,501740,WEDNESDAY,0,0,5,41,20.5,1013.4,Fair
3/2/2022 23:00,50,428,58872,307378,478,366250,WEDNESDAY,0,0,4.4,43,18.4,1014.2,Fair
3/3/2022 0:00,29,327,93596,241935,356,335531,THURSDAY,0,0,3.9,41,13,1015.2,Fair
3/3/2022 1:00,17,213,64370,146261,230,210631,THURSDAY,0,0,3.3,42,7.6,1014.9,Cloudy
3/3/2022 2:00,21,181,22796,132950,202,155746,THURSDAY,0,0,1.1,56,11.2,1014.2,Cloudy
3/3/2022 3:00,12,80,12506,51865,92,64371,THURSDAY,0,0,1.1,61,7.6,1013.6,Snow
3/3/2022 4:00,8,46,12323,31354,54,43677,THURSDAY,0,0,1.1,67,11.2,1012.7,Cloudy
3/3/2022 5:00,6,19,3756,13856,25,17612,THURSDAY,0,0,1.1,64,16.6,1011.6,Snow
3/3/2022 6:00,4,9,8518,3607,13,12125,THURSDAY,0,0,1.1,61,20.5,1009.8,Cloudy
3/3/2022 7:00,2,5,1501,2271,7,3772,THURSDAY,0,0,1.7,66,11.2,1009,Snow
3/3/2022 9:00,1,6,1024,3821,7,4845,THURSDAY,0,0,2.2,92,18.4,1007.6,Snow
3/3/2022 10:00,3,26,2890,24350,29,27240,THURSDAY,0,0,2.2,89,24.1,1007.9,Rain
3/3/2022 11:00,7,82,3633,53979,89,57612,THURSDAY,0,0,2.2,82,22.3,1008.9,Snow
3/3/2022 12:00,15,246,13713,193986,261,207699,THURSDAY,0,0,1.7,75,25.9,1010,Cloudy
3/3/2022 13:00,36,525,28772,385368,561,414140,THURSDAY,0,0,1.7,69,25.9,1010.9,Snow
3/3/2022 14:00,26,313,21590,188987,339,210577,THURSDAY,0,0,1.7,69,22.3,1012,Fair
3/3/2022 15:00,25,202,36248,140514,227,176762,THURSDAY,0,0,2.8,54,27.7,1012.6,Fair
3/3/2022 16:00,24,227,33946,162799,251,196745,THURSDAY,0,0,2.8,50,24.1,1013.6,Fair
3/3/2022 17:00,33,232,150261,260636,265,410897,THURSDAY,0,0,2.2,42,29.5,1014.1,Fair
3/3/2022 18:00,21,228,19976,148279,249,168255,THURSDAY,0,0,3.3,35,33.5,1014.2,Fair
3/3/2022 19:00,45,232,69164,149246,277,218410,THURSDAY,0,0,2.8,40,29.5,1014.7,Fair
3/3/2022 20:00,45,254,57192,167879,299,225071,THURSDAY,0,0,2.8,32,29.5,1015.4,Fair
3/3/2022 21:00,64,421,147171,315098,485,462269,THURSDAY,0,0,1.7,32,25.9,1016.5,Fair
3/3/2022 22:00,60,475,278717,343322,535,622039,THURSDAY,0,0,0.6,32,29.5,1017.6,Fair
3/3/2022 23:00,50,368,51881,263365,418,315246,THURSDAY,0,0,-0.6,33,24.1,1019.4,Fair
3/4/2022 0:00,32,255,33599,168018,287,201617,FRIDAY,0,0,-2.2,34,29.5,1021.6,Fair
3/4/2022 1:00,14,150,13149,100356,164,113505,FRIDAY,0,0,-3.3,35,29.5,1023.3,Fair
3/4/2022 2:00,10,112,5179,60707,122,65886,FRIDAY,0,0,-3.9,36,25.9,1025,Clear
3/4/2022 3:00,12,95,9190,54422,107,63612,FRIDAY,0,0,-5,42,24.1,1026.4,Clear
3/4/2022 4:00,12,48,15694,31850,60,47544,FRIDAY,0,0,-5.6,40,37.1,1027.5,Clear
3/4/2022 5:00,5,29,3751,17050,34,20801,FRIDAY,0,0,-6.1,43,29.5,1028.5,Clear
3/4/2022 6:00,13,32,15329,17995,45,33324,FRIDAY,0,0,-6.7,41,18.4,1029.5,Clear
3/4/2022 7:00,6,9,4121,6736,15,10857,FRIDAY,0,0,-7.2,43,18.4,1030.1,Clear
3/4/2022 9:00,3,4,6046,1573,7,7619,FRIDAY,0,0,-7.8,45,13,1031,Clear
3/4/2022 10:00,9,24,6896,16411,33,23307,FRIDAY,0,0,-8.3,44,13,1031.9,Clear
3/4/2022 11:00,9,70,10400,43637,79,54037,FRIDAY,0,0,-8.3,44,14.8,1032.6,Fair
3/4/2022 12:00,18,152,14589,127292,170,141881,FRIDAY,0,0,-7.8,43,11.2,1033.2,Fair
3/4/2022 13:00,20,301,16925,207723,321,224648,FRIDAY,0,0,-7.2,43,14.8,1033.7,Fair
3/4/2022 14:00,17,239,24124,144663,256,168787,FRIDAY,0,0,-6.1,43,13,1033.8,Fair
3/4/2022 15:00,23,214,21087,132095,237,153182,FRIDAY,0,0,-4.4,38,13,1033.6,Fair
3/4/2022 16:00,25,184,26042,130487,209,156529,FRIDAY,0,0,-3.3,38,18.4,1032.8,Fair
3/4/2022 17:00,34,217,57124,149312,251,206436,FRIDAY,0,0,-2.2,37,20.5,1031.9,Fair
3/4/2022 18:00,24,237,38244,191052,261,229296,FRIDAY,0,0,-1.1,34,20.5,1030.4,Fair
3/4/2022 19:00,37,248,101646,180262,285,281908,FRIDAY,0,0,0.6,30,24.1,1029.2,Fair
3/4/2022 20:00,59,270,2209771,209140,329,2418911,FRIDAY,0,0,1.1,30,13,1028.6,Fair
3/4/2022 21:00,59,354,71149,242414,413,313563,FRIDAY,0,0,1.1,28,14.8,1028.5,Fair
3/4/2022 22:00,67,439,126311,314208,506,440519,FRIDAY,0,0,1.1,29,22.3,1028,Fair
3/4/2022 23:00,49,354,55441,532942,403,588383,FRIDAY,0,0,0,31,14.8,1028.3,Clear
3/5/2022 0:00,35,217,167687,173649,252,341336,SATURDAY,1,0,0,34,14.8,1029,Clear
3/5/2022 1:00,19,161,31650,101678,180,133328,SATURDAY,1,0,0,33,20.5,1029.5,Clear
3/5/2022 2:00,18,121,74994,79342,139,154336,SATURDAY,1,0,-1.1,34,14.8,1030.6,Clear
3/5/2022 3:00,21,95,67508,60219,116,127727,SATURDAY,1,0,-1.7,36,13,1030.7,Clear
3/5/2022 4:00,18,69,27663,45187,87,72850,SATURDAY,1,0,-1.7,36,9.4,1030.9,Clear
3/5/2022 5:00,29,36,82279,27242,65,109521,SATURDAY,1,0,-1.7,39,16.6,1030.9,Clear
3/5/2022 6:00,32,37,1054371,39396,69,1093767,SATURDAY,1,0,-2.2,42,11.2,1031.2,Clear
3/5/2022 7:00,30,26,64082,22048,56,86130,SATURDAY,1,0,-2.2,42,13,1031.4,Clear
3/5/2022 8:00,9,7,9572,5059,16,14631,SATURDAY,1,0,-2.8,44,16.6,1031.2,Clear
3/5/2022 9:00,2,9,772,6057,11,6829,SATURDAY,1,0,-3.3,48,14.8,1031.4,Clear
3/5/2022 10:00,0,12,0,5677,12,5677,SATURDAY,1,0,-3.3,50,13,1031.9,Clear
3/5/2022 11:00,8,24,7680,15640,32,23320,SATURDAY,1,0,-2.8,48,13,1032.4,Fair
3/5/2022 12:00,7,42,11807,41062,49,52869,SATURDAY,1,0,-1.7,45,14.8,1032.9,Fair
3/5/2022 13:00,16,88,16742,69236,104,85978,SATURDAY,1,0,-1.1,44,14.8,1033.3,Fair
3/5/2022 14:00,40,134,220120,365962,174,586082,SATURDAY,1,0,0,43,14.8,1033.7,Fair
3/5/2022 15:00,36,171,77610,122113,207,199723,SATURDAY,1,0,1.7,38,18.4,1033.5,Cloudy
3/5/2022 16:00,58,245,107367,204062,303,311429,SATURDAY,1,0,2.2,37,20.5,1032.9,Cloudy
3/5/2022 17:00,89,298,144039,229793,387,373832,SATURDAY,1,0,3.3,35,14.8,1032.5,Cloudy
3/5/2022 18:00,110,269,155307,230832,379,386139,SATURDAY,1,0,3.3,35,20.5,1031.8,Cloudy
3/5/2022 19:00,136,319,701689,239985,455,941674,SATURDAY,1,0,4.4,36,16.6,1031.4,Cloudy
3/5/2022 20:00,128,285,208407,213167,413,421574,SATURDAY,1,0,5,33,13,1031.1,Cloudy
3/5/2022 21:00,112,282,249668,231022,394,480690,SATURDAY,1,0,5,33,14.8,1030.5,Cloudy
3/5/2022 22:00,105,287,2185529,222736,392,2408265,SATURDAY,1,0,5,30,16.6,1030.2,Cloudy
3/5/2022 23:00,70,253,2756756,181533,323,2938289,SATURDAY,1,0,3.9,37,9.4,1029.9,Cloudy
3/6/2022 0:00,33,198,27831,133839,231,161670,SUNDAY,1,0,2.8,50,20.5,1030.2,Cloudy
3/6/2022 1:00,27,139,33772,90710,166,124482,SUNDAY,1,0,2.8,48,18.4,1030.2,Cloudy
3/6/2022 2:00,31,100,204352,76175,131,280527,SUNDAY,1,0,2.8,54,14.8,1029.8,Cloudy
3/6/2022 3:00,31,100,24068,66890,131,90958,SUNDAY,1,0,2.8,57,16.6,1029.5,Cloudy
3/6/2022 4:00,27,78,19542,53343,105,72885,SUNDAY,1,0,2.8,61,13,1028.4,Cloudy
3/6/2022 5:00,36,58,31331,29652,94,60983,SUNDAY,1,0,2.8,70,7.6,1027.9,Cloudy
3/6/2022 6:00,74,67,121599,168193,141,289792,SUNDAY,1,0,2.8,70,14.8,1026.8,Cloudy
3/6/2022 7:00,50,38,82293,31166,88,113459,SUNDAY,1,0,2.8,72,11.2,1025.7,Cloudy
3/6/2022 8:00,6,7,10199,7868,13,18067,SUNDAY,1,0,2.8,76,9.4,1024.2,Cloudy
3/6/2022 9:00,5,8,9033,6314,13,15347,SUNDAY,1,0,2.8,85,7.6,1022.6,Cloudy
3/6/2022 10:00,2,9,2089,6694,11,8783,SUNDAY,1,0,2.8,89,9.4,1021,Cloudy
3/6/2022 11:00,4,27,2988,18090,31,21078,SUNDAY,1,0,3.9,89,7.6,1019.1,Cloudy
3/6/2022 12:00,2,32,5298,31956,34,37254,SUNDAY,1,0,3.9,93,0,1017.3,Cloudy
3/6/2022 13:00,18,75,38361,47802,93,86163,SUNDAY,1,0,5,96,11.2,1016.2,Cloudy
3/6/2022 14:00,24,135,23767,102674,159,126441,SUNDAY,1,0,7.2,93,11.2,1014,Cloudy
3/6/2022 15:00,66,182,127075,145099,248,272174,SUNDAY,1,0,10.6,86,29.5,1013.7,Cloudy
3/6/2022 16:00,76,247,118195,1810767,323,1928962,SUNDAY,1,0,12.8,77,24.1,1012.7,Cloudy
3/6/2022 17:00,101,265,2540589,232555,366,2773144,SUNDAY,1,0,12.8,77,33.5,1012.7,Cloudy
3/6/2022 18:00,108,274,197788,230113,382,427901,SUNDAY,1,0,13.3,80,29.5,1010.9,Cloudy
3/6/2022 19:00,200,361,600290,358308,561,958598,SUNDAY,1,0,16.7,67,31.7,1009.5,Cloudy
3/6/2022 20:00,278,392,1146179,389283,670,1535462,SUNDAY,1,0,17.8,60,33.5,1009.2,Cloudy
3/6/2022 21:00,281,483,933666,518060,764,1451726,SUNDAY,1,0,17.8,63,42.5,1008.7,Cloudy
3/6/2022 22:00,189,403,1601946,364597,592,1966543,SUNDAY,1,0,16.7,67,37.1,1008.9,Cloudy
3/6/2022 23:00,118,304,1022128,232400,422,1254528,SUNDAY,1,0,15.6,75,37.1,1009,Cloudy
3/7/2022 0:00,67,215,133835,157745,282,291580,MONDAY,0,0,15.6,78,38.9,1008.1,Cloudy
3/7/2022 1:00,46,174,115767,116564,220,232331,MONDAY,0,0,15.6,78,35.3,1007.7,Cloudy
3/7/2022 2:00,45,121,126589,79630,166,206219,MONDAY,0,0,15.6,78,38.9,1007.1,Cloudy
3/7/2022 3:00,43,90,81389,67060,133,148449,MONDAY,0,0,17.2,72,44.6,1006.9,Cloudy
3/7/2022 4:00,42,55,162129,39423,97,201552,MONDAY,0,0,17.8,68,42.5,1006.9,Cloudy
3/7/2022 5:00,16,28,117378,21689,44,139067,MONDAY,0,0,17.2,65,29.5,1007.2,Cloudy
3/7/2022 6:00,25,15,41781,15548,40,57329,MONDAY,0,0,16.7,67,20.5,1008.3,Cloudy
3/7/2022 7:00,4,10,8213,10419,14,18632,MONDAY,0,0,15.6,67,24.1,1009.1,Cloudy
3/7/2022 8:00,6,2,9192,2002,8,11194,MONDAY,0,0,14.4,51,22.3,1009.7,Cloudy
3/7/2022 9:00,2,12,1264,7744,14,9008,MONDAY,0,0,12.8,52,18.4,1010.2,Cloudy
3/7/2022 10:00,8,32,6777,25869,40,32646,MONDAY,0,0,12.2,50,22.3,1010.7,Cloudy
3/7/2022 11:00,12,122,8307,74185,134,82492,MONDAY,0,0,11.7,52,18.4,1010.9,Cloudy
3/7/2022 12:00,19,277,19535,191741,296,211276,MONDAY,0,0,11.7,50,22.3,1010.8,Cloudy
3/7/2022 13:00,47,569,61010,429053,616,490063,MONDAY,0,0,11.1,54,16.6,1011.9,Cloudy
3/7/2022 14:00,21,352,23110,346504,373,369614,MONDAY,0,0,12.2,49,13,1011.8,Cloudy
3/7/2022 15:00,35,229,67075,197466,264,264541,MONDAY,0,0,13.3,47,11.2,1010.9,Cloudy
3/7/2022 16:00,45,236,64949,166263,281,231212,MONDAY,0,0,13.3,47,13,1010.5,Cloudy
3/7/2022 17:00,49,289,80027,364038,338,444065,MONDAY,0,0,13.9,47,11.2,1009.1,Rain
3/7/2022 18:00,82,254,144677,179539,336,324216,MONDAY,0,0,11.7,61,11.2,1006.4,Rain
3/7/2022 19:00,69,296,271120,198337,365,469457,MONDAY,0,0,12.2,61,13,1004,Rain
3/7/2022 20:00,59,287,88760,199238,346,287998,MONDAY,0,0,12.8,64,9.4,1002.9,Rain
3/7/2022 21:00,52,314,3844314,296864,366,4141178,MONDAY,0,0,10.6,71,5.4,1002.3,Rain
3/7/2022 22:00,39,351,65753,244707,390,310460,MONDAY,0,0,13.3,87,20.5,1001.5,Rain
3/7/2022 23:00,18,264,92500,177932,282,270432,MONDAY,0,0,12.8,89,13,1000.4,Rain
3/8/2022 0:00,26,232,46875,151069,258,197944,TUESDAY,0,0,12.2,93,14.8,999.6,Rain
3/8/2022 1:00,17,156,22344,95679,173,118023,TUESDAY,0,0,12.8,89,18.4,998,Rain
3/8/2022 2:00,22,106,35376,76111,128,111487,TUESDAY,0,0,12.2,93,18.4,995.2,Rain
3/8/2022 3:00,15,54,58035,30237,69,88272,TUESDAY,0,0,13.9,83,35.3,993,Rain
3/8/2022 4:00,3,29,1174,18305,32,19479,TUESDAY,0,0,11.7,83,44.6,998,Rain
3/8/2022 5:00,5,15,4108,9597,20,13705,TUESDAY,0,0,10.6,54,42.5,998.1,Cloudy
3/8/2022 6:00,6,6,5687,3594,12,9281,TUESDAY,0,0,6.7,55,38.9,1000.1,Cloudy
3/8/2022 7:00,1,3,1248,2975,4,4223,TUESDAY,0,0,5.6,57,24.1,1001.4,Cloudy
3/8/2022 8:00,1,3,2119,3927,4,6046,TUESDAY,0,0,5,55,31.7,1002.6,Fair
3/8/2022 9:00,0,10,0,7803,10,7803,TUESDAY,0,0,4.4,55,27.7,1004.1,Fair
3/8/2022 10:00,6,34,3639,27569,40,31208,TUESDAY,0,0,4.4,55,27.7,1005.4,Fair
3/8/2022 11:00,9,109,8077,76605,118,84682,TUESDAY,0,0,4.4,53,35.3,1006.8,Fair
3/8/2022 12:00,30,319,70374,219506,349,289880,TUESDAY,0,0,3.9,50,38.9,1008.5,Fair
3/8/2022 13:00,39,585,33397,401120,624,434517,TUESDAY,0,0,3.9,50,44.6,1010.3,Fair
3/8/2022 14:00,27,365,22299,246115,392,268414,TUESDAY,0,0,5,45,35.3,1011.8,Fair
3/8/2022 15:00,26,189,38265,132143,215,170408,TUESDAY,0,0,5,43,40.7,1012.7,Fair
3/8/2022 16:00,42,219,80684,620093,261,700777,TUESDAY,0,0,4.4,43,38.9,1014.2,Fair
3/8/2022 17:00,53,263,572493,172609,316,745102,TUESDAY,0,0,5,38,33.5,1014.5,Fair
3/8/2022 18:00,48,226,68891,1279644,274,1348535,TUESDAY,0,0,5.6,30,31.7,1015.3,Fair
3/8/2022 19:00,70,275,129606,202811,345,332417,TUESDAY,0,0,6.1,29,27.7,1015.6,Fair
3/8/2022 20:00,58,319,166575,313294,377,479869,TUESDAY,0,0,5.6,29,27.7,1016.7,Fair
3/8/2022 21:00,88,452,239270,330101,540,569371,TUESDAY,0,0,6.1,29,24.1,1017,Fair
3/8/2022 22:00,111,579,145962,414630,690,560592,TUESDAY,0,0,5.6,28,16.6,1018.1,Fair
3/8/2022 23:00,45,463,120858,334434,508,455292,TUESDAY,0,0,5,28,16.6,1019.2,Fair
3/9/2022 0:00,45,351,58786,233778,396,292564,WEDNESDAY,0,0,4.4,29,20.5,1020,Fair
3/9/2022 1:00,20,182,15475,112828,202,128303,WEDNESDAY,0,0,3.9,28,18.4,1020.8,Fair
3/9/2022 2:00,16,146,80442,107287,162,187729,WEDNESDAY,0,0,3.3,31,9.4,1021.5,Fair
3/9/2022 3:00,18,116,24633,69569,134,94202,WEDNESDAY,0,0,2.8,34,7.6,1022.4,Fair
3/9/2022 4:00,8,51,7890,31304,59,39194,WEDNESDAY,0,0,2.8,34,0,1022.5,Fair
3/9/2022 5:00,5,14,4999,8692,19,13691,WEDNESDAY,0,0,2.8,37,13,1023.2,Cloudy
3/9/2022 6:00,1,11,1327,5662,12,6989,WEDNESDAY,0,0,2.2,40,13,1023.2,Fair
3/9/2022 7:00,1,8,2433,6014,9,8447,WEDNESDAY,0,0,1.1,43,9.4,1022.6,Fair
3/9/2022 8:00,0,2,0,2753,2,2753,WEDNESDAY,0,0,1.1,46,11.2,1022.5,Cloudy
3/9/2022 9:00,2,5,1295,4233,7,5528,WEDNESDAY,0,0,1.1,43,0,1022.4,Cloudy
3/9/2022 10:00,4,49,4271,33769,53,38040,WEDNESDAY,0,0,1.1,43,0,1021.9,Cloudy
3/9/2022 11:00,9,98,11512,66293,107,77805,WEDNESDAY,0,0,0.6,58,0,1022.5,Cloudy
3/9/2022 12:00,21,257,21537,200586,278,222123,WEDNESDAY,0,0,1.1,54,0,1022.1,Cloudy
3/9/2022 13:00,53,527,61434,358753,580,420187,WEDNESDAY,0,0,1.7,52,0,1022.3,Cloudy
3/9/2022 14:00,18,356,24446,333134,374,357580,WEDNESDAY,0,0,1.7,54,0,1022.1,Cloudy
3/9/2022 15:00,27,236,46342,144840,263,191182,WEDNESDAY,0,0,2.8,54,5.4,1021,Cloudy
3/9/2022 16:00,35,239,57973,160051,274,218024,WEDNESDAY,0,0,2.8,57,5.4,1020.3,Snow
3/9/2022 17:00,29,265,49426,141739,294,191165,WEDNESDAY,0,0,3.3,52,5.4,1019.5,Snow
3/9/2022 18:00,38,210,40326,132322,248,172648,WEDNESDAY,0,0,4.4,46,7.6,1017.7,Snow
3/9/2022 19:00,22,221,17488,185110,243,202598,WEDNESDAY,0,0,3.3,59,13,1017,Snow
3/9/2022 20:00,26,170,34835,106085,196,140920,WEDNESDAY,0,0,1.7,75,9.4,1016.5,Snow
3/9/2022 21:00,11,163,35100,515846,174,550946,WEDNESDAY,0,0,0.6,92,9.4,1015.7,Snow
3/9/2022 22:00,12,216,18774,160785,228,179559,WEDNESDAY,0,0,0.6,96,11.2,1014.9,Snow
3/9/2022 23:00,9,152,9473,126381,161,135854,WEDNESDAY,0,0,0.6,92,14.8,1014.2,Snow
3/10/2022 0:00,7,110,7305,66963,117,74268,THURSDAY,0,0,0.6,92,11.2,1015.5,Snow
3/10/2022 1:00,8,78,6094,50523,86,56617,THURSDAY,0,0,0,96,14.8,1015.6,Snow
3/10/2022 2:00,3,66,4870,38602,69,43472,THURSDAY,0,0,0,92,14.8,1015.8,Snow
3/10/2022 3:00,5,63,5232,44030,68,49262,THURSDAY,0,0,0.6,88,16.6,1016.2,Snow
3/10/2022 4:00,4,40,1992,58376,44,60368,THURSDAY,0,0,0.6,88,11.2,1017,Rain
3/10/2022 5:00,6,16,8678,9966,22,18644,THURSDAY,0,0,0.6,85,11.2,1016.7,Cloudy
3/10/2022 6:00,3,17,2858,12303,20,15161,THURSDAY,0,0,0.6,85,5.4,1016.8,Cloudy
3/10/2022 7:00,5,4,11517,3689,9,15206,THURSDAY,0,0,0,88,5.4,1017.4,Cloudy
3/10/2022 8:00,1,5,1382,3420,6,4802,THURSDAY,0,0,0,85,11.2,1017.3,Cloudy
3/10/2022 9:00,1,4,2040,3932,5,5972,THURSDAY,0,0,0,85,7.6,1018.1,Cloudy
3/10/2022 10:00,4,33,11049,23858,37,34907,THURSDAY,0,0,-1.1,88,14.8,1018.6,Fair
3/10/2022 11:00,3,75,1813,50576,78,52389,THURSDAY,0,0,-1.1,88,16.6,1019.7,Fair
3/10/2022 12:00,17,229,18537,156263,246,174800,THURSDAY,0,0,0.6,82,13,1020.3,Fair
3/10/2022 13:00,27,456,29430,314592,483,344022,THURSDAY,0,0,1.7,75,14.8,1020.9,Fair
3/10/2022 14:00,25,325,39387,208717,350,248104,THURSDAY,0,0,3.3,70,20.5,1021.4,Fair
3/10/2022 15:00,39,226,62013,163351,265,225364,THURSDAY,0,0,4.4,65,16.6,1021.4,Fair
3/10/2022 16:00,43,246,84966,184902,289,269868,THURSDAY,0,0,6.1,57,11.2,1021.3,Cloudy
3/10/2022 17:00,45,310,96031,220674,355,316705,THURSDAY,0,0,8.3,49,9.4,1020.7,Cloudy
3/10/2022 18:00,54,260,101646,181447,314,283093,THURSDAY,0,0,9.4,39,18.4,1019.8,Cloudy
3/10/2022 19:00,51,279,103084,191050,330,294134,THURSDAY,0,0,9.4,41,5.4,1019.6,Cloudy
3/10/2022 20:00,109,311,305289,249489,420,554778,THURSDAY,0,0,10,37,0,1019.5,Cloudy
3/10/2022 21:00,83,473,114485,353488,556,467973,THURSDAY,0,0,9.4,44,13,1018.9,Cloudy
3/10/2022 22:00,123,657,653431,882687,780,1536118,THURSDAY,0,0,6.7,65,13,1019.2,Cloudy
3/10/2022 23:00,81,483,87458,356788,564,444246,THURSDAY,0,0,6.7,62,13,1019.5,Cloudy
3/11/2022 0:00,70,354,132071,244851,424,376922,FRIDAY,0,0,5.6,67,13,1019.6,Cloudy
3/11/2022 1:00,41,203,52761,133457,244,186218,FRIDAY,0,0,5.6,67,20.5,1019.8,Cloudy
3/11/2022 2:00,31,175,44238,134373,206,178611,FRIDAY,0,0,4.4,73,14.8,1020.3,Cloudy
3/11/2022 3:00,49,120,97365,80681,169,178046,FRIDAY,0,0,3.9,79,13,1019.9,Cloudy
3/11/2022 4:00,29,82,935464,91388,111,1026852,FRIDAY,0,0,3.3,83,16.6,1019.7,Cloudy
3/11/2022 5:00,17,41,27596,30562,58,58158,FRIDAY,0,0,3.9,76,13,1019.4,Fair
3/11/2022 6:00,19,32,24045,22061,51,46106,FRIDAY,0,0,2.8,78,11.2,1020,Fair
3/11/2022 7:00,10,12,38541,10885,22,49426,FRIDAY,0,0,2.2,79,5.4,1019.4,Fair
3/11/2022 8:00,3,5,2079,5495,8,7574,FRIDAY,0,0,0,88,5.4,1019.4,Clear
3/11/2022 9:00,1,9,1242,5101,10,6343,FRIDAY,0,0,1.1,85,0,1019.8,Clear
3/11/2022 10:00,3,38,8849,24226,41,33075,FRIDAY,0,0,0.6,85,5.4,1020.1,Clear
3/11/2022 11:00,10,82,7668,56749,92,64417,FRIDAY,0,0,0,85,7.6,1020.2,Fair
3/11/2022 12:00,19,212,28760,155526,231,184286,FRIDAY,0,0,2.2,79,0,1020.1,Fair
3/11/2022 13:00,25,401,26546,291645,426,318191,FRIDAY,0,0,3.9,67,7.6,1020.3,Fair
3/11/2022 14:00,30,336,75619,229930,366,305549,FRIDAY,0,0,6.1,53,7.6,1020.5,Fair
3/11/2022 15:00,37,259,44063,185215,296,229278,FRIDAY,0,0,7.2,47,9.4,1020.3,Cloudy
3/11/2022 16:00,64,222,99502,169247,286,268749,FRIDAY,0,0,8.3,42,9.4,1020,Cloudy
3/11/2022 17:00,85,318,137397,243936,403,381333,FRIDAY,0,0,8.3,48,16.6,1019.2,Cloudy
3/11/2022 18:00,86,336,131689,243322,422,375011,FRIDAY,0,0,8.3,48,18.4,1018,Cloudy
3/11/2022 19:00,160,341,1154099,302361,501,1456460,FRIDAY,0,0,7.8,53,22.3,1017,Cloudy
3/11/2022 20:00,178,413,736766,378436,591,1115202,FRIDAY,0,0,8.3,58,24.1,1016.4,Cloudy
3/11/2022 21:00,171,492,1737468,934386,663,2671854,FRIDAY,0,0,8.3,65,22.3,1015.5,Cloudy
3/11/2022 22:00,167,596,512870,502659,763,1015529,FRIDAY,0,0,10,48,24.1,1014.6,Cloudy
3/11/2022 23:00,98,442,1639615,340440,540,1980055,FRIDAY,0,0,7.8,49,22.3,1014.2,Cloudy
3/12/2022 0:00,74,311,321865,220082,385,541947,SATURDAY,1,0,7.2,56,25.9,1014.4,Cloudy
3/12/2022 1:00,65,205,73139,144475,270,217614,SATURDAY,1,0,5.6,64,20.5,1014.2,Cloudy
3/12/2022 2:00,47,153,194778,99927,200,294705,SATURDAY,1,0,5,65,20.5,1013.8,Cloudy
3/12/2022 3:00,58,107,590811,82184,165,672995,SATURDAY,1,0,4.4,79,18.4,1013.3,Rain
3/12/2022 4:00,32,109,31463,68405,141,99868,SATURDAY,1,0,4.4,89,13,1012.7,Cloudy
3/12/2022 5:00,40,61,47411,53753,101,101164,SATURDAY,1,0,5,86,9.4,1011.3,Cloudy
3/12/2022 6:00,67,47,1509064,71104,114,1580168,SATURDAY,1,0,5,86,13,1010,Cloudy
3/12/2022 7:00,22,39,25669,44030,61,69699,SATURDAY,1,0,4.4,97,5.4,1008.4,Cloudy
3/12/2022 8:00,7,8,13127,5891,15,19018,SATURDAY,1,0,4.4,97,7.6,1006.3,Cloudy
3/12/2022 9:00,2,10,1336,7029,12,8365,SATURDAY,1,0,5,96,0,1005.3,Cloudy
3/12/2022 10:00,0,7,0,7609,7,7609,SATURDAY,1,0,5,96,9.4,1001,Rain
3/12/2022 11:00,5,23,5962,17276,28,23238,SATURDAY,1,0,5.6,96,9.4,1000.6,Rain
3/12/2022 12:00,5,38,4736,33231,43,37967,SATURDAY,1,0,5.6,96,7.6,998.7,Cloudy
3/12/2022 13:00,10,78,17341,55340,88,72681,SATURDAY,1,0,6.7,96,0,996.6,Cloudy
3/12/2022 14:00,24,121,31254,89728,145,120982,SATURDAY,1,0,7.2,97,7.6,995.4,Rain
3/12/2022 15:00,33,162,44979,108336,195,153315,SATURDAY,1,0,7.2,97,5.4,991.8,Rain
3/12/2022 16:00,21,97,26259,58788,118,85047,SATURDAY,1,0,7.2,97,0,988.8,Rain
3/12/2022 17:00,5,59,7524,33450,64,40974,SATURDAY,1,0,7.2,97,18.4,987.3,Rain
3/12/2022 18:00,9,73,10691,49017,82,59708,SATURDAY,1,0,5,89,29.5,985.4,Rain
3/12/2022 19:00,17,124,16130,90205,141,106335,SATURDAY,1,0,3.3,86,29.5,983.1,Rain
3/12/2022 20:00,9,111,12289,72011,120,84300,SATURDAY,1,0,2.8,82,35.3,983.5,Rain
3/12/2022 21:00,17,80,18911,55789,97,74700,SATURDAY,1,0,1.7,85,33.5,985,Cloudy
3/12/2022 22:00,18,99,242270,68334,117,310604,SATURDAY,1,0,0.6,78,37.1,986.1,Snow
3/12/2022 23:00,11,61,12817,45040,72,57857,SATURDAY,1,0,-1.1,81,31.7,987.8,Snow
3/13/2022 0:00,5,89,3679,64801,94,68480,SUNDAY,1,0,-1.7,72,38.9,988.9,Snow
3/13/2022 1:00,5,48,8921,32741,53,41662,SUNDAY,1,0,-2.2,69,48.2,990,Snow
3/13/2022 2:00,6,48,478463,29893,54,508356,SUNDAY,1,0,-3.3,57,50,991.7,Cloudy
3/13/2022 3:00,4,39,7015,25441,43,32456,SUNDAY,1,0,-3.9,66,37.1,993.2,Cloudy
3/13/2022 4:00,10,28,2115052,15167,38,2130219,SUNDAY,1,0,-4.4,57,37.1,994.5,Cloudy
3/13/2022 5:00,7,28,11789,15891,35,27680,SUNDAY,1,0,-4.4,62,31.7,995.8,Cloudy
3/13/2022 6:00,22,29,68293,19264,51,87557,SUNDAY,1,0,-4.4,55,46.4,997.6,Cloudy
3/13/2022 7:00,8,16,9685,14213,24,23898,SUNDAY,1,0,-5,54,40.7,999.3,Fair
3/13/2022 8:00,3,5,3188,2955,8,6143,SUNDAY,1,0,-5.6,55,38.9,1000.9,Fair
3/13/2022 9:00,2,11,1851,5907,13,7758,SUNDAY,1,0,-5.6,52,40.7,1003.6,Fair
3/13/2022 10:00,1,14,1372,7065,15,8437,SUNDAY,1,0,-5.6,52,29.5,1006.4,Fair
3/13/2022 11:00,2,16,2363,10162,18,12525,SUNDAY,1,0,-5.6,50,35.3,1009.5,Fair
3/13/2022 12:00,4,28,5316,19147,32,24463,SUNDAY,1,0,-5.6,52,38.9,1012.5,Fair
3/13/2022 13:00,15,88,14360,60004,103,74364,SUNDAY,1,0,-4.4,48,33.5,1014.4,Fair
3/13/2022 14:00,27,113,34905,79399,140,114304,SUNDAY,1,0,-3.3,44,33.5,1016,Fair
3/13/2022 15:00,32,144,44241,96014,176,140255,SUNDAY,1,0,-2.2,40,24.1,1017.2,Fair
3/13/2022 16:00,65,209,102351,155104,274,257455,SUNDAY,1,0,-1.1,36,22.3,1017.7,Fair
3/13/2022 17:00,45,202,65876,154474,247,220350,SUNDAY,1,0,0,34,22.3,1018,Fair
3/13/2022 18:00,66,233,132257,212353,299,344610,SUNDAY,1,0,1.1,30,29.5,1018.1,Fair
3/13/2022 19:00,83,217,667258,174902,300,842160,SUNDAY,1,0,1.7,32,27.7,1018.3,Fair
3/13/2022 20:00,68,260,114908,205647,328,320555,SUNDAY,1,0,1.7,29,27.7,1018.2,Fair
3/13/2022 21:00,57,250,235886,197177,307,433063,SUNDAY,1,0,1.7,29,24.1,1018.1,Fair
3/13/2022 22:00,41,210,53456,147463,251,200919,SUNDAY,1,0,1.7,30,24.1,1018.4,Cloudy
3/13/2022 23:00,26,140,29322,103366,166,132688,SUNDAY,1,0,1.1,35,31.7,1019.1,Cloudy
3/14/2022 0:00,21,119,19650,80484,140,100134,MONDAY,0,0,0.6,36,22.3,1020.3,Cloudy
3/14/2022 1:00,20,78,14504,46121,98,60625,MONDAY,0,0,0,41,25.9,1021.3,Cloudy
3/14/2022 2:00,8,56,8520,32644,64,41164,MONDAY,0,0,-0.6,43,18.4,1022.4,Fair
3/14/2022 3:00,5,38,3759,21050,43,24809,MONDAY,0,0,-0.6,43,24.1,1022.8,Fair
3/14/2022 4:00,5,18,4106,8995,23,13101,MONDAY,0,0,-0.6,43,22.3,1023.5,Fair
3/14/2022 5:00,4,7,2626,4090,11,6716,MONDAY,0,0,-0.6,47,25.9,1024.7,Fair
3/14/2022 6:00,0,4,0,2992,4,2992,MONDAY,0,0,-1.1,49,18.4,1025.3,Fair
3/14/2022 7:00,2,5,2681,2688,7,5369,MONDAY,0,0,-1.1,49,18.4,1025.2,Fair
3/14/2022 8:00,0,6,0,2591,6,2591,MONDAY,0,0,-1.7,53,20.5,1025.2,Fair
3/14/2022 9:00,3,29,1783,21206,32,22989,MONDAY,0,0,-1.7,56,16.6,1025.7,Fair
3/14/2022 10:00,3,85,3154,53544,88,56698,MONDAY,0,0,-1.7,56,13,1026,Fair
3/14/2022 11:00,15,194,12368,141435,209,153803,MONDAY,0,0,-1.7,58,14.8,1026.5,Fair
3/14/2022 12:00,14,400,13760,279139,414,292899,MONDAY,0,0,0.6,49,18.4,1026.7,Fair
3/14/2022 13:00,18,303,30259,193824,321,224083,MONDAY,0,0,1.7,45,20.5,1027.3,Fair
3/14/2022 14:00,25,165,36731,129328,190,166059,MONDAY,0,0,4.4,41,11.2,1027.9,Fair
3/14/2022 15:00,31,215,52040,175362,246,227402,MONDAY,0,0,6.7,38,16.6,1028,Fair
3/14/2022 16:00,48,237,268942,1309804,285,1578746,MONDAY,0,0,7.8,35,24.1,1027.7,Fair
3/14/2022 17:00,50,216,99714,260075,266,359789,MONDAY,0,0,8.9,34,18.4,1027.3,Fair
3/14/2022 18:00,67,260,617725,207413,327,825138,MONDAY,0,0,10,32,24.1,1026.7,Fair
3/14/2022 19:00,88,286,224142,273770,374,497912,MONDAY,0,0,10,30,24.1,1026.4,Fair
3/14/2022 20:00,92,382,191503,365162,474,556665,MONDAY,0,0,10.6,30,25.9,1025.7,Fair
3/14/2022 21:00,134,612,212082,469385,746,681467,MONDAY,0,0,11.1,28,14.8,1025.3,Fair
3/14/2022 22:00,107,515,279240,943195,622,1222435,MONDAY,0,0,10.6,29,18.4,1025.2,Cloudy
3/14/2022 23:00,49,311,239432,214339,360,453771,MONDAY,0,0,9.4,33,13,1025.6,Cloudy
3/15/2022 0:00,39,202,108884,194665,241,303549,TUESDAY,0,0,8.9,35,18.4,1025.8,Cloudy
3/15/2022 1:00,23,146,17589,112817,169,130406,TUESDAY,0,0,7.8,40,16.6,1026.3,Cloudy
3/15/2022 2:00,28,87,68572,59672,115,128244,TUESDAY,0,0,6.1,51,14.8,1026.6,Cloudy
3/15/2022 3:00,16,54,933650,37418,70,971068,TUESDAY,0,0,6.7,53,16.6,1026.1,Cloudy
3/15/2022 4:00,12,16,22627,11850,28,34477,TUESDAY,0,0,6.1,60,18.4,1025.2,Cloudy
3/15/2022 5:00,5,20,4306,11326,25,15632,TUESDAY,0,0,7.2,51,22.3,1024.3,Cloudy
3/15/2022 6:00,1,8,709,4296,9,5005,TUESDAY,0,0,6.7,55,24.1,1024.2,Cloudy
3/15/2022 7:00,2,2,3258,2524,4,5782,TUESDAY,0,0,7.2,56,25.9,1023.6,Cloudy
3/15/2022 8:00,1,6,1623,2855,7,4478,TUESDAY,0,0,6.7,60,24.1,1023.1,Cloudy
3/15/2022 9:00,6,23,4541,17846,29,22387,TUESDAY,0,0,6.7,60,16.6,1023.1,Cloudy
3/15/2022 10:00,11,106,43781,72581,117,116362,TUESDAY,0,0,7.8,53,18.4,1023,Cloudy
3/15/2022 11:00,19,311,15204,214824,330,230028,TUESDAY,0,0,7.2,56,20.5,1022.7,Cloudy
3/15/2022 12:00,63,629,137821,461848,692,599669,TUESDAY,0,0,7.8,53,18.4,1023.4,Cloudy
3/15/2022 13:00,35,390,51363,284741,425,336104,TUESDAY,0,0,8.9,50,16.6,1023.7,Cloudy
3/15/2022 14:00,46,211,104248,148021,257,252269,TUESDAY,0,0,11.1,44,11.2,1023.9,Cloudy
3/15/2022 15:00,57,234,113325,176264,291,289589,TUESDAY,0,0,13.3,40,9.4,1023.9,Cloudy
3/15/2022 16:00,74,290,393192,190563,364,583755,TUESDAY,0,0,13.9,37,5.4,1023.4,Cloudy
3/15/2022 17:00,86,284,128720,219511,370,348231,TUESDAY,0,0,13.3,42,13,1022.8,Cloudy
3/15/2022 18:00,105,232,223683,173293,337,396976,TUESDAY,0,0,12.2,50,22.3,1022.3,Cloudy
3/15/2022 19:00,103,327,205526,316538,430,522064,TUESDAY,0,0,10,56,24.1,1021.9,Cloudy
3/15/2022 20:00,139,457,268049,357645,596,625694,TUESDAY,0,0,8.9,58,24.1,1021.7,Cloudy
3/15/2022 21:00,179,690,580261,541210,869,1121471,TUESDAY,0,0,7.2,68,22.3,1021.2,Cloudy
3/15/2022 22:00,119,529,189300,418293,648,607593,TUESDAY,0,0,6.7,73,18.4,1021.1,Cloudy
3/15/2022 23:00,61,325,1272284,247630,386,1519914,TUESDAY,0,0,5.6,85,11.2,1021.2,Cloudy
3/16/2022 0:00,30,203,70824,141846,233,212670,WEDNESDAY,0,0,5.6,89,14.8,1021.1,Cloudy
3/16/2022 1:00,19,129,17337,94230,148,111567,WEDNESDAY,0,0,6.1,86,13,1021.1,Cloudy
3/16/2022 2:00,23,95,64609,73908,118,138517,WEDNESDAY,0,0,6.1,86,11.2,1021.2,Rain
3/16/2022 3:00,20,59,25590,40002,79,65592,WEDNESDAY,0,0,6.1,86,13,1020.6,Rain
3/16/2022 4:00,6,16,8885,9591,22,18476,WEDNESDAY,0,0,6.1,89,13,1020.5,Rain
3/16/2022 5:00,7,9,11550,5423,16,16973,WEDNESDAY,0,0,5.6,85,13,1020.3,Cloudy
3/16/2022 6:00,6,9,8857,7980,15,16837,WEDNESDAY,0,0,5,93,9.4,1019.8,Cloudy
3/16/2022 7:00,1,5,3299,2601,6,5900,WEDNESDAY,0,0,4.4,93,11.2,1020.1,Rain
3/16/2022 8:00,1,9,875,10638,10,11513,WEDNESDAY,0,0,4.4,93,9.4,1019.7,Cloudy
3/16/2022 9:00,3,39,2014,27330,42,29344,WEDNESDAY,0,0,3.9,93,13,1020.2,Cloudy
3/16/2022 10:00,13,93,9296,67375,106,76671,WEDNESDAY,0,0,3.9,93,7.6,1021.4,Fair
3/16/2022 11:00,19,266,43378,195190,285,238568,WEDNESDAY,0,0,4.4,89,13,1022.1,Fair
3/16/2022 12:00,53,600,44015,454448,653,498463,WEDNESDAY,0,0,3.9,89,11.2,1023.4,Fair
3/16/2022 13:00,28,371,84491,283114,399,367605,WEDNESDAY,0,0,5,82,5.4,1023.9,Fair
3/16/2022 14:00,39,206,44294,166266,245,210560,WEDNESDAY,0,0,6.1,79,5.4,1024.3,Fair
3/16/2022 15:00,51,233,119745,185000,284,304745,WEDNESDAY,0,0,6.1,82,7.6,1024.4,Fair
3/16/2022 16:00,56,258,130174,184151,314,314325,WEDNESDAY,0,0,6.1,82,13,1024.2,Fair
3/16/2022 17:00,94,270,162297,180638,364,342935,WEDNESDAY,0,0,6.7,82,16.6,1024.4,Fair
3/16/2022 18:00,103,246,283822,179389,349,463211,WEDNESDAY,0,0,8.3,71,14.8,1023.7,Fair
3/16/2022 19:00,128,314,323426,258918,442,582344,WEDNESDAY,0,0,9.4,63,13,1023.3,Fair
3/16/2022 20:00,135,411,235476,320342,546,555818,WEDNESDAY,0,0,8.3,71,22.3,1022.5,Fair
3/16/2022 21:00,183,706,445717,588468,889,1034185,WEDNESDAY,0,0,7.8,68,25.9,1022.2,Fair
3/16/2022 22:00,167,581,309184,632043,748,941227,WEDNESDAY,0,0,7.2,71,20.5,1022.5,Fair
3/16/2022 23:00,68,346,210542,235338,414,445880,WEDNESDAY,0,0,6.7,76,13,1023.1,Fair
3/17/2022 0:00,37,247,53179,174023,284,227202,THURSDAY,0,1,7.2,76,16.6,1023.6,Fair
3/17/2022 1:00,50,163,59177,112925,213,172102,THURSDAY,0,1,7.2,74,14.8,1024,Fair
3/17/2022 2:00,42,131,105923,76884,173,182807,THURSDAY,0,1,6.7,76,16.6,1024.1,Fair
3/17/2022 3:00,24,27,33722,20622,51,54344,THURSDAY,0,1,5.6,79,14.8,1024.2,Fair
3/17/2022 4:00,13,40,14361,27004,53,41365,THURSDAY,0,1,5.6,76,18.4,1024,Fair
3/17/2022 5:00,17,13,155701,8126,30,163827,THURSDAY,0,1,5,79,14.8,1023.4,Fair
3/17/2022 6:00,9,6,32054,5064,15,37118,THURSDAY,0,1,4.4,83,9.4,1023,Fair
3/17/2022 7:00,3,4,4295,1987,7,6282,THURSDAY,0,1,3.9,86,5.4,1022.7,Fair
3/17/2022 8:00,3,4,3493,4095,7,7588,THURSDAY,0,1,3.9,89,5.4,1021.9,Fair
3/17/2022 9:00,7,34,4666,27616,41,32282,THURSDAY,0,1,3.9,89,9.4,1022,Fair
3/17/2022 10:00,9,103,4786,66288,112,71074,THURSDAY,0,1,5,89,7.6,1021.7,Cloudy
3/17/2022 11:00,24,259,15925,189559,283,205484,THURSDAY,0,1,4.4,97,7.6,1021.6,Cloudy
3/17/2022 12:00,46,550,51735,397387,596,449122,THURSDAY,0,1,5.6,96,9.4,1021.4,Cloudy
3/17/2022 13:00,39,346,48175,274144,385,322319,THURSDAY,0,1,5.6,100,9.4,1021.4,Cloudy
3/17/2022 14:00,61,217,80109,159811,278,239920,THURSDAY,0,1,6.1,97,11.2,1020.9,Cloudy
3/17/2022 15:00,64,216,172273,293455,280,465728,THURSDAY,0,1,7.2,93,11.2,1020.5,Cloudy
3/17/2022 16:00,91,272,126197,168863,363,295060,THURSDAY,0,1,6.7,96,13,1019.9,Cloudy
3/17/2022 17:00,48,192,116313,121736,240,238049,THURSDAY,0,1,7.8,86,13,1019,Cloudy
3/17/2022 18:00,36,170,53077,195555,206,248632,THURSDAY,0,1,7.2,97,9.4,1018.3,Rain
3/17/2022 19:00,39,232,65355,162669,271,228024,THURSDAY,0,1,7.2,97,11.2,1017,Cloudy
3/17/2022 20:00,71,337,88437,255044,408,343481,THURSDAY,0,1,7.8,93,9.4,1016.1,Rain
3/17/2022 21:00,85,441,305721,345320,526,651041,THURSDAY,0,1,8.3,90,7.6,1015.1,Rain
3/17/2022 22:00,70,398,130097,306933,468,437030,THURSDAY,0,1,7.8,93,7.6,1014.7,Cloudy
3/17/2022 23:00,73,316,97698,245926,389,343624,THURSDAY,0,1,8.3,93,9.4,1014.5,Rain
3/18/2022 0:00,43,213,82481,147813,256,230294,FRIDAY,0,0,8.9,93,5.4,1014.1,Cloudy
3/18/2022 1:00,45,160,48487,116757,205,165244,FRIDAY,0,0,8.3,97,7.6,1014.1,Cloudy
3/18/2022 2:00,90,136,368075,106195,226,474270,FRIDAY,0,0,8.3,97,5.4,1013,Cloudy
3/18/2022 3:00,85,114,155086,99158,199,254244,FRIDAY,0,0,7.8,100,0,1013,Cloudy
3/18/2022 4:00,48,61,99297,56197,109,155494,FRIDAY,0,0,8.3,97,0,1012.4,Cloudy
3/18/2022 5:00,53,45,110453,37139,98,147592,FRIDAY,0,0,8.3,97,0,1012.1,Cloudy
3/18/2022 6:00,24,24,363053,20822,48,383875,FRIDAY,0,0,8.3,100,0,1012,Cloudy
3/18/2022 7:00,14,9,20627,6789,23,27416,FRIDAY,0,0,9.4,100,5.4,1011.6,Cloudy
3/18/2022 8:00,4,11,4023,5841,15,9864,FRIDAY,0,0,10,96,7.6,1011,Cloudy
3/18/2022 9:00,9,37,51501,34888,46,86389,FRIDAY,0,0,10,100,9.4,1011.7,Cloudy
3/18/2022 10:00,16,94,27590,63058,110,90648,FRIDAY,0,0,9.4,97,7.6,1012.2,Cloudy
3/18/2022 11:00,22,212,23305,164467,234,187772,FRIDAY,0,0,9.4,100,5.4,1012.7,Cloudy
3/18/2022 12:00,44,427,78979,316310,471,395289,FRIDAY,0,0,10,100,9.4,1013.6,Cloudy
3/18/2022 13:00,45,364,79810,266022,409,345832,FRIDAY,0,0,11.7,89,7.6,1014,Cloudy
3/18/2022 14:00,107,277,203659,223592,384,427251,FRIDAY,0,0,13.9,81,5.4,1014.2,Cloudy
3/18/2022 15:00,199,296,517918,250277,495,768195,FRIDAY,0,0,16.1,65,7.6,1014.4,Cloudy
3/18/2022 16:00,226,398,513767,434926,624,948693,FRIDAY,0,0,18.3,58,5.4,1014.7,Fair
3/18/2022 17:00,321,370,869922,342441,691,1212363,FRIDAY,0,0,19.4,51,11.2,1014.8,Fair
3/18/2022 18:00,448,422,1738008,413190,870,2151198,FRIDAY,0,0,17.2,60,16.6,1013.8,Fair
3/18/2022 19:00,529,501,1661459,495631,1030,2157090,FRIDAY,0,0,14.4,72,14.8,1013.6,Cloudy
3/18/2022 20:00,638,587,1604797,562722,1225,2167519,FRIDAY,0,0,15.6,62,22.3,1013.6,Cloudy
3/18/2022 21:00,591,736,1627309,720392,1327,2347701,FRIDAY,0,0,15,69,18.4,1013.8,Cloudy
3/18/2022 22:00,659,566,1833193,1132241,1225,2965434,FRIDAY,0,0,15,67,9.4,1014.3,Cloudy
3/18/2022 23:00,371,396,1174930,1367110,767,2542040,FRIDAY,0,0,12.8,74,13,1015.3,Cloudy
3/19/2022 0:00,248,274,2471742,234175,522,2705917,SATURDAY,1,0,12.8,74,0,1015.5,Cloudy
3/19/2022 1:00,224,213,848811,174390,437,1023201,SATURDAY,1,0,15,64,11.2,1016.2,Cloudy
3/19/2022 2:00,229,162,623973,234240,391,858213,SATURDAY,1,0,13.9,67,13,1016.3,Cloudy
3/19/2022 3:00,193,124,930960,237778,317,1168738,SATURDAY,1,0,12.2,69,9.4,1016.3,Rain
3/19/2022 4:00,186,108,343008,83790,294,426798,SATURDAY,1,0,12.8,66,7.6,1016.1,Cloudy
3/19/2022 5:00,256,94,1731994,86984,350,1818978,SATURDAY,1,0,11.7,71,9.4,1016.1,Cloudy
3/19/2022 6:00,94,44,1069741,54257,138,1123998,SATURDAY,1,0,12.2,69,7.6,1016.3,Cloudy
3/19/2022 7:00,33,27,51193,25605,60,76798,SATURDAY,1,0,10,80,9.4,1016.8,Cloudy
3/19/2022 8:00,18,7,63557,3554,25,67111,SATURDAY,1,0,8.9,86,7.6,1016.8,Cloudy
3/19/2022 9:00,9,16,9089,10211,25,19300,SATURDAY,1,0,8.3,86,7.6,1016.8,Cloudy
3/19/2022 10:00,10,43,10313,40411,53,50724,SATURDAY,1,0,7.2,90,11.2,1017,Cloudy
3/19/2022 11:00,17,53,21359,36232,70,57591,SATURDAY,1,0,7.2,93,14.8,1016.6,Cloudy
3/19/2022 12:00,12,78,226813,56166,90,282979,SATURDAY,1,0,6.7,96,11.2,1016.7,Cloudy
3/19/2022 13:00,35,100,43233,67971,135,111204,SATURDAY,1,0,6.7,93,14.8,1016.4,Rain
3/19/2022 14:00,30,120,168084,80760,150,248844,SATURDAY,1,0,6.7,96,18.4,1016.1,Rain
3/19/2022 15:00,50,128,88099,96621,178,184720,SATURDAY,1,0,6.7,100,11.2,1016.1,Cloudy
3/19/2022 16:00,74,197,171854,158876,271,330730,SATURDAY,1,0,7.8,96,11.2,1014.7,Cloudy
3/19/2022 17:00,85,230,108210,174130,315,282340,SATURDAY,1,0,7.8,96,14.8,1013.6,Rain
3/19/2022 18:00,71,159,93488,121179,230,214667,SATURDAY,1,0,8.3,93,13,1011.7,Rain
3/19/2022 19:00,69,186,125482,129091,255,254573,SATURDAY,1,0,8.3,97,13,1010.6,Cloudy
3/19/2022 20:00,83,204,126396,178818,287,305214,SATURDAY,1,0,8.9,96,9.4,1009.2,Cloudy
3/19/2022 21:00,68,194,264712,170507,262,435219,SATURDAY,1,0,9.4,97,7.6,1008.2,Cloudy
3/19/2022 22:00,85,207,91246,165861,292,257107,SATURDAY,1,0,10.6,96,9.4,1007.4,Cloudy
3/19/2022 23:00,70,171,503653,124825,241,628478,SATURDAY,1,0,9.4,97,7.6,1006.7,Cloudy
3/20/2022 0:00,46,118,2205867,92106,164,2297973,SUNDAY,1,0,8.9,96,9.4,1006.8,Cloudy
3/20/2022 1:00,47,106,103944,76066,153,180010,SUNDAY,1,0,8.9,96,9.4,1006.7,Cloudy
3/20/2022 2:00,73,70,106441,44313,143,150754,SUNDAY,1,0,8.3,97,11.2,1006,Cloudy
3/20/2022 3:00,44,69,82581,52617,113,135198,SUNDAY,1,0,7.8,96,7.6,1006,Rain
3/20/2022 4:00,65,58,148321,38038,123,186359,SUNDAY,1,0,8.3,97,11.2,1006.8,Cloudy
3/20/2022 5:00,138,64,243823,54060,202,297883,SUNDAY,1,0,8.3,86,5.4,1005.9,Cloudy
3/20/2022 6:00,59,39,215591,34948,98,250539,SUNDAY,1,0,8.3,90,7.6,1006.9,Cloudy
3/20/2022 7:00,26,7,70218,6008,33,76226,SUNDAY,1,0,8.3,90,0,1005.4,Cloudy
3/20/2022 8:00,4,8,23830,8123,12,31953,SUNDAY,1,0,6.1,97,5.4,1005.2,Cloudy
3/20/2022 9:00,6,7,3806,4023,13,7829,SUNDAY,1,0,7.8,96,14.8,1005.4,Cloudy
3/20/2022 10:00,2,34,994,23313,36,24307,SUNDAY,1,0,7.8,96,14.8,1005.3,Cloudy
3/20/2022 11:00,13,45,36761,29908,58,66669,SUNDAY,1,0,8.3,97,9.4,1005,Cloudy
3/20/2022 12:00,37,108,60989,85374,145,146363,SUNDAY,1,0,8.9,96,5.4,1005.5,Cloudy
3/20/2022 13:00,80,173,122779,141261,253,264040,SUNDAY,1,0,10,93,11.2,1006.6,Cloudy
3/20/2022 14:00,179,297,360722,274398,476,635120,SUNDAY,1,0,11.7,86,11.2,1006.3,Cloudy
3/20/2022 15:00,321,367,1209042,419288,688,1628330,SUNDAY,1,0,13.9,77,11.2,1006,Cloudy
3/20/2022 16:00,433,407,1137829,417900,840,1555729,SUNDAY,1,0,16.1,62,11.2,1005.3,Cloudy
3/20/2022 17:00,354,412,1222275,691757,766,1914032,SUNDAY,1,0,16.1,58,14.8,1004.9,Cloudy
3/20/2022 18:00,375,413,1385993,416847,788,1802840,SUNDAY,1,0,15.6,55,18.4,1004.7,Cloudy
3/20/2022 19:00,529,428,1631110,470144,957,2101254,SUNDAY,1,0,15.6,51,20.5,1004,Cloudy
3/20/2022 20:00,414,411,2101353,443850,825,2545203,SUNDAY,1,0,16.1,50,22.3,1003.8,Cloudy
3/20/2022 21:00,308,407,1909958,361013,715,2270971,SUNDAY,1,0,16.1,44,22.3,1003.6,Cloudy
3/20/2022 22:00,255,335,1045639,305472,590,1351111,SUNDAY,1,0,14.4,46,25.9,1003.9,Cloudy
3/20/2022 23:00,96,233,131691,168211,329,299902,SUNDAY,1,0,12.2,50,22.3,1004.4,Cloudy
3/21/2022 0:00,53,183,108205,133087,236,241292,MONDAY,0,0,11.7,52,29.5,1004.9,Cloudy
3/21/2022 1:00,51,105,584557,67145,156,651702,MONDAY,0,0,11.1,52,29.5,1005.2,Cloudy
3/21/2022 2:00,41,85,204315,54752,126,259067,MONDAY,0,0,10,56,18.4,1005.9,Cloudy
3/21/2022 3:00,18,55,25376,36151,73,61527,MONDAY,0,0,8.9,61,24.1,1006.5,Cloudy
3/21/2022 4:00,13,19,10126,10580,32,20706,MONDAY,0,0,8.3,58,22.3,1007.1,Cloudy
3/21/2022 5:00,1,9,2070,3655,10,5725,MONDAY,0,0,7.8,58,29.5,1007.9,Cloudy
3/21/2022 6:00,1,8,934,5823,9,6757,MONDAY,0,0,7.2,60,31.7,1008.4,Cloudy
3/21/2022 7:00,4,5,3573,1700,9,5273,MONDAY,0,0,7.2,56,25.9,1009,Cloudy
3/21/2022 8:00,5,5,7060,2146,10,9206,MONDAY,0,0,6.7,58,29.5,1009.8,Cloudy
3/21/2022 9:00,4,33,2106,22401,37,24507,MONDAY,0,0,6.1,60,31.7,1011,Cloudy
3/21/2022 10:00,21,109,14237,75545,130,89782,MONDAY,0,0,6.1,57,24.1,1012.2,Fair
3/21/2022 11:00,24,267,19747,194607,291,214354,MONDAY,0,0,6.1,55,24.1,1013,Fair
3/21/2022 12:00,47,526,50012,402690,573,452702,MONDAY,0,0,6.7,53,14.8,1013.6,Fair
3/21/2022 13:00,48,346,60737,271453,394,332190,MONDAY,0,0,8.3,46,18.4,1013.8,Fair
3/21/2022 14:00,44,242,72937,190959,286,263896,MONDAY,0,0,10,39,20.5,1014,Fair
3/21/2022 15:00,75,221,142012,184169,296,326181,MONDAY,0,0,10.6,33,20.5,1013.4,Fair
3/21/2022 16:00,83,262,141598,185577,345,327175,MONDAY,0,0,12.2,30,35.3,1012.9,Fair
3/21/2022 17:00,77,291,280807,214759,368,495566,MONDAY,0,0,12.8,30,24.1,1012.3,Fair
3/21/2022 18:00,70,273,150528,211160,343,361688,MONDAY,0,0,13.3,26,37.1,1011.6,Fair
3/21/2022 19:00,94,307,174216,236893,401,411109,MONDAY,0,0,14.4,23,33.5,1010.8,Fair
3/21/2022 20:00,114,435,185885,326106,549,511991,MONDAY,0,0,13.9,25,37.1,1010.9,Fair
3/21/2022 21:00,176,675,396067,523520,851,919587,MONDAY,0,0,13.3,28,27.7,1010.9,Fair
3/21/2022 22:00,132,589,287611,457887,721,745498,MONDAY,0,0,12.8,24,37.1,1011.5,Fair
3/21/2022 23:00,59,340,80416,296221,399,376637,MONDAY,0,0,12.2,22,27.7,1012.2,Fair
3/22/2022 0:00,53,218,88500,145191,271,233691,TUESDAY,0,0,11.7,24,27.7,1013.2,Fair
3/22/2022 1:00,29,165,29888,114639,194,144527,TUESDAY,0,0,10,26,24.1,1014.2,Fair
3/22/2022 2:00,29,89,108662,62847,118,171509,TUESDAY,0,0,9.4,28,29.5,1014.7,Fair
3/22/2022 3:00,19,59,325784,33711,78,359495,TUESDAY,0,0,8.3,30,18.4,1014.6,Clear
3/22/2022 4:00,9,34,9960,22194,43,32154,TUESDAY,0,0,8.3,33,24.1,1014.7,Clear
3/22/2022 5:00,9,9,33064,3701,18,36765,TUESDAY,0,0,7.2,38,25.9,1015,Clear
3/22/2022 6:00,2,5,75098,2033,7,77131,TUESDAY,0,0,6.7,41,16.6,1015.4,Clear
3/22/2022 7:00,2,9,2682,7199,11,9881,TUESDAY,0,0,5.6,43,11.2,1015.1,Clear
3/22/2022 8:00,4,7,5341,5541,11,10882,TUESDAY,0,0,5,41,29.5,1015.1,Clear
3/22/2022 9:00,6,30,7236,19711,36,26947,TUESDAY,0,0,3.3,48,27.7,1016.2,Clear
3/22/2022 10:00,11,117,11155,87868,128,99023,TUESDAY,0,0,2.8,48,24.1,1016.7,Clear
3/22/2022 11:00,20,292,20280,198620,312,218900,TUESDAY,0,0,2.2,48,16.6,1017.1,Clear
3/22/2022 12:00,51,614,71426,487415,665,558841,TUESDAY,0,0,2.8,44,24.1,1017.6,Clear
3/22/2022 13:00,33,359,40380,239846,392,280226,TUESDAY,0,0,3.9,37,27.7,1017.3,Fair
3/22/2022 14:00,37,247,125170,164187,284,289357,TUESDAY,0,0,5.6,27,24.1,1017.3,Fair
3/22/2022 15:00,56,231,74503,166523,287,241026,TUESDAY,0,0,7.2,24,18.4,1016.9,Fair
3/22/2022 16:00,53,282,87901,206594,335,294495,TUESDAY,0,0,8.3,21,20.5,1016.6,Fair
3/22/2022 17:00,59,252,103879,173586,311,277465,TUESDAY,0,0,9.4,18,35.3,1016.1,Fair
3/22/2022 18:00,95,218,174070,181184,313,355254,TUESDAY,0,0,10,19,40.7,1015.9,Fair
3/22/2022 19:00,71,286,196423,210235,357,406658,TUESDAY,0,0,10,20,40.7,1015.9,Fair
3/22/2022 20:00,81,396,158918,321815,477,480733,TUESDAY,0,0,10.6,20,31.7,1016.3,Fair
3/22/2022 21:00,108,717,208581,583673,825,792254,TUESDAY,0,0,10.6,21,29.5,1016.6,Fair
3/22/2022 22:00,113,599,161181,449857,712,611038,TUESDAY,0,0,9.4,22,24.1,1017.4,Fair
3/22/2022 23:00,59,435,319999,307947,494,627946,TUESDAY,0,0,8.3,24,24.1,1018.2,Fair
3/23/2022 0:00,35,243,29909,338266,278,368175,WEDNESDAY,0,0,6.7,28,29.5,1019.3,Fair
3/23/2022 1:00,31,151,31374,95964,182,127338,WEDNESDAY,0,0,5,33,25.9,1021.1,Fair
3/23/2022 2:00,24,98,107307,340999,122,448306,WEDNESDAY,0,0,3.9,36,24.1,1021.8,Fair
3/23/2022 3:00,23,48,227257,30474,71,257731,WEDNESDAY,0,0,3.3,37,22.3,1023.4,Fair
3/23/2022 4:00,11,23,7359,12349,34,19708,WEDNESDAY,0,0,2.8,40,20.5,1023.5,Fair
3/23/2022 5:00,4,14,2651,7158,18,9809,WEDNESDAY,0,0,2.2,42,16.6,1023.8,Clear
3/23/2022 6:00,5,8,217284,5430,13,222714,WEDNESDAY,0,0,2.2,44,14.8,1023.4,Clear
3/23/2022 7:00,1,6,1419,3521,7,4940,WEDNESDAY,0,0,1.7,45,18.4,1022.8,Clear
3/23/2022 8:00,5,6,4863,4054,11,8917,WEDNESDAY,0,0,1.1,47,14.8,1022.9,Clear
3/23/2022 9:00,4,34,1773,25738,38,27511,WEDNESDAY,0,0,1.1,46,18.4,1023.6,Clear
3/23/2022 10:00,14,117,7028,101084,131,108112,WEDNESDAY,0,0,0.6,47,13,1024.1,Clear
3/23/2022 11:00,28,267,59352,208671,295,268023,WEDNESDAY,0,0,0.6,47,16.6,1024.2,Fair
3/23/2022 12:00,56,542,64082,386960,598,451042,WEDNESDAY,0,0,1.7,44,16.6,1024.2,Fair
3/23/2022 13:00,33,369,49210,276141,402,325351,WEDNESDAY,0,0,2.8,38,9.4,1024.8,Fair
3/23/2022 14:00,50,249,77345,231817,299,309162,WEDNESDAY,0,0,4.4,37,13,1025.2,Cloudy
3/23/2022 15:00,61,236,138108,195424,297,333532,WEDNESDAY,0,0,5.6,41,13,1025.3,Cloudy
3/23/2022 16:00,56,273,86738,214051,329,300789,WEDNESDAY,0,0,6,42,14.8,1025,Cloudy
3/23/2022 17:00,69,268,108248,370138,337,478386,WEDNESDAY,0,0,5.6,44,16.6,1024.9,Cloudy
3/23/2022 18:00,61,249,285907,341078,310,626985,WEDNESDAY,0,0,5.6,50,16.6,1024.8,Cloudy
3/23/2022 19:00,82,305,131064,254791,387,385855,WEDNESDAY,0,0,5.6,55,16.6,1024.4,Cloudy
3/23/2022 20:00,113,429,170914,319594,542,490508,WEDNESDAY,0,0,5,53,16.6,1024.7,Cloudy
3/23/2022 21:00,121,655,838170,553286,776,1391456,WEDNESDAY,0,0,5,55,16.6,1024.4,Cloudy
3/23/2022 22:00,104,557,1246257,479093,661,1725350,WEDNESDAY,0,0,5,57,20.5,1024.5,Cloudy
3/23/2022 23:00,51,319,62451,232501,370,294952,WEDNESDAY,0,0,5,60,20.5,1024.6,Cloudy
3/24/2022 0:00,44,207,141584,1132083,251,1273667,THURSDAY,0,0,5,57,13,1024.9,Cloudy
3/24/2022 1:00,40,144,989382,112564,184,1101946,THURSDAY,0,0,5,51,11.2,1025.9,Cloudy
3/24/2022 2:00,37,88,162693,62933,125,225626,THURSDAY,0,0,5,51,13,1025.7,Cloudy
3/24/2022 3:00,6,52,5446,43747,58,49193,THURSDAY,0,0,5,46,11.2,1025.4,Cloudy
3/24/2022 4:00,11,24,13292,14011,35,27303,THURSDAY,0,0,4.4,60,7.6,1025,Cloudy
3/24/2022 5:00,12,11,15675,48690,23,64365,THURSDAY,0,0,4.4,60,13,1024.8,Rain
3/24/2022 6:00,2,6,1605,3091,8,4696,THURSDAY,0,0,4.4,70,22.3,1024,Rain
3/24/2022 7:00,2,6,1792,2986,8,4778,THURSDAY,0,0,4.4,79,25.9,1023.9,Rain
3/24/2022 8:00,0,1,0,715,1,715,THURSDAY,0,0,3.9,82,31.7,1022.9,Rain
3/24/2022 9:00,2,9,1046,10178,11,11224,THURSDAY,0,0,3.9,86,31.7,1022.7,Rain
3/24/2022 10:00,6,33,14887,19911,39,34798,THURSDAY,0,0,3.9,86,37.1,1023.1,Rain
3/24/2022 11:00,7,110,706944,70585,117,777529,THURSDAY,0,0,3.9,89,37.1,1022.5,Rain
3/24/2022 12:00,10,169,12956,119802,179,132758,THURSDAY,0,0,3.9,89,33.5,1022.3,Rain
3/24/2022 13:00,9,123,4641,80915,132,85556,THURSDAY,0,0,4.4,89,33.5,1021.5,Rain
3/24/2022 14:00,11,99,15439,137261,110,152700,THURSDAY,0,0,4.4,93,29.5,1021.5,Rain
3/24/2022 15:00,6,105,3791,62657,111,66448,THURSDAY,0,0,5,89,29.5,1021.4,Rain
3/24/2022 16:00,8,109,12869,70159,117,83028,THURSDAY,0,0,5,96,29.5,1020.4,Rain
3/24/2022 17:00,10,97,8725,76797,107,85522,THURSDAY,0,0,5,96,25.9,1019.4,Rain
3/24/2022 18:00,9,104,19645,82713,113,102358,THURSDAY,0,0,5.6,92,24.1,1018.4,Rain
3/24/2022 19:00,11,118,72656,73268,129,145924,THURSDAY,0,0,5.6,96,22.3,1016.9,Rain
3/24/2022 20:00,18,173,77359,121321,191,198680,THURSDAY,0,0,6.1,97,24.1,1015.4,Rain
3/24/2022 21:00,28,297,39966,209405,325,249371,THURSDAY,0,0,6.1,97,27.7,1014.3,Rain
3/24/2022 22:00,34,279,39332,266260,313,305592,THURSDAY,0,0,6.1,97,22.3,1013.8,Rain
3/24/2022 23:00,30,214,46882,135483,244,182365,THURSDAY,0,0,6.1,97,27.7,1012.4,Rain
3/25/2022 0:00,12,123,12069,82124,135,94193,FRIDAY,0,0,6.1,97,29.5,1012.3,Rain
3/25/2022 1:00,25,141,36799,92145,166,128944,FRIDAY,0,0,6.1,100,24.1,1011,Rain
3/25/2022 2:00,29,77,29463,53851,106,83314,FRIDAY,0,0,6.1,97,16.6,1010.4,Rain
3/25/2022 3:00,25,68,26019,47987,93,74006,FRIDAY,0,0,5.6,96,24.1,1007.8,Rain
3/25/2022 4:00,9,25,14403,18586,34,32989,FRIDAY,0,0,5.6,96,20.5,1007,Rain
3/25/2022 5:00,5,5,8422,3783,10,12205,FRIDAY,0,0,5.6,92,16.6,1006.8,Rain
3/25/2022 6:00,2,4,1319,1842,6,3161,FRIDAY,0,0,5,93,24.1,1004.7,Rain
3/25/2022 7:00,7,3,64629,1527,10,66156,FRIDAY,0,0,4.4,93,18.4,1003.2,Rain
3/25/2022 8:00,0,5,0,2602,5,2602,FRIDAY,0,0,4.4,97,16.6,1003.9,Rain
3/25/2022 9:00,4,27,2266,17267,31,19533,FRIDAY,0,0,4.4,93,20.5,1002.5,Rain
3/25/2022 10:00,14,83,12898,62239,97,75137,FRIDAY,0,0,3.9,89,24.1,1002.8,Rain
3/25/2022 11:00,22,219,21533,167473,241,189006,FRIDAY,0,0,3.9,86,11.2,1003.9,Cloudy
3/25/2022 12:00,37,417,34404,310320,454,344724,FRIDAY,0,0,3.9,86,14.8,1003.3,Cloudy
3/25/2022 13:00,41,325,46267,216539,366,262806,FRIDAY,0,0,4.4,83,16.6,1002.9,Rain
3/25/2022 14:00,42,269,84609,203924,311,288533,FRIDAY,0,0,5.6,79,11.2,1002.6,Cloudy
3/25/2022 15:00,90,261,393036,197537,351,590573,FRIDAY,0,0,6.7,73,9.4,1001.5,Cloudy
3/25/2022 16:00,99,303,213698,219651,402,433349,FRIDAY,0,0,8.9,68,9.4,1000.3,Cloudy
3/25/2022 17:00,135,355,711440,269120,490,980560,FRIDAY,0,0,11.7,64,9.4,999.9,Cloudy
3/25/2022 18:00,176,343,1301599,337202,519,1638801,FRIDAY,0,0,12.8,57,5.4,998.5,Cloudy
3/25/2022 19:00,226,418,1226677,451588,644,1678265,FRIDAY,0,0,12.2,64,16.6,997.4,Cloudy
3/25/2022 20:00,213,515,429302,781263,728,1210565,FRIDAY,0,0,11.1,69,16.6,997.6,Cloudy
3/25/2022 21:00,326,695,1290403,599620,1021,1890023,FRIDAY,0,0,15,44,20.5,997.3,Cloudy
3/25/2022 22:00,287,573,567824,496747,860,1064571,FRIDAY,0,0,14.4,42,18.4,997.1,Cloudy
3/25/2022 23:00,191,422,954930,341315,613,1296245,FRIDAY,0,0,13.9,45,16.6,996.7,Cloudy
3/26/2022 0:00,140,221,613095,173392,361,786487,SATURDAY,1,0,12.8,52,16.6,997,Cloudy
3/26/2022 1:00,100,206,144036,146241,306,290277,SATURDAY,1,0,11.7,56,13,997.5,Cloudy
3/26/2022 2:00,83,156,123757,118953,239,242710,SATURDAY,1,0,12.2,55,18.4,998,Cloudy
3/26/2022 3:00,71,101,781170,73325,172,854495,SATURDAY,1,0,11.7,50,20.5,998.3,Cloudy
3/26/2022 4:00,104,97,1335435,78246,201,1413681,SATURDAY,1,0,11.1,52,16.6,998.6,Cloudy
3/26/2022 5:00,128,87,1616034,75473,215,1691507,SATURDAY,1,0,10.6,54,14.8,998.6,Cloudy
3/26/2022 6:00,39,44,94536,40404,83,134940,SATURDAY,1,0,10,56,18.4,998.4,Cloudy
3/26/2022 7:00,17,14,14455,13835,31,28290,SATURDAY,1,0,9.4,59,18.4,998,Cloudy
3/26/2022 8:00,4,10,2689,6207,14,8896,SATURDAY,1,0,8.9,61,18.4,997.8,Cloudy
3/26/2022 9:00,3,10,2357,7343,13,9700,SATURDAY,1,0,8.9,56,16.6,998.1,Cloudy
3/26/2022 10:00,16,46,44139,34615,62,78754,SATURDAY,1,0,7.8,63,13,998.2,Cloudy
3/26/2022 11:00,21,70,37491,42518,91,80009,SATURDAY,1,0,7.2,65,16.6,998.4,Cloudy
3/26/2022 12:00,51,132,83188,100344,183,183532,SATURDAY,1,0,8.3,58,14.8,998.7,Cloudy
3/26/2022 13:00,92,233,187153,229563,325,416716,SATURDAY,1,0,9.4,52,16.6,998.3,Cloudy
3/26/2022 14:00,156,343,450072,383340,499,833412,SATURDAY,1,0,10.6,46,11.2,998.1,Cloudy
3/26/2022 15:00,242,354,547294,356318,596,903612,SATURDAY,1,0,11.7,41,13,997.3,Cloudy
3/26/2022 16:00,317,409,1336286,393776,726,1730062,SATURDAY,1,0,11.7,41,9.4,996.4,Cloudy
3/26/2022 17:00,294,423,613425,385253,717,998678,SATURDAY,1,0,12.2,41,14.8,995.8,Cloudy
3/26/2022 18:00,259,396,456669,357544,655,814213,SATURDAY,1,0,9.4,66,22.3,995.1,Cloudy
3/26/2022 19:00,268,329,1215667,277972,597,1493639,SATURDAY,1,0,9.4,71,16.6,994.2,Cloudy
3/26/2022 20:00,122,239,788828,191291,361,980119,SATURDAY,1,0,10,66,14.8,993.8,Cloudy
3/26/2022 21:00,43,166,52579,114826,209,167405,SATURDAY,1,0,9.4,69,7.6,994,Cloudy
3/26/2022 22:00,40,168,45694,151212,208,196906,SATURDAY,1,0,7.8,76,16.6,994.5,Cloudy
3/26/2022 23:00,31,107,41291,78149,138,119440,SATURDAY,1,0,7.2,76,18.4,995.2,Cloudy
3/27/2022 0:00,36,93,52313,68328,129,120641,SUNDAY,1,0,7.8,73,11.2,995.3,Cloudy
3/27/2022 1:00,47,103,124347,72443,150,196790,SUNDAY,1,0,7.8,65,11.2,995.4,Cloudy
3/27/2022 2:00,79,111,645846,75997,190,721843,SUNDAY,1,0,7.2,71,18.4,995.7,Cloudy
3/27/2022 3:00,85,90,1752617,63481,175,1816098,SUNDAY,1,0,6.7,76,18.4,996,Cloudy
3/27/2022 4:00,69,67,112616,57901,136,170517,SUNDAY,1,0,6.1,79,18.4,996,Cloudy
3/27/2022 5:00,92,59,286127,49945,151,336072,SUNDAY,1,0,6.1,79,16.6,995.4,Cloudy
3/27/2022 6:00,55,49,548077,45140,104,593217,SUNDAY,1,0,5.6,79,20.5,995.5,Cloudy
3/27/2022 7:00,18,17,26246,11811,35,38057,SUNDAY,1,0,5.6,79,16.6,995.4,Cloudy
3/27/2022 8:00,5,8,4486,5743,13,10229,SUNDAY,1,0,5,79,20.5,995.7,Cloudy
3/27/2022 9:00,4,17,5506,9728,21,15234,SUNDAY,1,0,5,73,18.4,996.2,Cloudy
3/27/2022 10:00,6,29,10996,18664,35,29660,SUNDAY,1,0,5,67,20.5,996.8,Fair
3/27/2022 11:00,14,50,15107,32463,64,47570,SUNDAY,1,0,4.4,70,25.9,997.7,Fair
3/27/2022 12:00,36,128,186891,86851,164,273742,SUNDAY,1,0,5.6,62,27.7,998.3,Fair
3/27/2022 13:00,93,195,169919,147181,288,317100,SUNDAY,1,0,6.1,55,35.3,998.5,Fair
3/27/2022 14:00,135,285,308647,244137,420,552784,SUNDAY,1,0,7.2,51,24.1,998.7,Fair
3/27/2022 15:00,201,320,507376,262867,521,770243,SUNDAY,1,0,8.3,48,25.9,998.6,Fair
3/27/2022 16:00,201,366,913263,304073,567,1217336,SUNDAY,1,0,8.9,44,24.1,998.5,Cloudy
3/27/2022 17:00,219,375,1280694,362669,594,1643363,SUNDAY,1,0,8.3,46,16.6,998.4,Cloudy
3/27/2022 18:00,241,352,1586654,319995,593,1906649,SUNDAY,1,0,9.4,41,22.3,997.8,Cloudy
3/27/2022 19:00,223,343,1119050,308904,566,1427954,SUNDAY,1,0,9.4,38,25.9,997.7,Cloudy
3/27/2022 20:00,200,421,369319,361843,621,731162,SUNDAY,1,0,9.4,38,22.3,997.7,Cloudy
3/27/2022 21:00,172,373,767021,300122,545,1067143,SUNDAY,1,0,7.8,38,35.3,998.2,Cloudy
3/27/2022 22:00,112,338,227002,249770,450,476772,SUNDAY,1,0,7.2,40,24.1,999.2,Cloudy
3/27/2022 23:00,84,222,146247,154207,306,300454,SUNDAY,1,0,6.1,41,25.9,999.9,Cloudy
3/28/2022 0:00,64,183,80625,126009,247,206634,MONDAY,0,0,5.6,41,27.7,1000.7,Cloudy
3/28/2022 1:00,46,117,48481,155848,163,204329,MONDAY,0,0,3.9,44,24.1,1001.9,Cloudy
3/28/2022 2:00,31,72,29057,46190,103,75247,MONDAY,0,0,2.8,50,33.5,1002.3,Cloudy
3/28/2022 3:00,30,48,178010,39504,78,217514,MONDAY,0,0,2.2,48,31.7,1002.7,Cloudy
3/28/2022 4:00,14,26,17187,15538,40,32725,MONDAY,0,0,1.1,47,27.7,1003.2,Cloudy
3/28/2022 5:00,4,14,4287,9160,18,13447,MONDAY,0,0,-0.6,51,33.5,1003.7,Cloudy
3/28/2022 6:00,6,9,13313,7056,15,20369,MONDAY,0,0,-1.1,51,29.5,1004,Cloudy
3/28/2022 7:00,2,6,2248,3142,8,5390,MONDAY,0,0,-1.7,49,33.5,1003.9,Cloudy
3/28/2022 8:00,2,7,3204,4469,9,7673,MONDAY,0,0,-2.2,51,25.9,1004.3,Cloudy
3/28/2022 9:00,2,25,6383,16956,27,23339,MONDAY,0,0,-2.2,51,24.1,1004.8,Cloudy
3/28/2022 10:00,10,106,6117,61594,116,67711,MONDAY,0,0,-2.8,55,18.4,1005.2,Cloudy
3/28/2022 11:00,10,191,204737,125052,201,329789,MONDAY,0,0,-3.9,81,20.5,1006.3,Cloudy
3/28/2022 12:00,32,403,26594,281314,435,307908,MONDAY,0,0,-3.9,68,25.9,1006.8,Cloudy
3/28/2022 13:00,27,284,29804,171162,311,200966,MONDAY,0,0,-3.3,50,33.5,1006.8,Cloudy
3/28/2022 14:00,18,197,31208,146998,215,178206,MONDAY,0,0,-3.3,44,29.5,1007,Cloudy
3/28/2022 15:00,45,196,85294,152699,241,237993,MONDAY,0,0,-2.2,37,27.7,1007,Cloudy
3/28/2022 16:00,40,258,186835,290427,298,477262,MONDAY,0,0,-1.7,34,25.9,1006.6,Cloudy
3/28/2022 17:00,29,197,124879,130714,226,255593,MONDAY,0,0,-0.6,31,27.7,1006.2,Cloudy
3/28/2022 18:00,37,204,49566,127650,241,177216,MONDAY,0,0,-0.6,30,27.7,1005.9,Cloudy
3/28/2022 19:00,49,214,87551,132827,263,220378,MONDAY,0,0,0,30,22.3,1005.9,Cloudy
3/28/2022 20:00,32,346,37920,258400,378,296320,MONDAY,0,0,0,29,31.7,1006.2,Cloudy
3/28/2022 21:00,51,446,57164,313783,497,370947,MONDAY,0,0,-1.1,28,27.7,1006.5,Cloudy
3/28/2022 22:00,44,368,33598,320459,412,354057,MONDAY,0,0,-1.7,32,22.3,1007.8,Cloudy
3/28/2022 23:00,34,268,190152,192535,302,382687,MONDAY,0,0,-1.7,32,25.9,1008.9,Cloudy
3/29/2022 0:00,12,153,14614,104438,165,119052,TUESDAY,0,0,-2.8,39,27.7,1010.1,Cloudy
3/29/2022 1:00,27,117,19012,62018,144,81030,TUESDAY,0,0,-3.3,33,31.7,1011.3,Cloudy
3/29/2022 2:00,11,57,11081,30677,68,41758,TUESDAY,0,0,-3.9,35,27.7,1011.7,Cloudy
3/29/2022 3:00,3,33,38011,15934,36,53945,TUESDAY,0,0,-4.4,41,24.1,1012,Cloudy
3/29/2022 4:00,7,9,4704,4196,16,8900,TUESDAY,0,0,-5.6,48,33.5,1012.7,Cloudy
3/29/2022 5:00,5,2,3126,636,7,3762,TUESDAY,0,0,-6.1,43,27.7,1013.3,Cloudy
3/29/2022 6:00,1,3,2175,1558,4,3733,TUESDAY,0,0,-6.7,45,33.5,1013.6,Fair
3/29/2022 7:00,2,5,1681,3201,7,4882,TUESDAY,0,0,-7.2,47,25.9,1013.7,Fair
3/29/2022 8:00,0,4,0,1856,4,1856,TUESDAY,0,0,-7.2,47,27.7,1014.1,Fair
3/29/2022 9:00,2,29,835,19874,31,20709,TUESDAY,0,0,-7.2,49,25.9,1014.5,Fair
3/29/2022 10:00,17,79,9704,52836,96,62540,TUESDAY,0,0,-6.7,49,24.1,1015,Fair
3/29/2022 11:00,19,238,22492,371430,257,393922,TUESDAY,0,0,-6.7,52,31.7,1015.5,Fair
3/29/2022 12:00,38,528,35091,355875,566,390966,TUESDAY,0,0,-5,45,27.7,1015.9,Fair
3/29/2022 13:00,25,324,32711,195561,349,228272,TUESDAY,0,0,-4.4,43,31.7,1015.9,Fair
3/29/2022 14:00,20,208,30884,129197,228,160081,TUESDAY,0,0,-2.2,39,31.7,1016,Fair
3/29/2022 15:00,25,196,45561,121319,221,166880,TUESDAY,0,0,-1.1,37,27.7,1015.8,Fair
3/29/2022 16:00,23,226,36892,158436,249,195328,TUESDAY,0,0,0.6,35,29.5,1015.2,Fair
3/29/2022 17:00,35,209,32581,154146,244,186727,TUESDAY,0,0,1.7,32,24.1,1014.7,Fair
3/29/2022 18:00,54,219,72334,142990,273,215324,TUESDAY,0,0,2.8,30,33.5,1014.2,Fair
3/29/2022 19:00,49,279,74339,187114,328,261453,TUESDAY,0,0,2.2,31,33.5,1014.2,Fair
3/29/2022 20:00,55,409,69053,381793,464,450846,TUESDAY,0,0,2.8,30,29.5,1014.2,Fair
3/29/2022 21:00,67,522,69849,399043,589,468892,TUESDAY,0,0,2.8,30,31.7,1014.2,Fair
3/29/2022 22:00,55,508,161588,488043,563,649631,TUESDAY,0,0,2.8,28,35.3,1014.4,Fair
3/29/2022 23:00,48,327,138255,217858,375,356113,TUESDAY,0,0,2.2,31,35.3,1015.1,Fair
3/30/2022 0:00,21,202,23396,121459,223,144855,WEDNESDAY,0,0,1.7,32,29.5,1016.1,Fair
3/30/2022 1:00,31,168,93193,126650,199,219843,WEDNESDAY,0,0,1.1,32,22.3,1017.1,Fair
3/30/2022 2:00,20,93,68736,53813,113,122549,WEDNESDAY,0,0,1.1,32,18.4,1017.5,Clear
3/30/2022 3:00,8,58,5853,33725,66,39578,WEDNESDAY,0,0,0,34,24.1,1018,Clear
3/30/2022 4:00,4,16,31699,13573,20,45272,WEDNESDAY,0,0,0,36,22.3,1018.7,Fair
3/30/2022 5:00,2,14,1246,8408,16,9654,WEDNESDAY,0,0,-0.6,38,20.5,1018.8,Clear
3/30/2022 6:00,4,3,11225,1209,7,12434,WEDNESDAY,0,0,-0.6,38,27.7,1018.8,Clear
3/30/2022 7:00,4,3,10621,1992,7,12613,WEDNESDAY,0,0,-1.1,37,27.7,1019,Clear
3/30/2022 8:00,1,7,1510,6472,8,7982,WEDNESDAY,0,0,-1.1,36,18.4,1019.1,Clear
3/30/2022 9:00,1,30,116,24501,31,24617,WEDNESDAY,0,0,-1.1,37,20.5,1019.1,Clear
3/30/2022 10:00,12,125,14056,73681,137,87737,WEDNESDAY,0,0,-1.1,37,27.7,1019.7,Clear
3/30/2022 11:00,30,263,35256,207985,293,243241,WEDNESDAY,0,0,-1.1,37,25.9,1020.5,Fair
3/30/2022 12:00,35,547,35160,381830,582,416990,WEDNESDAY,0,0,-0.6,36,24.1,1021.5,Fair
3/30/2022 13:00,33,387,42045,338416,420,380461,WEDNESDAY,0,0,0.6,33,31.7,1021.4,Fair
3/30/2022 14:00,47,241,60000,188899,288,248899,WEDNESDAY,0,0,1.7,30,22.3,1021.6,Fair
3/30/2022 15:00,32,244,51632,170882,276,222514,WEDNESDAY,0,0,3.3,29,24.1,1020.9,Fair
3/30/2022 16:00,41,303,524052,199617,344,723669,WEDNESDAY,0,0,5,26,27.7,1020.4,Fair
3/30/2022 17:00,51,283,101689,197966,334,299655,WEDNESDAY,0,0,7.2,24,24.1,1020,Cloudy
3/30/2022 18:00,46,281,53675,203528,327,257203,WEDNESDAY,0,0,7.8,23,14.8,1019.2,Cloudy
3/30/2022 19:00,84,366,174254,262249,450,436503,WEDNESDAY,0,0,8.9,21,13,1018.4,Cloudy
3/30/2022 20:00,76,504,94509,401416,580,495925,WEDNESDAY,0,0,9.4,20,18.4,1017.6,Cloudy
3/30/2022 21:00,116,716,241814,658468,832,900282,WEDNESDAY,0,0,8.9,21,13,1016.7,Cloudy
3/30/2022 22:00,118,586,123042,419083,704,542125,WEDNESDAY,0,0,8.9,22,16.6,1017.4,Cloudy
3/30/2022 23:00,71,400,140877,278913,471,419790,WEDNESDAY,0,0,8.3,23,11.2,1017.4,Cloudy
3/31/2022 0:00,40,258,50786,174117,298,224903,THURSDAY,0,0,7.8,24,18.4,1017.3,Cloudy
3/31/2022 1:00,35,185,61758,127222,220,188980,THURSDAY,0,0,7.2,26,14.8,1017.2,Cloudy
3/31/2022 2:00,49,157,135473,122691,206,258164,THURSDAY,0,0,6.7,33,16.6,1016.9,Cloudy
3/31/2022 3:00,14,74,17960,41811,88,59771,THURSDAY,0,0,6.7,35,24.1,1016.7,Cloudy
3/31/2022 4:00,6,39,6138,28474,45,34612,THURSDAY,0,0,6.1,33,22.3,1015.9,Cloudy
3/31/2022 5:00,14,24,125827,18738,38,144565,THURSDAY,0,0,5.6,33,18.4,1016.3,Cloudy
3/31/2022 6:00,3,9,3880,7868,12,11748,THURSDAY,0,0,4.4,46,20.5,1014.6,Cloudy
3/31/2022 7:00,3,6,3216,7515,9,10731,THURSDAY,0,0,5,43,11.2,1014.3,Cloudy
3/31/2022 8:00,5,5,133014,1770,10,134784,THURSDAY,0,0,5,46,11.2,1013.8,Cloudy
3/31/2022 9:00,3,36,6886,26710,39,33596,THURSDAY,0,0,5,55,11.2,1013.2,Cloudy
3/31/2022 10:00,3,110,1434,75930,113,77364,THURSDAY,0,0,5,62,16.6,1011.8,Cloudy
3/31/2022 11:00,39,303,69019,227868,342,296887,THURSDAY,0,0,5.6,67,7.6,1011.4,Cloudy
3/31/2022 12:00,57,665,52631,470386,722,523017,THURSDAY,0,0,6.1,76,11.2,1010.4,Cloudy
3/31/2022 13:00,47,457,47435,354347,504,401782,THURSDAY,0,0,6.7,89,9.4,1009.6,Cloudy
3/31/2022 14:00,53,290,101667,230901,343,332568,THURSDAY,0,0,8.9,86,9.4,1008.9,Cloudy
3/31/2022 15:00,61,262,92283,187021,323,279304,THURSDAY,0,0,12.8,83,22.3,1008.1,Cloudy
3/31/2022 16:00,65,363,143351,339468,428,482819,THURSDAY,0,0,15.6,78,29.5,1007.2,Cloudy
3/31/2022 17:00,87,289,209515,185792,376,395307,THURSDAY,0,0,17.2,72,40.7,1006.4,Cloudy
3/31/2022 18:00,72,331,129019,243171,403,372190,THURSDAY,0,0,17.8,73,38.9,1005.4,Cloudy
3/31/2022 19:00,110,374,170601,261194,484,431795,THURSDAY,0,0,18.3,73,22.3,1004.6,Cloudy
3/31/2022 20:00,132,579,217631,413247,711,630878,THURSDAY,0,0,17.2,75,27.7,1004.3,Cloudy
3/31/2022 21:00,163,694,238341,563129,857,801470,THURSDAY,0,0,17.2,75,38.9,1003.5,Cloudy
3/31/2022 22:00,163,614,257069,426807,777,683876,THURSDAY,0,0,17.8,73,33.5,1002.8,Rain
3/31/2022 23:00,113,463,136413,323944,576,460357,THURSDAY,0,0,18.3,73,48.2,1002,Rain
4/1/2022 0:00,74,300,244035,206849,374,450884,FRIDAY,0,0,18.3,73,51.8,1001.4,Rain
4/1/2022 1:00,77,207,114445,140713,284,255158,FRIDAY,0,0,17.2,81,38.9,1001,Rain
4/1/2022 2:00,68,127,112032,323206,195,435238,FRIDAY,0,0,16.7,80,35.3,1000.1,Rain
4/1/2022 3:00,43,82,122882,52189,125,175071,FRIDAY,0,0,16.1,87,37.1,999,Rain
4/1/2022 4:00,19,41,31584,30046,60,61630,FRIDAY,0,0,15,90,35.3,997.8,Rain
4/1/2022 5:00,19,22,15226,17453,41,32679,FRIDAY,0,0,15.6,86,22.3,998.3,Rain
4/1/2022 6:00,3,17,6265,11971,20,18236,FRIDAY,0,0,14.4,93,16.6,997.8,Rain
4/1/2022 7:00,9,8,13857,10857,17,24714,FRIDAY,0,0,14.4,93,14.8,997.5,Rain
4/1/2022 8:00,2,4,1854,1744,6,3598,FRIDAY,0,0,13.3,93,7.6,996.9,Cloudy
4/1/2022 9:00,7,38,3257,22595,45,25852,FRIDAY,0,0,12.8,96,9.4,996.2,Cloudy
4/1/2022 10:00,11,58,9627,34861,69,44488,FRIDAY,0,0,12.8,96,0,996.1,Cloudy
4/1/2022 11:00,25,237,37633,164408,262,202041,FRIDAY,0,0,14.4,97,7.6,995.9,Cloudy
4/1/2022 12:00,31,275,39910,185534,306,225444,FRIDAY,0,0,15,93,11.2,995.8,Cloudy
4/1/2022 13:00,21,201,25999,117921,222,143920,FRIDAY,0,0,12.2,83,40.7,998,Rain
4/1/2022 14:00,37,242,43900,163411,279,207311,FRIDAY,0,0,12.2,83,24.1,997.5,Cloudy
4/1/2022 15:00,70,284,333670,283308,354,616978,FRIDAY,0,0,12.8,80,13,997.8,Cloudy
4/1/2022 16:00,103,351,167062,235339,454,402401,FRIDAY,0,0,13.3,72,13,996.7,Cloudy
4/1/2022 17:00,121,355,1028282,256455,476,1284737,FRIDAY,0,0,12.8,66,24.1,997.2,Cloudy
4/1/2022 18:00,144,371,249144,259809,515,508953,FRIDAY,0,0,13.9,57,22.3,996.3,Cloudy
4/1/2022 19:00,148,354,259549,383651,502,643200,FRIDAY,0,0,13.3,51,27.7,996.8,Cloudy
4/1/2022 20:00,161,498,263864,369221,659,633085,FRIDAY,0,0,12.8,47,31.7,996.8,Cloudy
4/1/2022 21:00,188,637,424328,515485,825,939813,FRIDAY,0,0,12.2,50,27.7,997.6,Cloudy
4/1/2022 22:00,196,603,2577790,561264,799,3139054,FRIDAY,0,0,10.6,56,25.9,998.6,Cloudy
4/1/2022 23:00,140,386,170156,280457,526,450613,FRIDAY,0,0,10.6,48,35.3,999.8,Cloudy
4/2/2022 0:00,61,237,1170780,167427,298,1338207,SATURDAY,1,0,9.4,41,29.5,1001.4,Cloudy
4/2/2022 1:00,59,201,84347,111849,260,196196,SATURDAY,1,0,7.8,43,35.3,1003.1,Cloudy
4/2/2022 2:00,63,142,136831,102321,205,239152,SATURDAY,1,0,6.7,47,31.7,1004.1,Cloudy
4/2/2022 3:00,51,99,107846,61446,150,169292,SATURDAY,1,0,6.1,49,38.9,1005,Fair
4/2/2022 4:00,80,82,433598,54523,162,488121,SATURDAY,1,0,5,53,37.1,1006.4,Fair
4/2/2022 5:00,70,89,426332,74455,159,500787,SATURDAY,1,0,4.4,55,31.7,1007.2,Fair
4/2/2022 6:00,43,53,310199,79303,96,389502,SATURDAY,1,0,4.4,53,33.5,1007.8,Fair
4/2/2022 7:00,7,18,2442717,12004,25,2454721,SATURDAY,1,0,4.4,53,31.7,1008.2,Fair
4/2/2022 8:00,2,8,1253,3875,10,5128,SATURDAY,1,0,4.4,48,29.5,1009,Fair
4/2/2022 9:00,3,9,4550,4311,12,8861,SATURDAY,1,0,4.4,46,27.7,1009.6,Fair
4/2/2022 10:00,9,32,22676,20743,41,43419,SATURDAY,1,0,4.4,44,35.3,1010.4,Fair
4/2/2022 11:00,19,56,38733,44548,75,83281,SATURDAY,1,0,3.9,44,35.3,1011.8,Fair
4/2/2022 12:00,38,122,41148,95641,160,136789,SATURDAY,1,0,3.9,46,27.7,1013.3,Fair
4/2/2022 13:00,68,213,124631,163365,281,287996,SATURDAY,1,0,4.4,43,22.3,1013.8,Fair
4/2/2022 14:00,110,311,276558,256797,421,533355,SATURDAY,1,0,5.6,39,37.1,1014,Fair
4/2/2022 15:00,185,346,537045,284227,531,821272,SATURDAY,1,0,6.7,35,29.5,1014.3,Fair
4/2/2022 16:00,247,376,500297,343134,623,843431,SATURDAY,1,0,8.3,31,33.5,1014.1,Fair
4/2/2022 17:00,283,426,713279,404767,709,1118046,SATURDAY,1,0,9.4,26,33.5,1013.8,Fair
4/2/2022 18:00,300,402,683823,346124,702,1029947,SATURDAY,1,0,10.6,24,25.9,1013.3,Fair
4/2/2022 19:00,374,451,885953,421375,825,1307328,SATURDAY,1,0,11.7,22,27.7,1012.8,Fair
4/2/2022 20:00,339,494,1257001,467105,833,1724106,SATURDAY,1,0,11.7,20,27.7,1012.6,Fair
4/2/2022 21:00,337,489,1591223,882448,826,2473671,SATURDAY,1,0,11.7,18,22.3,1012.4,Fair
4/2/2022 22:00,342,503,1029801,423953,845,1453754,SATURDAY,1,0,11.7,18,18.4,1012.4,Fair
4/2/2022 23:00,167,355,844111,420776,522,1264887,SATURDAY,1,0,10.6,23,16.6,1012.7,Fair
4/3/2022 0:00,99,227,225481,172519,326,398000,SUNDAY,1,0,10,25,11.2,1013.5,Fair
4/3/2022 1:00,103,191,383289,153581,294,536870,SUNDAY,1,0,10,23,7.6,1014.5,Fair
4/3/2022 2:00,103,158,1155481,106289,261,1261770,SUNDAY,1,0,8.9,26,5.4,1014.7,Fair
4/3/2022 3:00,106,145,1630859,122328,251,1753187,SUNDAY,1,0,8.3,30,5.4,1015,Fair
4/3/2022 4:00,99,110,145251,92196,209,237447,SUNDAY,1,0,5.6,46,9.4,1014.7,Fair
4/3/2022 5:00,184,106,1553866,233391,290,1787257,SUNDAY,1,0,5,57,9.4,1013.9,Fair
4/3/2022 6:00,55,53,124570,83947,108,208517,SUNDAY,1,0,5.6,57,5.4,1013.6,Fair
4/3/2022 7:00,8,19,32284,20164,27,52448,SUNDAY,1,0,4.4,48,0,1013.2,Fair
4/3/2022 8:00,9,11,8947,26600,20,35547,SUNDAY,1,0,4.4,46,0,1013.3,Cloudy
4/3/2022 9:00,2,10,4068,9660,12,13728,SUNDAY,1,0,3.9,48,7.6,1013.6,Cloudy
4/3/2022 10:00,10,26,15656,21835,36,37491,SUNDAY,1,0,3.3,50,5.4,1013.3,Cloudy
4/3/2022 11:00,17,42,18342,38532,59,56874,SUNDAY,1,0,2.2,62,7.6,1012.9,Cloudy
4/3/2022 12:00,27,97,58091,76177,124,134268,SUNDAY,1,0,4.4,62,7.6,1012.8,Cloudy
4/3/2022 13:00,84,174,177340,135343,258,312683,SUNDAY,1,0,5.6,73,14.8,1011.9,Cloudy
4/3/2022 14:00,110,250,217153,224665,360,441818,SUNDAY,1,0,6.7,73,18.4,1011.6,Cloudy
4/3/2022 15:00,126,306,436735,249835,432,686570,SUNDAY,1,0,7.2,71,20.5,1011,Cloudy
4/3/2022 16:00,181,411,322321,333890,592,656211,SUNDAY,1,0,8.3,71,20.5,1010.4,Cloudy
4/3/2022 17:00,212,383,3001579,965922,595,3967501,SUNDAY,1,0,7.8,73,22.3,1009.9,Cloudy
4/3/2022 18:00,226,423,1486382,361945,649,1848327,SUNDAY,1,0,8.3,71,24.1,1009.2,Cloudy
4/3/2022 19:00,200,365,444053,289608,565,733661,SUNDAY,1,0,7.8,73,24.1,1008.7,Cloudy
4/3/2022 20:00,151,331,298347,263767,482,562114,SUNDAY,1,0,7.2,76,24.1,1007.9,Rain
4/3/2022 21:00,116,328,1860661,267483,444,2128144,SUNDAY,1,0,6.7,79,24.1,1007.3,Rain
4/3/2022 22:00,133,301,649268,203636,434,852904,SUNDAY,1,0,6.7,79,18.4,1007,Cloudy
4/3/2022 23:00,54,233,105258,151426,287,256684,SUNDAY,1,0,6.1,82,14.8,1007.4,Cloudy
4/4/2022 0:00,42,183,67090,125106,225,192196,MONDAY,0,0,6.1,86,13,1007.4,Rain
4/4/2022 1:00,35,113,360081,71053,148,431134,MONDAY,0,0,6.1,82,14.8,1007.6,Rain
4/4/2022 2:00,37,102,113822,65397,139,179219,MONDAY,0,0,5.6,76,14.8,1007.5,Cloudy
4/4/2022 3:00,17,55,54301,38165,72,92466,MONDAY,0,0,5.6,70,14.8,1007.4,Cloudy
4/4/2022 4:00,13,24,16913,13097,37,30010,MONDAY,0,0,5.6,64,14.8,1007.4,Cloudy
4/4/2022 5:00,5,21,6622,12197,26,18819,MONDAY,0,0,5,70,24.1,1007.5,Cloudy
4/4/2022 6:00,1,9,288,36632,10,36920,MONDAY,0,0,3.9,86,20.5,1008,Cloudy
4/4/2022 7:00,1,6,1725,4577,7,6302,MONDAY,0,0,3.9,86,16.6,1008.1,Cloudy
4/4/2022 8:00,2,9,1616,9517,11,11133,MONDAY,0,0,3.9,86,14.8,1008.2,Cloudy
4/4/2022 9:00,4,31,30456,18291,35,48747,MONDAY,0,0,3.9,86,20.5,1008.5,Cloudy
4/4/2022 10:00,4,118,2614,75188,122,77802,MONDAY,0,0,3.9,82,22.3,1009.2,Cloudy
4/4/2022 11:00,21,266,15245,176752,287,191997,MONDAY,0,0,3.3,83,24.1,1010,Cloudy
4/4/2022 12:00,39,583,42609,395393,622,438002,MONDAY,0,0,3.9,76,20.5,1010.6,Cloudy
4/4/2022 13:00,26,388,77885,911649,414,989534,MONDAY,0,0,5,67,20.5,1010.6,Cloudy
4/4/2022 14:00,36,280,45072,176799,316,221871,MONDAY,0,0,7.2,51,29.5,1010.7,Cloudy
4/4/2022 15:00,64,254,114008,169545,318,283553,MONDAY,0,0,7.8,43,14.8,1010.7,Fair
4/4/2022 16:00,53,306,96707,1870969,359,1967676,MONDAY,0,0,10,41,18.4,1010.8,Fair
4/4/2022 17:00,82,279,114625,208035,361,322660,MONDAY,0,0,11.1,34,27.7,1011,Fair
4/4/2022 18:00,99,331,218936,224208,430,443144,MONDAY,0,0,12.2,28,27.7,1010.6,Fair
4/4/2022 19:00,98,398,1620777,321926,496,1942703,MONDAY,0,0,13.3,24,24.1,1009.9,Fair
4/4/2022 20:00,128,547,255097,404014,675,659111,MONDAY,0,0,13.9,25,24.1,1009.9,Fair
4/4/2022 21:00,186,778,908256,1305547,964,2213803,MONDAY,0,0,13.9,22,24.1,1009.8,Fair
4/4/2022 22:00,146,687,287881,537137,833,825018,MONDAY,0,0,13.3,23,20.5,1010.4,Fair
4/4/2022 23:00,90,484,225451,331551,574,557002,MONDAY,0,0,12.2,24,22.3,1011.1,Cloudy
4/5/2022 0:00,55,313,71982,247737,368,319719,TUESDAY,0,0,11.1,28,16.6,1012.1,Cloudy
4/5/2022 1:00,38,183,61647,122296,221,183943,TUESDAY,0,0,10.6,28,20.5,1013.1,Cloudy
4/5/2022 2:00,28,119,33101,82345,147,115446,TUESDAY,0,0,10,30,13,1013.5,Cloudy
4/5/2022 3:00,24,73,60426,47780,97,108206,TUESDAY,0,0,9.4,30,13,1014.1,Cloudy
4/5/2022 4:00,12,41,105514,25826,53,131340,TUESDAY,0,0,8.9,33,16.6,1014.8,Cloudy
4/5/2022 5:00,19,16,37770,13432,35,51202,TUESDAY,0,0,8.9,31,11.2,1014.8,Cloudy
4/5/2022 6:00,9,6,8872,7069,15,15941,TUESDAY,0,0,7.8,35,11.2,1015.3,Cloudy
4/5/2022 7:00,0,6,0,5429,6,5429,TUESDAY,0,0,7.8,35,11.2,1015.6,Fair
4/5/2022 8:00,1,8,1515,7463,9,8978,TUESDAY,0,0,7.2,38,11.2,1016,Fair
4/5/2022 9:00,3,40,31803,32772,43,64575,TUESDAY,0,0,7.2,40,13,1016.3,Fair
4/5/2022 10:00,10,148,24458,97978,158,122436,TUESDAY,0,0,6.7,41,11.2,1016.7,Fair
4/5/2022 11:00,21,403,18196,296714,424,314910,TUESDAY,0,0,7.2,42,13,1017.3,Fair
4/5/2022 12:00,77,729,138665,512220,806,650885,TUESDAY,0,0,8.3,42,13,1017.8,Fair
4/5/2022 13:00,63,500,72073,323436,563,395509,TUESDAY,0,0,10,37,9.4,1018.1,Fair
4/5/2022 14:00,78,324,1065837,227516,402,1293353,TUESDAY,0,0,11.7,32,14.8,1018.5,Fair
4/5/2022 15:00,70,346,108181,261988,416,370169,TUESDAY,0,0,12.2,31,9.4,1017.9,Fair
4/5/2022 16:00,92,426,158822,294944,518,453766,TUESDAY,0,0,12.8,30,18.4,1017.1,Cloudy
4/5/2022 17:00,103,349,212705,244887,452,457592,TUESDAY,0,0,13.9,27,14.8,1016.7,Cloudy
4/5/2022 18:00,108,371,1643663,285450,479,1929113,TUESDAY,0,0,14.4,28,5.4,1016.4,Cloudy
4/5/2022 19:00,125,445,786229,322281,570,1108510,TUESDAY,0,0,12.8,40,18.4,1015.9,Cloudy
4/5/2022 20:00,181,648,371288,500086,829,871374,TUESDAY,0,0,10,52,29.5,1015.5,Cloudy
4/5/2022 21:00,208,918,983003,780030,1126,1763033,TUESDAY,0,0,11.7,47,25.9,1015.8,Cloudy
4/5/2022 22:00,215,823,660516,620253,1038,1280769,TUESDAY,0,0,9.4,66,16.6,1016,Cloudy
4/5/2022 23:00,121,599,1029035,420664,720,1449699,TUESDAY,0,0,11.7,48,16.6,1015.6,Cloudy
4/6/2022 0:00,75,328,67527,236489,403,304016,WEDNESDAY,0,0,10.6,52,14.8,1016,Cloudy
4/6/2022 1:00,63,238,1643309,163972,301,1807281,WEDNESDAY,0,0,10,50,22.3,1016.8,Cloudy
4/6/2022 2:00,43,175,247342,120237,218,367579,WEDNESDAY,0,0,8.9,54,18.4,1016.9,Cloudy
4/6/2022 3:00,38,74,73402,52132,112,125534,WEDNESDAY,0,0,8.3,54,13,1016.6,Rain
4/6/2022 4:00,20,39,347132,21085,59,368217,WEDNESDAY,0,0,7.2,60,11.2,1016.9,Cloudy
4/6/2022 5:00,9,9,79462,5320,18,84782,WEDNESDAY,0,0,7.2,58,9.4,1016.7,Cloudy
4/6/2022 6:00,8,9,7214,5396,17,12610,WEDNESDAY,0,0,6.7,70,9.4,1016.2,Cloudy
4/6/2022 7:00,2,4,1898,3782,6,5680,WEDNESDAY,0,0,6.1,76,7.6,1015.8,Cloudy
4/6/2022 8:00,0,10,0,7146,10,7146,WEDNESDAY,0,0,6.1,79,5.4,1014.9,Rain
4/6/2022 9:00,7,39,5105,26448,46,31553,WEDNESDAY,0,0,6.1,82,11.2,1015,Rain
4/6/2022 10:00,8,107,13988,63958,115,77946,WEDNESDAY,0,0,6.7,85,13,1015.3,Rain
4/6/2022 11:00,31,270,33634,192043,301,225677,WEDNESDAY,0,0,6.7,89,16.6,1015.2,Rain
4/6/2022 12:00,61,548,127185,361085,609,488270,WEDNESDAY,0,0,7.2,90,14.8,1014.9,Rain
4/6/2022 13:00,17,252,12578,154532,269,167110,WEDNESDAY,0,0,7.2,90,18.4,1014.8,Rain
4/6/2022 14:00,10,161,13299,93275,171,106574,WEDNESDAY,0,0,7.2,93,20.5,1014.9,Rain
4/6/2022 15:00,14,130,15381,81941,144,97322,WEDNESDAY,0,0,7.2,97,22.3,1014.8,Rain
4/6/2022 16:00,14,138,10501,628950,152,639451,WEDNESDAY,0,0,7.8,89,24.1,1014.7,Rain
4/6/2022 17:00,20,161,30915,98593,181,129508,WEDNESDAY,0,0,7.8,89,22.3,1014.1,Rain
4/6/2022 18:00,19,221,186956,146964,240,333920,WEDNESDAY,0,0,7.2,90,24.1,1013.7,Rain
4/6/2022 19:00,32,229,37312,157445,261,194757,WEDNESDAY,0,0,7.2,90,25.9,1013.5,Rain
4/6/2022 20:00,51,392,258239,287228,443,545467,WEDNESDAY,0,0,7.8,86,22.3,1014,Rain
4/6/2022 21:00,78,620,79223,463537,698,542760,WEDNESDAY,0,0,8.3,80,18.4,1013.8,Rain
4/6/2022 22:00,90,589,108821,386059,679,494880,WEDNESDAY,0,0,8.3,76,18.4,1013.7,Cloudy
4/6/2022 23:00,63,450,335382,305113,513,640495,WEDNESDAY,0,0,7.8,79,16.6,1013.2,Cloudy
4/7/2022 0:00,69,273,152172,165886,342,318058,THURSDAY,0,0,7.2,82,16.6,1013.6,Cloudy
4/7/2022 1:00,37,209,50381,179298,246,229679,THURSDAY,0,0,7.8,76,16.6,1014,Cloudy
4/7/2022 2:00,35,145,32443,96059,180,128502,THURSDAY,0,0,7.2,80,16.6,1014.9,Cloudy
4/7/2022 3:00,35,74,45045,63394,109,108439,THURSDAY,0,0,6.1,82,14.8,1014,Cloudy
4/7/2022 4:00,23,49,55379,30935,72,86314,THURSDAY,0,0,6.1,82,11.2,1014.5,Fair
4/7/2022 5:00,6,15,9692,8495,21,18187,THURSDAY,0,0,5,86,7.6,1014.5,Fair
4/7/2022 6:00,7,11,11923,5108,18,17031,THURSDAY,0,0,5.6,82,9.4,1014.4,Cloudy
4/7/2022 7:00,3,10,5228,60042,13,65270,THURSDAY,0,0,5,86,11.2,1014.9,Cloudy
4/7/2022 8:00,3,11,2162,6697,14,8859,THURSDAY,0,0,5,86,7.6,1015,Cloudy
4/7/2022 9:00,5,42,5157,31910,47,37067,THURSDAY,0,0,4.4,89,5.4,1015.1,Cloudy
4/7/2022 10:00,11,118,15246,80124,129,95370,THURSDAY,0,0,5.6,82,13,1014.8,Cloudy
4/7/2022 11:00,40,339,46721,236990,379,283711,THURSDAY,0,0,6.7,79,16.6,1014.9,Cloudy
4/7/2022 12:00,67,626,57629,600590,693,658219,THURSDAY,0,0,6.7,79,18.4,1015.2,Cloudy
4/7/2022 13:00,30,446,33630,310398,476,344028,THURSDAY,0,0,7.2,80,22.3,1015,Cloudy
4/7/2022 14:00,40,327,58648,215293,367,273941,THURSDAY,0,0,7.8,79,18.4,1015.9,Cloudy
4/7/2022 15:00,56,324,77702,196986,380,274688,THURSDAY,0,0,7.8,76,20.5,1015.5,Cloudy
4/7/2022 16:00,55,316,54429,206426,371,260855,THURSDAY,0,0,8.3,76,20.5,1015.1,Cloudy
4/7/2022 17:00,62,315,101875,295206,377,397081,THURSDAY,0,0,8.9,71,16.6,1015.1,Cloudy
4/7/2022 18:00,73,327,191998,208200,400,400198,THURSDAY,0,0,8.3,74,25.9,1014.9,Cloudy
4/7/2022 19:00,69,385,166738,252508,454,419246,THURSDAY,0,0,8.3,74,18.4,1015.2,Rain
4/7/2022 20:00,89,524,113848,662954,613,776802,THURSDAY,0,0,7.8,79,22.3,1013.8,Rain
4/7/2022 21:00,109,689,140089,617399,798,757488,THURSDAY,0,0,7.8,79,24.1,1013.6,Rain
4/7/2022 22:00,101,626,106949,510129,727,617078,THURSDAY,0,0,7.2,80,22.3,1013.7,Cloudy
4/7/2022 23:00,60,411,1792418,278289,471,2070707,THURSDAY,0,0,7.2,76,25.9,1013.6,Cloudy
4/8/2022 0:00,47,252,48882,158014,299,206896,FRIDAY,0,0,7.2,76,29.5,1012.9,Cloudy
4/8/2022 1:00,36,206,39669,133610,242,173279,FRIDAY,0,0,7.2,76,33.5,1012,Rain
4/8/2022 2:00,38,134,134333,86433,172,220766,FRIDAY,0,0,7.8,73,35.3,1011.8,Rain
4/8/2022 3:00,19,66,13890,38320,85,52210,FRIDAY,0,0,6.7,85,37.1,1010.9,Rain
4/8/2022 4:00,20,31,38334,17606,51,55940,FRIDAY,0,0,6.7,89,35.3,1009,Cloudy
4/8/2022 5:00,21,21,114041,10582,42,124623,FRIDAY,0,0,6.7,93,37.1,1007.1,Cloudy
4/8/2022 6:00,6,11,4173,6623,17,10796,FRIDAY,0,0,6.7,96,37.1,1006.4,Cloudy
4/8/2022 7:00,1,5,649,5853,6,6502,FRIDAY,0,0,7.2,93,37.1,1004,Cloudy
4/8/2022 8:00,4,4,2077,1474,8,3551,FRIDAY,0,0,8.3,90,42.5,1002,Rain
4/8/2022 9:00,0,25,0,13777,25,13777,FRIDAY,0,0,8.3,97,44.6,1000.4,Cloudy
4/8/2022 10:00,8,85,5348,51416,93,56764,FRIDAY,0,0,9.4,93,16.6,1000.7,Rain
4/8/2022 11:00,12,186,15668,123193,198,138861,FRIDAY,0,0,9.4,97,11.2,999.9,Cloudy
4/8/2022 12:00,33,377,61536,275679,410,337215,FRIDAY,0,0,10,96,11.2,998.7,Cloudy
4/8/2022 13:00,39,296,78472,204585,335,283057,FRIDAY,0,0,11.1,97,13,998.2,Cloudy
4/8/2022 14:00,46,260,99823,168984,306,268807,FRIDAY,0,0,12.8,96,14.8,999,Rain
4/8/2022 15:00,95,335,170755,233196,430,403951,FRIDAY,0,0,14.4,90,18.4,999.4,Cloudy
4/8/2022 16:00,84,373,351904,281443,457,633347,FRIDAY,0,0,16.7,70,20.5,999.5,Cloudy
4/8/2022 17:00,151,390,298297,262814,541,561111,FRIDAY,0,0,15,67,22.3,1000.3,Cloudy
4/8/2022 18:00,156,421,312983,317404,577,630387,FRIDAY,0,0,14.4,65,29.5,1001.1,Cloudy
4/8/2022 19:00,219,465,438873,368080,684,806953,FRIDAY,0,0,15.6,55,29.5,1001.3,Cloudy
4/8/2022 20:00,211,610,804214,471719,821,1275933,FRIDAY,0,0,16.1,50,25.9,1001.8,Cloudy
4/8/2022 21:00,332,819,770227,695324,1151,1465551,FRIDAY,0,0,16.7,44,24.1,1002.4,Cloudy
4/8/2022 22:00,367,729,936004,1872974,1096,2808978,FRIDAY,0,0,16.1,39,18.4,1002.7,Cloudy
4/8/2022 23:00,256,508,382146,464031,764,846177,FRIDAY,0,0,15.6,41,11.2,1003.1,Fair
4/9/2022 0:00,163,300,590152,220369,463,810521,SATURDAY,1,0,15,44,9.4,1004,Fair
4/9/2022 1:00,141,252,212642,177042,393,389684,SATURDAY,1,0,13.9,45,9.4,1005,Fair
4/9/2022 2:00,154,187,738658,140704,341,879362,SATURDAY,1,0,13.3,47,9.4,1005.6,Fair
4/9/2022 3:00,133,172,280786,123657,305,404443,SATURDAY,1,0,12.2,50,0,1006,Fair
4/9/2022 4:00,142,149,618367,108663,291,727030,SATURDAY,1,0,8.3,76,14.8,1006.4,Fair
4/9/2022 5:00,194,116,1972669,130944,310,2103613,SATURDAY,1,0,8.3,76,7.6,1005.7,Fair
4/9/2022 6:00,66,50,87201,35990,116,123191,SATURDAY,1,0,8.3,76,5.4,1004.7,Fair
4/9/2022 7:00,10,35,22585,30906,45,53491,SATURDAY,1,0,7.8,83,0,1005.3,Fair
4/9/2022 8:00,10,6,16142,4155,16,20297,SATURDAY,1,0,7.8,83,0,1005.1,Fair
4/9/2022 9:00,6,13,11142,8861,19,20003,SATURDAY,1,0,6.1,89,5.4,1005.2,Cloudy
4/9/2022 10:00,11,50,23156,29558,61,52714,SATURDAY,1,0,7.2,82,13,1004.5,Cloudy
4/9/2022 11:00,15,84,30488,47048,99,77536,SATURDAY,1,0,8.3,76,13,1004.6,Cloudy
4/9/2022 12:00,33,167,49039,144536,200,193575,SATURDAY,1,0,8.3,83,13,1004.7,Cloudy
4/9/2022 13:00,75,256,144227,180058,331,324285,SATURDAY,1,0,8.9,80,7.6,1004.5,Cloudy
4/9/2022 14:00,84,229,164105,162124,313,326229,SATURDAY,1,0,10.6,68,7.6,1004.2,Cloudy
4/9/2022 15:00,152,313,517691,295688,465,813379,SATURDAY,1,0,11.1,71,20.5,1003.8,Cloudy
4/9/2022 16:00,227,406,559200,319678,633,878878,SATURDAY,1,0,12.8,66,9.4,1002.5,Cloudy
4/9/2022 17:00,207,384,863955,333423,591,1197378,SATURDAY,1,0,13.3,60,31.7,1001.1,Cloudy
4/9/2022 18:00,280,388,1013570,468830,668,1482400,SATURDAY,1,0,15,55,29.5,999.8,Cloudy
4/9/2022 19:00,86,208,121055,168740,294,289795,SATURDAY,1,0,9.4,66,31.7,1000,Cloudy
4/9/2022 20:00,112,255,253422,203417,367,456839,SATURDAY,1,0,10.6,80,16.6,999.9,Cloudy
4/9/2022 21:00,173,355,359869,296823,528,656692,SATURDAY,1,0,10.6,68,25.9,1000.9,Cloudy
4/9/2022 22:00,235,411,1413378,343451,646,1756829,SATURDAY,1,0,12.2,57,18.4,1000.7,Cloudy
4/9/2022 23:00,182,353,2066107,284101,535,2350208,SATURDAY,1,0,10.6,63,14.8,1001.1,Cloudy
4/10/2022 0:00,120,279,280386,223406,399,503792,SUNDAY,1,0,10,66,22.3,1001.8,Fair
4/10/2022 1:00,96,161,216660,124170,257,340830,SUNDAY,1,0,9.4,69,24.1,1002.6,Fair
4/10/2022 2:00,112,181,177389,133715,293,311104,SUNDAY,1,0,8.9,71,16.6,1002.8,Fair
4/10/2022 3:00,104,136,600693,90918,240,691611,SUNDAY,1,0,7.8,76,14.8,1003,Fair
4/10/2022 4:00,86,111,297919,142339,197,440258,SUNDAY,1,0,7.8,71,14.8,1002.8,Fair
4/10/2022 5:00,172,103,1894410,86424,275,1980834,SUNDAY,1,0,7.2,71,14.8,1002.6,Fair
4/10/2022 6:00,65,52,144073,35989,117,180062,SUNDAY,1,0,6.1,73,14.8,1001.9,Fair
4/10/2022 7:00,16,23,45327,18152,39,63479,SUNDAY,1,0,6.1,70,16.6,1001.5,Fair
4/10/2022 8:00,11,9,34813,3992,20,38805,SUNDAY,1,0,5.6,73,16.6,1001.6,Fair
4/10/2022 9:00,4,16,2559,11981,20,14540,SUNDAY,1,0,5.6,73,16.6,1001.8,Fair
4/10/2022 10:00,6,33,4041,25207,39,29248,SUNDAY,1,0,5,76,13,1002.6,Fair
4/10/2022 11:00,13,73,32765,46827,86,79592,SUNDAY,1,0,5.6,73,16.6,1003.1,Fair
4/10/2022 12:00,53,141,189846,107152,194,296998,SUNDAY,1,0,6.1,70,25.9,1003.3,Cloudy
4/10/2022 13:00,81,190,720154,140382,271,860536,SUNDAY,1,0,7.2,63,24.1,1003.7,Cloudy
4/10/2022 14:00,141,306,280827,259513,447,540340,SUNDAY,1,0,9.4,56,25.9,1003.9,Cloudy
4/10/2022 15:00,191,364,385760,331910,555,717670,SUNDAY,1,0,11.1,48,27.7,1003.6,Cloudy
4/10/2022 16:00,274,455,947752,438454,729,1386206,SUNDAY,1,0,11.7,43,16.6,1003,Cloudy
4/10/2022 17:00,295,433,1393376,415771,728,1809147,SUNDAY,1,0,11.7,43,27.7,1002.5,Cloudy
4/10/2022 18:00,297,480,975535,498868,777,1474403,SUNDAY,1,0,12.8,40,22.3,1002.1,Cloudy
4/10/2022 19:00,326,491,1155825,460347,817,1616172,SUNDAY,1,0,12.8,35,24.1,1001.6,Cloudy
4/10/2022 20:00,251,458,805945,421500,709,1227445,SUNDAY,1,0,13.3,33,27.7,1001.8,Cloudy
4/10/2022 21:00,167,340,248832,288308,507,537140,SUNDAY,1,0,11.7,38,25.9,1002.6,Cloudy
4/10/2022 22:00,102,310,661867,211146,412,873013,SUNDAY,1,0,8.9,56,31.7,1004.3,Cloudy
4/10/2022 23:00,81,255,313249,171264,336,484513,SUNDAY,1,0,8.3,58,25.9,1005.1,Cloudy
4/11/2022 0:00,48,182,51332,149778,230,201110,MONDAY,0,0,8.9,54,16.6,1006.2,Cloudy
4/11/2022 1:00,30,129,31477,126489,159,157966,MONDAY,0,0,8.3,52,27.7,1007.6,Cloudy
4/11/2022 2:00,31,83,92446,46193,114,138639,MONDAY,0,0,7.8,53,16.6,1008.2,Fair
4/11/2022 3:00,25,56,70416,35662,81,106078,MONDAY,0,0,7.8,51,27.7,1009,Fair
4/11/2022 4:00,6,35,6344,19542,41,25886,MONDAY,0,0,7.2,53,25.9,1009.6,Fair
4/11/2022 5:00,6,19,4970,10542,25,15512,MONDAY,0,0,6.1,57,24.1,1010.2,Fair
4/11/2022 6:00,0,3,0,2270,3,2270,MONDAY,0,0,6.1,57,22.3,1010.9,Fair
4/11/2022 7:00,1,6,352,5195,7,5547,MONDAY,0,0,5.6,57,24.1,1011.6,Clear
4/11/2022 8:00,3,14,3524,8758,17,12282,MONDAY,0,0,5,57,27.7,1012.2,Clear
4/11/2022 9:00,8,43,3853,31485,51,35338,MONDAY,0,0,5,55,25.9,1012.9,Clear
4/11/2022 10:00,15,149,11953,95340,164,107293,MONDAY,0,0,4.4,57,25.9,1013.9,Fair
4/11/2022 11:00,34,334,48305,254737,368,303042,MONDAY,0,0,5,55,22.3,1015.4,Fair
4/11/2022 12:00,66,608,75404,448439,674,523843,MONDAY,0,0,6.1,51,24.1,1016.3,Fair
4/11/2022 13:00,64,408,108852,289484,472,398336,MONDAY,0,0,7.2,49,20.5,1016.7,Fair
4/11/2022 14:00,81,293,172022,225220,374,397242,MONDAY,0,0,9.4,42,20.5,1017.3,Fair
4/11/2022 15:00,89,299,141994,286515,388,428509,MONDAY,0,0,11.1,39,18.4,1017.5,Fair
4/11/2022 16:00,157,362,406632,248049,519,654681,MONDAY,0,0,12.8,38,14.8,1017.2,Fair
4/11/2022 17:00,144,395,370570,275684,539,646254,MONDAY,0,0,13.3,37,9.4,1017,Fair
4/11/2022 18:00,161,423,703787,311263,584,1015050,MONDAY,0,0,15,32,14.8,1016.9,Fair
4/11/2022 19:00,170,439,361261,336542,609,697803,MONDAY,0,0,15.6,31,13,1015.8,Fair
4/11/2022 20:00,225,555,693252,479196,780,1172448,MONDAY,0,0,17.2,28,16.6,1015.5,Fair
4/11/2022 21:00,228,891,439255,728790,1119,1168045,MONDAY,0,0,17.2,25,16.6,1014.4,Cloudy
4/11/2022 22:00,240,773,450184,659014,1013,1109198,MONDAY,0,0,17.2,25,14.8,1014.2,Cloudy
4/11/2022 23:00,140,596,519224,422982,736,942206,MONDAY,0,0,16.1,26,16.6,1014.5,Cloudy
4/12/2022 0:00,87,320,210249,234684,407,444933,TUESDAY,0,0,12.8,45,14.8,1015,Cloudy
4/12/2022 1:00,70,212,1586205,156162,282,1742367,TUESDAY,0,0,12.2,47,18.4,1015.9,Cloudy
4/12/2022 2:00,38,138,142388,99164,176,241552,TUESDAY,0,0,11.7,45,18.4,1015.7,Cloudy
4/12/2022 3:00,14,74,13763,107160,88,120923,TUESDAY,0,0,11.1,39,22.3,1015.9,Rain
4/12/2022 4:00,11,33,11633,16024,44,27657,TUESDAY,0,0,11.1,43,20.5,1015.5,Cloudy
4/12/2022 5:00,3,19,6821,10038,22,16859,TUESDAY,0,0,11.1,43,18.4,1015.1,Cloudy
4/12/2022 6:00,4,8,5312,3792,12,9104,TUESDAY,0,0,10.6,48,16.6,1014.4,Cloudy
4/12/2022 7:00,3,7,2697,47390,10,50087,TUESDAY,0,0,10,58,20.5,1013.4,Cloudy
4/12/2022 8:00,4,7,5967,5252,11,11219,TUESDAY,0,0,10,61,18.4,1013,Cloudy
4/12/2022 9:00,5,45,9871,34275,50,44146,TUESDAY,0,0,10,63,20.5,1012.7,Cloudy
4/12/2022 10:00,13,149,14108,126141,162,140249,TUESDAY,0,0,10,66,14.8,1012.5,Rain
4/12/2022 11:00,45,408,86796,288499,453,375295,TUESDAY,0,0,10,66,13,1013,Rain
4/12/2022 12:00,57,735,61925,561550,792,623475,TUESDAY,0,0,11.7,59,14.8,1012.9,Rain
4/12/2022 13:00,53,448,61636,340451,501,402087,TUESDAY,0,0,12.8,52,18.4,1012.8,Rain
4/12/2022 14:00,41,235,95718,154417,276,250135,TUESDAY,0,0,12.8,55,20.5,1013.3,Rain
4/12/2022 15:00,34,201,55811,116590,235,172401,TUESDAY,0,0,11.7,69,16.6,1014.1,Rain
4/12/2022 16:00,31,270,41956,175480,301,217436,TUESDAY,0,0,11.7,80,5.4,1012.7,Rain
4/12/2022 17:00,84,309,644135,1005962,393,1650097,TUESDAY,0,0,12.8,74,11.2,1013.4,Rain
4/12/2022 18:00,127,383,483733,291718,510,775451,TUESDAY,0,0,15.6,62,11.2,1013.7,Cloudy
4/12/2022 19:00,160,507,294924,434191,667,729115,TUESDAY,0,0,18.3,50,14.8,1013.5,Cloudy
4/12/2022 20:00,189,667,373731,615689,856,989420,TUESDAY,0,0,19.4,44,18.4,1012.7,Cloudy
4/12/2022 21:00,340,1003,896356,1008379,1343,1904735,TUESDAY,0,0,20.6,38,22.3,1012.4,Fair
4/12/2022 22:00,302,916,659825,742219,1218,1402044,TUESDAY,0,0,20.6,35,27.7,1013.2,Fair
4/12/2022 23:00,174,575,445854,466881,749,912735,TUESDAY,0,0,19.4,34,18.4,1013.6,Fair
4/13/2022 0:00,118,386,193598,301343,504,494941,WEDNESDAY,0,0,18.9,37,16.6,1014.9,Fair
4/13/2022 1:00,114,261,433320,209774,375,643094,WEDNESDAY,0,0,17.8,40,13,1015.8,Fair
4/13/2022 2:00,106,197,228012,156566,303,384578,WEDNESDAY,0,0,16.7,44,9.4,1016.3,Fair
4/13/2022 3:00,46,80,114286,60246,126,174532,WEDNESDAY,0,0,15.6,46,9.4,1017.1,Fair
4/13/2022 4:00,19,47,41696,30149,66,71845,WEDNESDAY,0,0,15,46,11.2,1017.5,Fair
4/13/2022 5:00,13,19,24517,14170,32,38687,WEDNESDAY,0,0,13.9,47,9.4,1017.8,Fair
4/13/2022 6:00,10,10,1069622,6915,20,1076537,WEDNESDAY,0,0,13.9,44,11.2,1018.3,Fair
4/13/2022 7:00,5,4,4430,3646,9,8076,WEDNESDAY,0,0,12.8,40,11.2,1018,Cloudy
4/13/2022 8:00,1,6,1333,8218,7,9551,WEDNESDAY,0,0,12.2,38,13,1018.1,Cloudy
4/13/2022 9:00,2,45,26334,31279,47,57613,WEDNESDAY,0,0,11.1,41,11.2,1018.3,Cloudy
4/13/2022 10:00,13,181,11888,127506,194,139394,WEDNESDAY,0,0,8.9,58,0,1019.6,Cloudy
4/13/2022 11:00,44,427,43764,333522,471,377286,WEDNESDAY,0,0,9.4,61,7.6,1019.5,Cloudy
4/13/2022 12:00,98,836,527464,609811,934,1137275,WEDNESDAY,0,0,14.4,36,0,1019.4,Cloudy
4/13/2022 13:00,86,520,128295,466743,606,595038,WEDNESDAY,0,0,14.4,39,5.4,1019.9,Cloudy
4/13/2022 14:00,98,360,234473,299213,458,533686,WEDNESDAY,0,0,15.6,37,11.2,1019.3,Cloudy
4/13/2022 15:00,122,356,328174,274119,478,602293,WEDNESDAY,0,0,16.7,28,7.6,1018.3,Cloudy
4/13/2022 16:00,159,401,621802,295513,560,917315,WEDNESDAY,0,0,16.1,34,18.4,1017.4,Cloudy
4/13/2022 17:00,146,396,242486,296311,542,538797,WEDNESDAY,0,0,15,53,18.4,1016.4,Cloudy
4/13/2022 18:00,168,407,335723,306568,575,642291,WEDNESDAY,0,0,16.7,48,9.4,1015.3,Cloudy
4/13/2022 19:00,200,457,575497,359921,657,935418,WEDNESDAY,0,0,21.7,24,25.9,1013.9,Cloudy
4/13/2022 20:00,258,673,519063,548420,931,1067483,WEDNESDAY,0,0,21.7,26,31.7,1012.5,Cloudy
4/13/2022 21:00,380,1018,998598,886205,1398,1884803,WEDNESDAY,0,0,21.1,29,27.7,1011.9,Cloudy
4/13/2022 22:00,416,884,959565,739264,1300,1698829,WEDNESDAY,0,0,19.4,37,24.1,1011.5,Cloudy
4/13/2022 23:00,278,668,792184,523879,946,1316063,WEDNESDAY,0,0,18.9,49,22.3,1011.3,Cloudy
4/14/2022 0:00,180,416,3360271,349785,596,3710056,THURSDAY,0,0,16.1,65,16.6,1010.7,Cloudy
4/14/2022 1:00,117,300,185022,243817,417,428839,THURSDAY,0,0,16.1,72,11.2,1010.8,Cloudy
4/14/2022 2:00,103,224,337411,179819,327,517230,THURSDAY,0,0,16.1,72,9.4,1011.1,Cloudy
4/14/2022 3:00,58,122,149217,96939,180,246156,THURSDAY,0,0,12.2,64,24.1,1011.5,Rain
4/14/2022 4:00,32,49,67848,25139,81,92987,THURSDAY,0,0,11.1,63,16.6,1012,Cloudy
4/14/2022 5:00,13,18,2480182,12327,31,2492509,THURSDAY,0,0,10,71,18.4,1012,Cloudy
4/14/2022 6:00,1,14,1567,10897,15,12464,THURSDAY,0,0,9.4,77,14.8,1011.2,Cloudy
4/14/2022 7:00,1,3,695,4144,4,4839,THURSDAY,0,0,9.4,77,13,1011.4,Cloudy
4/14/2022 8:00,2,12,1779,14962,14,16741,THURSDAY,0,0,8.9,80,16.6,1011,Cloudy
4/14/2022 9:00,4,49,3634,33929,53,37563,THURSDAY,0,0,8.3,83,13,1010.8,Cloudy
4/14/2022 10:00,13,151,15519,106526,164,122045,THURSDAY,0,0,8.3,83,11.2,1010.7,Cloudy
4/14/2022 11:00,49,367,61035,261303,416,322338,THURSDAY,0,0,8.3,86,16.6,1010.9,Cloudy
4/14/2022 12:00,89,695,88499,505162,784,593661,THURSDAY,0,0,8.3,86,13,1011.5,Cloudy
4/14/2022 13:00,62,486,77295,366463,548,443758,THURSDAY,0,0,8.3,86,20.5,1011.4,Cloudy
4/14/2022 14:00,64,325,125189,227555,389,352744,THURSDAY,0,0,8.9,86,13,1011.4,Cloudy
4/14/2022 15:00,67,318,130019,220174,385,350193,THURSDAY,0,0,8.9,86,16.6,1012.2,Cloudy
4/14/2022 16:00,69,357,135899,256585,426,392484,THURSDAY,0,0,9.4,86,20.5,1011.3,Cloudy
4/14/2022 17:00,75,319,91692,213436,394,305128,THURSDAY,0,0,9.4,86,16.6,1011.1,Cloudy
4/14/2022 18:00,112,360,215558,261387,472,476945,THURSDAY,0,0,10,83,14.8,1011,Cloudy
4/14/2022 19:00,116,408,193411,317924,524,511335,THURSDAY,0,0,10,83,14.8,1010.8,Cloudy
4/14/2022 20:00,142,542,285208,399505,684,684713,THURSDAY,0,0,9.4,83,16.6,1010.8,Cloudy
4/14/2022 21:00,204,783,524474,625820,987,1150294,THURSDAY,0,0,8.3,90,14.8,1009.7,Rain
4/14/2022 22:00,179,678,213940,497685,857,711625,THURSDAY,0,0,8.3,90,18.4,1010.6,Cloudy
4/14/2022 23:00,94,420,157713,255474,514,413187,THURSDAY,0,0,8.3,86,18.4,1010.8,Cloudy
4/15/2022 0:00,45,267,44920,180771,312,225691,FRIDAY,0,0,7.8,89,13,1011.7,Cloudy
4/15/2022 1:00,19,129,30069,86911,148,116980,FRIDAY,0,0,8.3,90,13,1013.4,Cloudy
4/15/2022 2:00,59,159,115867,124500,218,240367,FRIDAY,0,0,8.3,90,16.6,1012.9,Cloudy
4/15/2022 3:00,35,73,126839,77798,108,204637,FRIDAY,0,0,8.3,90,11.2,1013.3,Rain
4/15/2022 4:00,17,50,15161,32804,67,47965,FRIDAY,0,0,8.3,86,16.6,1013.6,Cloudy
4/15/2022 5:00,39,40,55784,34343,79,90127,FRIDAY,0,0,8.3,86,11.2,1014.1,Cloudy
4/15/2022 6:00,17,18,20526,10817,35,31343,FRIDAY,0,0,8.3,90,7.6,1014.2,Cloudy
4/15/2022 7:00,2,11,1518,12528,13,14046,FRIDAY,0,0,8.3,90,11.2,1015,Cloudy
4/15/2022 8:00,6,6,33038,2656,12,35694,FRIDAY,0,0,8.3,90,7.6,1015.3,Cloudy
4/15/2022 9:00,6,43,3348,29884,49,33232,FRIDAY,0,0,8.9,86,11.2,1016.3,Cloudy
4/15/2022 10:00,21,116,33307,76222,137,109529,FRIDAY,0,0,10,80,11.2,1016.5,Cloudy
4/15/2022 11:00,46,270,63850,195543,316,259393,FRIDAY,0,0,9.4,80,13,1017.2,Cloudy
4/15/2022 12:00,80,479,110346,350885,559,461231,FRIDAY,0,0,10,66,14.8,1017.8,Fair
4/15/2022 13:00,82,433,196164,340217,515,536381,FRIDAY,0,0,12.8,49,13,1018,Fair
4/15/2022 14:00,146,350,373950,269675,496,643625,FRIDAY,0,0,14.4,36,16.6,1018.6,Fair
4/15/2022 15:00,203,402,630013,373473,605,1003486,FRIDAY,0,0,15.6,28,22.3,1018.3,Fair
4/15/2022 16:00,325,498,2323020,391445,823,2714465,FRIDAY,0,0,17.2,22,31.7,1017.7,Fair
4/15/2022 17:00,353,471,1452158,445003,824,1897161,FRIDAY,0,0,17.8,24,25.9,1017.2,Fair
4/15/2022 18:00,289,439,2454906,612093,728,3066999,FRIDAY,0,0,18.3,20,25.9,1016.5,Fair
4/15/2022 19:00,406,549,858457,610010,955,1468467,FRIDAY,0,0,18.9,16,13,1016,Fair
4/15/2022 20:00,485,678,1262631,635800,1163,1898431,FRIDAY,0,0,18.9,16,25.9,1015.4,Fair
4/15/2022 21:00,552,807,2296174,746025,1359,3042199,FRIDAY,0,0,18.9,16,27.7,1015.2,Fair
4/15/2022 22:00,501,729,1621911,635959,1230,2257870,FRIDAY,0,0,18.9,16,27.7,1015.1,Fair
4/15/2022 23:00,355,571,1024899,642890,926,1667789,FRIDAY,0,0,17.8,17,22.3,1014.7,Fair
4/16/2022 0:00,204,381,1286550,284500,585,1571050,SATURDAY,1,0,16.1,24,31.7,1015.2,Fair
4/16/2022 1:00,135,266,1553022,199161,401,1752183,SATURDAY,1,0,15,25,27.7,1016.5,Fair
4/16/2022 2:00,114,185,339819,130947,299,470766,SATURDAY,1,0,14.4,25,29.5,1017.4,Fair
4/16/2022 3:00,128,150,192831,255975,278,448806,SATURDAY,1,0,13.3,30,29.5,1016.3,Fair
4/16/2022 4:00,88,104,223021,71080,192,294101,SATURDAY,1,0,12.8,34,29.5,1016.1,Fair
4/16/2022 5:00,93,104,175769,116273,197,292042,SATURDAY,1,0,11.7,39,22.3,1015.8,Fair
4/16/2022 6:00,64,52,83644,39228,116,122872,SATURDAY,1,0,12.2,38,25.9,1015.3,Clear
4/16/2022 7:00,21,16,336208,36060,37,372268,SATURDAY,1,0,12.8,37,25.9,1014.1,Clear
4/16/2022 8:00,6,11,4555,9845,17,14400,SATURDAY,1,0,12.8,35,31.7,1014.1,Fair
4/16/2022 9:00,12,16,16736,17040,28,33776,SATURDAY,1,0,12.8,35,24.1,1014,Fair
4/16/2022 10:00,25,68,53121,54061,93,107182,SATURDAY,1,0,12.8,37,25.9,1013.8,Fair
4/16/2022 11:00,52,136,214608,109380,188,323988,SATURDAY,1,0,12.8,37,22.3,1014.6,Cloudy
4/16/2022 12:00,100,211,200241,179239,311,379480,SATURDAY,1,0,13.9,34,24.1,1014.3,Cloudy
4/16/2022 13:00,179,286,500299,251551,465,751850,SATURDAY,1,0,15.6,32,29.5,1014.1,Cloudy
4/16/2022 14:00,246,379,522737,307959,625,830696,SATURDAY,1,0,16.1,30,25.9,1013.3,Cloudy
4/16/2022 15:00,347,430,866775,392237,777,1259012,SATURDAY,1,0,16.1,35,33.5,1013.5,Cloudy
4/16/2022 16:00,387,464,1003764,443244,851,1447008,SATURDAY,1,0,18.3,33,29.5,1012.9,Cloudy
4/16/2022 17:00,424,519,1301054,581629,943,1882683,SATURDAY,1,0,19.4,34,38.9,1011.8,Cloudy
4/16/2022 18:00,492,474,1090949,492118,966,1583067,SATURDAY,1,0,21.7,31,40.7,1011.2,Cloudy
4/16/2022 19:00,613,536,1702255,549329,1149,2251584,SATURDAY,1,0,21.7,32,33.5,1009.7,Cloudy
4/16/2022 20:00,522,511,1989098,647584,1033,2636682,SATURDAY,1,0,18.3,47,37.1,1009.2,Rain
4/16/2022 21:00,454,489,1821133,443223,943,2264356,SATURDAY,1,0,17.2,48,27.7,1008,Rain
4/16/2022 22:00,346,412,931235,346024,758,1277259,SATURDAY,1,0,16.7,54,37.1,1007.9,Rain
4/16/2022 23:00,255,322,1768568,235785,577,2004353,SATURDAY,1,0,16.7,58,27.7,1007.5,Rain
4/17/2022 0:00,50,89,243244,52557,139,295801,SUNDAY,1,0,16.7,58,18.4,1009.4,Rain
4/17/2022 1:00,31,70,81496,44356,101,125852,SUNDAY,1,0,8.3,83,27.7,1011.1,Rain
4/17/2022 2:00,19,68,23435,50434,87,73869,SUNDAY,1,0,7.2,86,11.2,1012,Rain
4/17/2022 3:00,10,38,8780,24804,48,33584,SUNDAY,1,0,7.2,86,14.8,1011.8,Rain
4/17/2022 4:00,13,31,15855,16915,44,32770,SUNDAY,1,0,7.2,90,9.4,1011.7,Rain
4/17/2022 5:00,41,41,57896,28652,82,86548,SUNDAY,1,0,6.7,79,9.4,1011.9,Rain
4/17/2022 6:00,26,45,51138,50922,71,102060,SUNDAY,1,0,6.7,79,0,1010.6,Rain
4/17/2022 7:00,6,12,67879,4864,18,72743,SUNDAY,1,0,6.7,79,16.6,1010.8,Rain
4/17/2022 8:00,2,17,2913,13123,19,16036,SUNDAY,1,0,6.7,79,18.4,1011.1,Cloudy
4/17/2022 9:00,8,18,9325,13337,26,22662,SUNDAY,1,0,5.6,79,18.4,1011.9,Fair
4/17/2022 10:00,13,21,33294,20545,34,53839,SUNDAY,1,0,5.6,73,18.4,1012.6,Fair
4/17/2022 11:00,29,63,52925,54603,92,107528,SUNDAY,1,0,5.6,70,20.5,1013.2,Fair
4/17/2022 12:00,70,101,136037,102321,171,238358,SUNDAY,1,0,6.7,65,18.4,1013.7,Fair
4/17/2022 13:00,163,227,319276,215525,390,534801,SUNDAY,1,0,7.8,60,24.1,1014.2,Fair
4/17/2022 14:00,241,282,551396,244447,523,795843,SUNDAY,1,0,8.3,56,24.1,1014.6,Fair
4/17/2022 15:00,223,321,452834,258776,544,711610,SUNDAY,1,0,8.9,47,24.1,1014.8,Fair
4/17/2022 16:00,246,314,762494,237150,560,999644,SUNDAY,1,0,7.8,53,29.5,1016,Fair
4/17/2022 17:00,175,301,353452,261965,476,615417,SUNDAY,1,0,7.2,53,35.3,1015.9,Cloudy
4/17/2022 18:00,144,313,248815,288359,457,537174,SUNDAY,1,0,7.8,45,25.9,1016.3,Cloudy
4/17/2022 19:00,211,282,526996,488749,493,1015745,SUNDAY,1,0,8.9,42,29.5,1016.3,Cloudy
4/17/2022 20:00,215,324,454127,301847,539,755974,SUNDAY,1,0,8.3,44,31.7,1017.2,Fair
4/17/2022 21:00,156,320,1640349,252909,476,1893258,SUNDAY,1,0,8.3,37,24.1,1018,Fair
4/17/2022 22:00,204,349,583243,294122,553,877365,SUNDAY,1,0,8.9,29,22.3,1019,Fair
4/17/2022 23:00,155,296,179707,213536,451,393243,SUNDAY,1,0,8.3,36,13,1020,Fair
4/18/2022 0:00,79,211,93851,176135,290,269986,MONDAY,0,1,8.3,33,20.5,1021,Fair
4/18/2022 1:00,65,146,86839,95825,211,182664,MONDAY,0,1,7.8,34,13,1022.2,Fair
4/18/2022 2:00,50,97,130114,57071,147,187185,MONDAY,0,1,7.2,38,27.7,1023.2,Fair
4/18/2022 3:00,40,59,521907,41158,99,563065,MONDAY,0,1,6.1,45,18.4,1024.1,Clear
4/18/2022 4:00,32,43,111290,35359,75,146649,MONDAY,0,1,6.1,47,18.4,1024.3,Clear
4/18/2022 5:00,16,30,36560,16485,46,53045,MONDAY,0,1,5.6,49,18.4,1024.7,Clear
4/18/2022 6:00,9,9,12864,14969,18,27833,MONDAY,0,1,5,51,20.5,1025.2,Clear
4/18/2022 7:00,6,13,10207,12019,19,22226,MONDAY,0,1,5,53,18.4,1025.4,Clear
4/18/2022 8:00,15,8,30493,8761,23,39254,MONDAY,0,1,5,53,14.8,1025.9,Clear
4/18/2022 9:00,15,39,11896,21789,54,33685,MONDAY,0,1,3.9,57,9.4,1026,Clear
4/18/2022 10:00,48,98,48403,73348,146,121751,MONDAY,0,1,3.9,57,14.8,1027.2,Clear
4/18/2022 11:00,41,167,49662,126356,208,176018,MONDAY,0,1,5,53,14.8,1028.2,Fair
4/18/2022 12:00,112,348,222714,300555,460,523269,MONDAY,0,1,6.1,51,13,1028.8,Fair
4/18/2022 13:00,188,341,571231,254881,529,826112,MONDAY,0,1,7.8,43,11.2,1028.8,Fair
4/18/2022 14:00,263,345,1416247,297658,608,1713905,MONDAY,0,1,8.9,42,13,1028.5,Fair
4/18/2022 15:00,284,352,1698017,825061,636,2523078,MONDAY,0,1,8.9,44,13,1028.8,Fair
4/18/2022 16:00,324,405,1880731,420458,729,2301189,MONDAY,0,1,9.4,48,18.4,1029,Fair
4/18/2022 17:00,326,411,992533,451542,737,1444075,MONDAY,0,1,9.4,50,27.7,1028.4,Fair
4/18/2022 18:00,383,383,2497914,356645,766,2854559,MONDAY,0,1,9.4,54,29.5,1027.7,Fair
4/18/2022 19:00,388,486,1081244,402873,874,1484117,MONDAY,0,1,8.9,51,25.9,1027.4,Cloudy
4/18/2022 20:00,332,541,634990,455966,873,1090956,MONDAY,0,1,8.9,58,27.7,1026.5,Cloudy
4/18/2022 21:00,304,617,568250,493350,921,1061600,MONDAY,0,1,8.9,63,27.7,1025.8,Cloudy
4/18/2022 22:00,191,559,797620,473024,750,1270644,MONDAY,0,1,8.9,63,31.7,1025.9,Cloudy
4/18/2022 23:00,178,392,1132335,279829,570,1412164,MONDAY,0,1,8.9,66,24.1,1025.2,Cloudy
4/19/2022 0:00,99,264,127200,246374,363,373574,TUESDAY,0,0,7.8,68,25.9,1025.1,Cloudy
4/19/2022 1:00,60,216,191190,157168,276,348358,TUESDAY,0,0,7.2,74,25.9,1024.9,Cloudy
4/19/2022 2:00,41,117,73365,80610,158,153975,TUESDAY,0,0,7.2,71,25.9,1024,Cloudy
4/19/2022 3:00,23,72,34508,42851,95,77359,TUESDAY,0,0,7.2,76,31.7,1022.8,Rain
4/19/2022 4:00,19,36,61467,27315,55,88782,TUESDAY,0,0,7.2,80,31.7,1021.2,Rain
4/19/2022 5:00,8,16,19924,10136,24,30060,TUESDAY,0,0,7.2,80,37.1,1018.9,Rain
4/19/2022 6:00,10,8,45596,4568,18,50164,TUESDAY,0,0,7.2,80,42.5,1016.3,Rain
4/19/2022 7:00,1,1,931,126,2,1057,TUESDAY,0,0,6.7,89,38.9,1013.5,Rain
4/19/2022 8:00,2,0,2579,0,2,2579,TUESDAY,0,0,6.7,93,51.8,1009,Rain
4/19/2022 9:00,2,12,1634,11166,14,12800,TUESDAY,0,0,7.2,93,59.4,1003.9,Rain
4/19/2022 10:00,4,44,12431,23676,48,36107,TUESDAY,0,0,8.9,93,51.8,1003.4,Rain
4/19/2022 11:00,18,173,28936,124621,191,153557,TUESDAY,0,0,10,93,46.4,1000.1,Rain
4/19/2022 12:00,44,510,57662,359509,554,417171,TUESDAY,0,0,11.1,97,29.5,998.7,Rain
4/19/2022 13:00,51,413,306709,278179,464,584888,TUESDAY,0,0,12.8,87,33.5,998.2,Rain
4/19/2022 14:00,74,270,114169,198260,344,312429,TUESDAY,0,0,11.1,86,37.1,998.3,Rain
4/19/2022 15:00,99,301,309474,371247,400,680721,TUESDAY,0,0,10.6,83,29.5,998.5,Rain
4/19/2022 16:00,131,366,301687,260382,497,562069,TUESDAY,0,0,12.2,77,27.7,998.6,Cloudy
4/19/2022 17:00,101,319,212239,209388,420,421627,TUESDAY,0,0,14.4,60,44.6,999.2,Cloudy
4/19/2022 18:00,107,297,594786,201003,404,795789,TUESDAY,0,0,12.2,55,44.6,1001.1,Cloudy
4/19/2022 19:00,135,352,280172,224664,487,504836,TUESDAY,0,0,10.6,66,29.5,1002.6,Cloudy
4/19/2022 20:00,123,495,179594,325654,618,505248,TUESDAY,0,0,10.6,54,29.5,1003.3,Cloudy
4/19/2022 21:00,131,699,277403,547886,830,825289,TUESDAY,0,0,10,56,42.5,1004.5,Cloudy
4/19/2022 22:00,162,670,246118,475680,832,721798,TUESDAY,0,0,7.8,63,31.7,1006.2,Cloudy
4/19/2022 23:00,109,471,141288,307330,580,448618,TUESDAY,0,0,8.3,56,27.7,1007.4,Cloudy
4/20/2022 0:00,56,289,56082,182063,345,238145,WEDNESDAY,0,0,7.2,56,29.5,1008.7,Fair
4/20/2022 1:00,41,267,38208,190519,308,228727,WEDNESDAY,0,0,6.7,58,24.1,1010,Fair
4/20/2022 2:00,58,147,130146,94103,205,224249,WEDNESDAY,0,0,6.7,55,22.3,1010.5,Fair
4/20/2022 3:00,21,89,46651,55280,110,101931,WEDNESDAY,0,0,6.1,55,22.3,1010.6,Fair
4/20/2022 4:00,16,40,25528,19995,56,45523,WEDNESDAY,0,0,6.1,55,25.9,1011.2,Fair
4/20/2022 5:00,12,15,36340,12893,27,49233,WEDNESDAY,0,0,6.1,53,22.3,1012,Fair
4/20/2022 6:00,3,10,2342,4241,13,6583,WEDNESDAY,0,0,5.6,57,24.1,1012.7,Fair
4/20/2022 7:00,2,6,770,5838,8,6608,WEDNESDAY,0,0,5.6,55,25.9,1013.3,Fair
4/20/2022 8:00,5,6,4449,4386,11,8835,WEDNESDAY,0,0,5.6,55,27.7,1013.9,Fair
4/20/2022 9:00,7,52,9523,36443,59,45966,WEDNESDAY,0,0,5.6,57,27.7,1014.8,Fair
4/20/2022 10:00,14,143,10258,101731,157,111989,WEDNESDAY,0,0,5.6,57,33.5,1016.2,Fair
4/20/2022 11:00,36,352,43121,255003,388,298124,WEDNESDAY,0,0,6.7,53,25.9,1017.5,Fair
4/20/2022 12:00,88,666,109300,477821,754,587121,WEDNESDAY,0,0,7.2,49,29.5,1018.8,Fair
4/20/2022 13:00,65,484,149702,312583,549,462285,WEDNESDAY,0,0,8.3,44,37.1,1019.9,Fair
4/20/2022 14:00,92,346,172160,268807,438,440967,WEDNESDAY,0,0,9.4,41,35.3,1021.2,Fair
4/20/2022 15:00,125,330,258933,211044,455,469977,WEDNESDAY,0,0,10,39,22.3,1022.1,Fair
4/20/2022 16:00,143,404,749956,628162,547,1378118,WEDNESDAY,0,0,10,41,29.5,1023.1,Fair
4/20/2022 17:00,132,375,296594,253921,507,550515,WEDNESDAY,0,0,10.6,39,27.7,1023.7,Fair
4/20/2022 18:00,171,383,596907,247517,554,844424,WEDNESDAY,0,0,11.7,35,27.7,1024.2,Fair
4/20/2022 19:00,165,414,333407,280433,579,613840,WEDNESDAY,0,0,12.2,31,22.3,1024.4,Fair
4/20/2022 20:00,229,636,524223,504091,865,1028314,WEDNESDAY,0,0,13.3,30,25.9,1024.7,Fair
4/20/2022 21:00,247,902,493309,714906,1149,1208215,WEDNESDAY,0,0,13.9,25,20.5,1025.6,Fair
4/20/2022 22:00,310,749,1085172,595775,1059,1680947,WEDNESDAY,0,0,13.3,26,22.3,1026.6,Fair
4/20/2022 23:00,141,518,212616,493784,659,706400,WEDNESDAY,0,0,12.8,25,14.8,1027.4,Fair
4/21/2022 0:00,82,346,418897,245974,428,664871,THURSDAY,0,0,12.2,26,9.4,1028.9,Fair
4/21/2022 1:00,108,260,134967,191204,368,326171,THURSDAY,0,0,11.1,31,13,1030.6,Fair
4/21/2022 2:00,131,264,858776,205147,395,1063923,THURSDAY,0,0,10.6,35,16.6,1031.3,Fair
4/21/2022 3:00,34,98,29804,63034,132,92838,THURSDAY,0,0,9.4,39,13,1031.8,Fair
4/21/2022 4:00,32,67,903650,38336,99,941986,THURSDAY,0,0,8.9,39,9.4,1032.4,Clear
4/21/2022 5:00,15,22,20236,14206,37,34442,THURSDAY,0,0,6.7,53,9.4,1033,Fair
4/21/2022 6:00,13,10,10514,5464,23,15978,THURSDAY,0,0,6.1,51,13,1033.7,Clear
4/21/2022 7:00,1,7,1391,4874,8,6265,THURSDAY,0,0,5.6,64,9.4,1033.9,Clear
4/21/2022 8:00,2,11,2367,8655,13,11022,THURSDAY,0,0,6.7,68,16.6,1033.7,Clear
4/21/2022 9:00,5,49,4223,32751,54,36974,THURSDAY,0,0,6.1,76,24.1,1034,Fair
4/21/2022 10:00,14,139,15157,88022,153,103179,THURSDAY,0,0,6.1,70,20.5,1034.5,Clear
4/21/2022 11:00,41,373,44524,394646,414,439170,THURSDAY,0,0,7.2,71,22.3,1034.7,Fair
4/21/2022 12:00,92,736,387525,512370,828,899895,THURSDAY,0,0,8.3,74,24.1,1034.8,Cloudy
4/21/2022 13:00,77,538,142793,465967,615,608760,THURSDAY,0,0,9.4,69,18.4,1035.1,Cloudy
4/21/2022 14:00,92,378,152593,597841,470,750434,THURSDAY,0,0,10.6,66,20.5,1034.5,Cloudy
4/21/2022 15:00,135,365,436289,263799,500,700088,THURSDAY,0,0,10.6,71,25.9,1033.8,Cloudy
4/21/2022 16:00,150,418,359050,324376,568,683426,THURSDAY,0,0,13.3,53,13,1032.5,Cloudy
4/21/2022 17:00,192,390,450567,299460,582,750027,THURSDAY,0,0,16.1,30,29.5,1031,Cloudy
4/21/2022 18:00,142,352,254633,268797,494,523430,THURSDAY,0,0,16.1,30,29.5,1030.1,Cloudy
4/21/2022 19:00,172,430,492264,308710,602,800974,THURSDAY,0,0,15,33,33.5,1029.1,Cloudy
4/21/2022 20:00,199,621,361452,460560,820,822012,THURSDAY,0,0,13.9,42,40.7,1028.1,Cloudy
4/21/2022 21:00,188,900,323700,691546,1088,1015246,THURSDAY,0,0,12.8,49,31.7,1027.2,Cloudy
4/21/2022 22:00,182,665,1136395,502324,847,1638719,THURSDAY,0,0,12.2,53,31.7,1027.6,Cloudy
4/21/2022 23:00,135,533,210568,358068,668,568636,THURSDAY,0,0,11.7,54,31.7,1026.8,Cloudy
4/22/2022 0:00,88,361,159413,228098,449,387511,FRIDAY,0,0,11.1,61,33.5,1026.7,Cloudy
4/22/2022 1:00,67,229,147386,152726,296,300112,FRIDAY,0,0,11.1,66,27.7,1027.1,Cloudy
4/22/2022 2:00,72,192,109445,138713,264,248158,FRIDAY,0,0,10.6,74,22.3,1026.4,Cloudy
4/22/2022 3:00,66,102,132256,68222,168,200478,FRIDAY,0,0,11.1,71,27.7,1025.7,Rain
4/22/2022 4:00,53,71,149724,45632,124,195356,FRIDAY,0,0,10.6,68,22.3,1025.4,Cloudy
4/22/2022 5:00,20,50,78436,33648,70,112084,FRIDAY,0,0,10.6,63,22.3,1025,Cloudy
4/22/2022 6:00,19,32,29601,20750,51,50351,FRIDAY,0,0,10,66,20.5,1024.8,Cloudy
4/22/2022 7:00,5,7,5445,6624,12,12069,FRIDAY,0,0,10,66,20.5,1024.2,Cloudy
4/22/2022 8:00,10,13,9318,10252,23,19570,FRIDAY,0,0,9.4,69,20.5,1023.5,Fair
4/22/2022 9:00,9,54,11660,34460,63,46120,FRIDAY,0,0,10,68,18.4,1023.5,Fair
4/22/2022 10:00,11,121,7165,80588,132,87753,FRIDAY,0,0,10,71,18.4,1023.8,Fair
4/22/2022 11:00,28,316,28169,230782,344,258951,FRIDAY,0,0,11.7,66,22.3,1024.4,Fair
4/22/2022 12:00,74,580,100013,405456,654,505469,FRIDAY,0,0,12.8,64,20.5,1024.6,Fair
4/22/2022 13:00,85,511,159800,592970,596,752770,FRIDAY,0,0,15,53,24.1,1024.7,Fair
4/22/2022 14:00,121,359,466745,331478,480,798223,FRIDAY,0,0,16.7,36,31.7,1024.3,Fair
4/22/2022 15:00,171,409,443173,310573,580,753746,FRIDAY,0,0,17.2,30,29.5,1024.4,Fair
4/22/2022 16:00,197,428,425292,339426,625,764718,FRIDAY,0,0,17.2,30,33.5,1024.4,Fair
4/22/2022 17:00,227,466,544766,365926,693,910692,FRIDAY,0,0,17.8,27,29.5,1024.6,Fair
4/22/2022 18:00,228,468,450053,381484,696,831537,FRIDAY,0,0,16.7,30,27.7,1024.5,Fair
4/22/2022 19:00,334,491,1091787,399200,825,1490987,FRIDAY,0,0,18.3,26,27.7,1024.4,Fair
4/22/2022 20:00,345,713,1883349,590673,1058,2474022,FRIDAY,0,0,17.2,29,29.5,1024.4,Fair
4/22/2022 21:00,415,867,1333554,769577,1282,2103131,FRIDAY,0,0,17.2,27,31.7,1024.9,Fair
4/22/2022 22:00,395,760,917177,644663,1155,1561840,FRIDAY,0,0,16.7,26,24.1,1025.4,Fair
4/22/2022 23:00,290,570,604303,464630,860,1068933,FRIDAY,0,0,15.6,27,20.5,1025.6,Fair
4/23/2022 0:00,183,338,408005,266512,521,674517,SATURDAY,1,0,15,27,20.5,1026.7,Fair
4/23/2022 1:00,122,284,197389,223706,406,421095,SATURDAY,1,0,13.3,33,16.6,1027.4,Fair
4/23/2022 2:00,151,223,337951,165150,374,503101,SATURDAY,1,0,12.2,38,13,1028.3,Fair
4/23/2022 3:00,113,174,252658,136158,287,388816,SATURDAY,1,0,11.7,35,13,1028.6,Clear
4/23/2022 4:00,137,129,330573,104175,266,434748,SATURDAY,1,0,10.6,38,13,1028.7,Clear
4/23/2022 5:00,201,125,1273161,106897,326,1380058,SATURDAY,1,0,10,39,18.4,1029.1,Clear
4/23/2022 6:00,66,57,670274,54618,123,724892,SATURDAY,1,0,9.4,39,7.6,1029.2,Clear
4/23/2022 7:00,13,18,9937,42156,31,52093,SATURDAY,1,0,8.9,42,11.2,1029,Clear
4/23/2022 8:00,6,9,6609,12851,15,19460,SATURDAY,1,0,8.3,42,14.8,1028.8,Clear
4/23/2022 9:00,6,9,18964,10393,15,29357,SATURDAY,1,0,7.8,43,20.5,1028.7,Clear
4/23/2022 10:00,12,48,25249,32735,60,57984,SATURDAY,1,0,7.8,43,14.8,1029.1,Fair
4/23/2022 11:00,21,121,16218,88435,142,104653,SATURDAY,1,0,7.8,45,13,1029.5,Fair
4/23/2022 12:00,66,211,88342,158651,277,246993,SATURDAY,1,0,8.9,39,16.6,1029.6,Fair
4/23/2022 13:00,139,364,277680,315899,503,593579,SATURDAY,1,0,10,36,14.8,1029.7,Fair
4/23/2022 14:00,260,475,594425,417468,735,1011893,SATURDAY,1,0,11.7,31,16.6,1029,Cloudy
4/23/2022 15:00,373,531,829902,553450,904,1383352,SATURDAY,1,0,11.1,38,13,1028.5,Cloudy
4/23/2022 16:00,452,596,1190354,584070,1048,1774424,SATURDAY,1,0,11.7,41,20.5,1027.4,Cloudy
4/23/2022 17:00,549,616,2547327,620853,1165,3168180,SATURDAY,1,0,12.8,38,13,1026.3,Cloudy
4/23/2022 18:00,684,653,1519294,641268,1337,2160562,SATURDAY,1,0,13.9,44,16.6,1025.3,Cloudy
4/23/2022 19:00,723,673,2053631,716148,1396,2769779,SATURDAY,1,0,13.9,44,22.3,1024.6,Cloudy
4/23/2022 20:00,525,572,1277398,519039,1097,1796437,SATURDAY,1,0,11.7,56,20.5,1023.8,Cloudy
4/23/2022 21:00,429,532,1543409,707898,961,2251307,SATURDAY,1,0,11.7,59,13,1023.5,Cloudy
4/23/2022 22:00,416,582,632072,475894,998,1107966,SATURDAY,1,0,11.7,56,7.6,1023.2,Cloudy
4/23/2022 23:00,314,461,1320487,348402,775,1668889,SATURDAY,1,0,10,71,9.4,1023.3,Cloudy
4/24/2022 0:00,189,251,408971,251517,440,660488,SUNDAY,1,0,10,77,9.4,1023.9,Cloudy
4/24/2022 1:00,158,269,828016,193558,427,1021574,SUNDAY,1,0,10,74,0,1024.1,Cloudy
4/24/2022 2:00,220,241,296886,174800,461,471686,SUNDAY,1,0,11.7,48,0,1024.3,Cloudy
4/24/2022 3:00,188,215,312638,157711,403,470349,SUNDAY,1,0,12.2,40,5.4,1024.4,Cloudy
4/24/2022 4:00,186,180,311577,127888,366,439465,SUNDAY,1,0,12.8,30,16.6,1024.5,Cloudy
4/24/2022 5:00,262,148,917376,135739,410,1053115,SUNDAY,1,0,12.2,26,16.6,1024.5,Cloudy
4/24/2022 6:00,141,86,612554,66785,227,679339,SUNDAY,1,0,9.4,33,22.3,1024.5,Cloudy
4/24/2022 7:00,13,34,12225,29457,47,41682,SUNDAY,1,0,8.9,35,24.1,1024.9,Cloudy
4/24/2022 8:00,5,9,4984,7092,14,12076,SUNDAY,1,0,8.3,46,20.5,1025.5,Cloudy
4/24/2022 9:00,7,6,21133,9109,13,30242,SUNDAY,1,0,7.8,51,25.9,1026.1,Cloudy
4/24/2022 10:00,8,41,36595,30732,49,67327,SUNDAY,1,0,7.2,51,27.7,1026.7,Fair
4/24/2022 11:00,9,53,16286,38271,62,54557,SUNDAY,1,0,6.7,55,25.9,1027.8,Cloudy
4/24/2022 12:00,54,175,96366,140358,229,236724,SUNDAY,1,0,6.7,53,24.1,1028,Cloudy
4/24/2022 13:00,100,269,165932,382048,369,547980,SUNDAY,1,0,7.2,49,22.3,1028.1,Cloudy
4/24/2022 14:00,171,348,290073,274494,519,564567,SUNDAY,1,0,7.8,45,22.3,1028,Cloudy
4/24/2022 15:00,210,403,597680,298209,613,895889,SUNDAY,1,0,7.8,49,22.3,1028,Cloudy
4/24/2022 16:00,202,453,368654,370396,655,739050,SUNDAY,1,0,7.2,49,18.4,1028,Cloudy
4/24/2022 17:00,254,455,686178,540456,709,1226634,SUNDAY,1,0,7.2,47,14.8,1027.4,Cloudy
4/24/2022 18:00,248,461,429350,379193,709,808543,SUNDAY,1,0,7.8,47,13,1027.1,Cloudy
4/24/2022 19:00,225,520,1404122,409066,745,1813188,SUNDAY,1,0,6.7,47,13,1026.3,Cloudy
4/24/2022 20:00,171,468,244521,355123,639,599644,SUNDAY,1,0,7.2,49,11.2,1025.9,Cloudy
4/24/2022 21:00,138,435,389992,331645,573,721637,SUNDAY,1,0,7.2,49,11.2,1025.6,Cloudy
4/24/2022 22:00,139,428,602379,314713,567,917092,SUNDAY,1,0,7.8,37,5.4,1025.2,Cloudy
4/24/2022 23:00,93,371,145507,248130,464,393637,SUNDAY,1,0,7.8,43,7.6,1024.8,Cloudy
4/25/2022 0:00,66,208,72762,172987,274,245749,MONDAY,0,0,7.8,43,11.2,1024.8,Cloudy
4/25/2022 1:00,56,216,79309,145778,272,225087,MONDAY,0,0,7.8,53,7.6,1024.7,Cloudy
4/25/2022 2:00,44,127,118628,84175,171,202803,MONDAY,0,0,8.9,40,11.2,1025,Cloudy
4/25/2022 3:00,31,61,101675,40576,92,142251,MONDAY,0,0,9.4,34,13,1024.8,Cloudy
4/25/2022 4:00,21,41,53592,21893,62,75485,MONDAY,0,0,8.9,39,9.4,1024.6,Cloudy
4/25/2022 5:00,9,29,14623,17821,38,32444,MONDAY,0,0,8.3,44,5.4,1024.1,Cloudy
4/25/2022 6:00,4,12,7825,5134,16,12959,MONDAY,0,0,8.3,48,7.6,1023.9,Cloudy
4/25/2022 7:00,3,11,2136,6928,14,9064,MONDAY,0,0,8.3,52,7.6,1024.1,Cloudy
4/25/2022 8:00,4,8,20540,8572,12,29112,MONDAY,0,0,8.3,52,5.4,1023.8,Cloudy
4/25/2022 9:00,5,45,1984,27406,50,29390,MONDAY,0,0,8.3,54,9.4,1024.1,Cloudy
4/25/2022 10:00,10,146,10775,96254,156,107029,MONDAY,0,0,8.3,49,5.4,1024.4,Cloudy
4/25/2022 11:00,36,385,32715,289991,421,322706,MONDAY,0,0,8.9,50,7.6,1025.5,Cloudy
4/25/2022 12:00,63,681,93536,499015,744,592551,MONDAY,0,0,10,46,7.6,1025.9,Cloudy
4/25/2022 13:00,68,447,79234,330369,515,409603,MONDAY,0,0,10,52,16.6,1026.3,Cloudy
4/25/2022 14:00,61,309,130838,218435,370,349273,MONDAY,0,0,10,63,14.8,1026.8,Cloudy
4/25/2022 15:00,102,308,147721,215987,410,363708,MONDAY,0,0,10,66,24.1,1026.8,Cloudy
4/25/2022 16:00,73,347,106546,229872,420,336418,MONDAY,0,0,11.1,52,20.5,1026.8,Cloudy
4/25/2022 17:00,76,318,107044,227570,394,334614,MONDAY,0,0,10.6,48,25.9,1026.4,Cloudy
4/25/2022 18:00,86,343,158871,237550,429,396421,MONDAY,0,0,11.1,50,22.3,1026,Cloudy
4/25/2022 19:00,107,398,351518,278584,505,630102,MONDAY,0,0,10,58,24.1,1025.6,Cloudy
4/25/2022 20:00,123,567,560243,409878,690,970121,MONDAY,0,0,10,58,27.7,1024.9,Cloudy
4/25/2022 21:00,177,851,229503,636335,1028,865838,MONDAY,0,0,10,61,22.3,1024.9,Cloudy
4/25/2022 22:00,126,693,172450,505549,819,677999,MONDAY,0,0,9.4,66,25.9,1025,Cloudy
4/25/2022 23:00,94,501,106667,333045,595,439712,MONDAY,0,0,8.3,71,27.7,1024.8,Cloudy
4/26/2022 0:00,48,323,38240,304551,371,342791,TUESDAY,0,0,8.3,76,18.4,1024.4,Cloudy
4/26/2022 1:00,42,239,44339,155121,281,199460,TUESDAY,0,0,8.3,76,18.4,1024.5,Cloudy
4/26/2022 2:00,42,151,67763,91959,193,159722,TUESDAY,0,0,8.3,76,14.8,1024.5,Cloudy
4/26/2022 3:00,17,90,17959,188977,107,206936,TUESDAY,0,0,8.3,74,14.8,1024,Cloudy
4/26/2022 4:00,22,44,36981,27323,66,64304,TUESDAY,0,0,8.3,74,20.5,1023.7,Cloudy
4/26/2022 5:00,15,15,24804,6680,30,31484,TUESDAY,0,0,7.8,76,16.6,1023.5,Cloudy
4/26/2022 6:00,10,5,4963,4796,15,9759,TUESDAY,0,0,7.8,79,14.8,1022.7,Cloudy
4/26/2022 7:00,0,11,0,8196,11,8196,TUESDAY,0,0,7.8,79,13,1022.5,Cloudy
4/26/2022 8:00,7,9,7106,6868,16,13974,TUESDAY,0,0,8.3,80,11.2,1022.4,Cloudy
4/26/2022 9:00,7,50,4995,30569,57,35564,TUESDAY,0,0,8.3,80,14.8,1022,Cloudy
4/26/2022 10:00,21,146,196356,193587,167,389943,TUESDAY,0,0,8.3,76,13,1021.8,Cloudy
4/26/2022 11:00,47,424,54474,298181,471,352655,TUESDAY,0,0,8.3,80,16.6,1021.5,Cloudy
4/26/2022 12:00,75,871,105861,601678,946,707539,TUESDAY,0,0,8.9,77,11.2,1021.4,Cloudy
4/26/2022 13:00,52,545,133505,405800,597,539305,TUESDAY,0,0,9.4,77,14.8,1020.9,Cloudy
4/26/2022 14:00,41,336,151063,242340,377,393403,TUESDAY,0,0,10.6,71,14.8,1020.3,Cloudy
4/26/2022 15:00,49,355,426590,360184,404,786774,TUESDAY,0,0,10.6,77,16.6,1020,Cloudy
4/26/2022 16:00,61,350,107288,234081,411,341369,TUESDAY,0,0,11.7,77,13,1019.4,Cloudy
4/26/2022 17:00,77,321,259091,221574,398,480665,TUESDAY,0,0,11.1,83,16.6,1018.6,Cloudy
4/26/2022 18:00,79,385,99587,265220,464,364807,TUESDAY,0,0,11.7,80,14.8,1018.1,Cloudy
4/26/2022 19:00,61,385,125777,269010,446,394787,TUESDAY,0,0,12.2,77,13,1017.4,Rain
4/26/2022 20:00,68,474,65863,306744,542,372607,TUESDAY,0,0,11.7,93,14.8,1016.8,Rain
4/26/2022 21:00,82,535,143653,366862,617,510515,TUESDAY,0,0,11.7,93,14.8,1016.3,Rain
4/26/2022 22:00,47,348,95844,265023,395,360867,TUESDAY,0,0,11.1,97,9.4,1016.2,Rain
4/26/2022 23:00,24,250,70726,144258,274,214984,TUESDAY,0,0,11.1,97,7.6,1015.6,Rain
4/27/2022 0:00,16,183,20463,113880,199,134343,WEDNESDAY,0,0,10,96,11.2,1015.1,Rain
4/27/2022 1:00,16,94,14074,61287,110,75361,WEDNESDAY,0,0,9.4,100,14.8,1014.6,Cloudy
4/27/2022 2:00,31,105,22644,67407,136,90051,WEDNESDAY,0,0,10,96,14.8,1013.7,Rain
4/27/2022 3:00,13,53,10469,29459,66,39928,WEDNESDAY,0,0,10,100,5.4,1012.9,Rain
4/27/2022 4:00,9,30,32778,19557,39,52335,WEDNESDAY,0,0,10.6,96,5.4,1011.9,Rain
4/27/2022 5:00,5,21,2484,10572,26,13056,WEDNESDAY,0,0,10,100,7.6,1010.9,Rain
4/27/2022 6:00,5,5,2873,3552,10,6425,WEDNESDAY,0,0,11.1,97,0,1010.4,Rain
4/27/2022 7:00,3,9,1558,8852,12,10410,WEDNESDAY,0,0,10.6,100,0,1009.1,Rain
4/27/2022 8:00,4,9,2841,4289,13,7130,WEDNESDAY,0,0,11.1,97,14.8,1009.2,Cloudy
4/27/2022 9:00,2,48,3169,30695,50,33864,WEDNESDAY,0,0,11.7,93,13,1008.8,Cloudy
4/27/2022 10:00,22,155,16791,97883,177,114674,WEDNESDAY,0,0,11.7,86,25.9,1009.1,Cloudy
4/27/2022 11:00,59,415,138513,330919,474,469432,WEDNESDAY,0,0,10.6,74,27.7,1009.5,Cloudy
4/27/2022 12:00,91,769,115985,551711,860,667696,WEDNESDAY,0,0,10.6,71,25.9,1009.3,Cloudy
4/27/2022 13:00,64,530,118180,396640,594,514820,WEDNESDAY,0,0,11.1,66,24.1,1008.8,Cloudy
4/27/2022 14:00,57,390,76524,405321,447,481845,WEDNESDAY,0,0,12.2,57,22.3,1008.5,Cloudy
4/27/2022 15:00,64,348,124326,240043,412,364369,WEDNESDAY,0,0,12.8,51,22.3,1007.9,Cloudy
4/27/2022 16:00,78,383,228683,269049,461,497732,WEDNESDAY,0,0,12.2,49,20.5,1007.2,Cloudy
4/27/2022 17:00,106,379,146844,262868,485,409712,WEDNESDAY,0,0,12.8,43,25.9,1006.6,Cloudy
4/27/2022 18:00,92,409,230087,300372,501,530459,WEDNESDAY,0,0,13.9,37,25.9,1006.1,Cloudy
4/27/2022 19:00,99,411,141266,304261,510,445527,WEDNESDAY,0,0,13.3,38,27.7,1006,Cloudy
4/27/2022 20:00,115,602,167742,481821,717,649563,WEDNESDAY,0,0,12.8,40,35.3,1006.1,Cloudy
4/27/2022 21:00,131,724,125216,545371,855,670587,WEDNESDAY,0,0,12.2,45,27.7,1006.2,Cloudy
4/27/2022 22:00,121,739,285493,600634,860,886127,WEDNESDAY,0,0,9.4,63,20.5,1007.1,Cloudy
4/27/2022 23:00,115,524,288204,350159,639,638363,WEDNESDAY,0,0,10.6,42,25.9,1007.1,Cloudy
4/28/2022 0:00,70,303,161771,200089,373,361860,THURSDAY,0,0,9.4,42,29.5,1007.9,Cloudy
4/28/2022 1:00,45,275,40588,176742,320,217330,THURSDAY,0,0,8.9,47,33.5,1009,Cloudy
4/28/2022 2:00,30,132,25840,93007,162,118847,THURSDAY,0,0,7.8,51,31.7,1009.2,Cloudy
4/28/2022 3:00,29,97,292805,58430,126,351235,THURSDAY,0,0,7.2,51,31.7,1009.4,Cloudy
4/28/2022 4:00,11,40,7850,18437,51,26287,THURSDAY,0,0,6.1,62,33.5,1009.9,Fair
4/28/2022 5:00,15,18,10593,8755,33,19348,THURSDAY,0,0,6.1,55,37.1,1009.5,Fair
4/28/2022 6:00,13,9,19769,5541,22,25310,THURSDAY,0,0,5.6,55,25.9,1009,Fair
4/28/2022 7:00,0,16,0,11843,16,11843,THURSDAY,0,0,5,53,24.1,1009,Fair
4/28/2022 8:00,5,15,15754,8975,20,24729,THURSDAY,0,0,5,51,35.3,1009.2,Fair
4/28/2022 9:00,6,59,4093,34799,65,38892,THURSDAY,0,0,4.4,53,27.7,1009.8,Fair
4/28/2022 10:00,13,137,12411,89719,150,102130,THURSDAY,0,0,3.9,50,37.1,1010.2,Cloudy
4/28/2022 11:00,45,354,36027,262547,399,298574,THURSDAY,0,0,4.4,48,27.7,1010.6,Cloudy
4/28/2022 12:00,63,644,55720,459381,707,515101,THURSDAY,0,0,5,45,40.7,1010.7,Cloudy
4/28/2022 13:00,56,454,140184,307454,510,447638,THURSDAY,0,0,6.1,43,27.7,1010.8,Cloudy
4/28/2022 14:00,62,290,121373,206938,352,328311,THURSDAY,0,0,7.2,40,38.9,1010.8,Cloudy
4/28/2022 15:00,52,306,133522,380618,358,514140,THURSDAY,0,0,7.8,40,35.3,1010.7,Cloudy
4/28/2022 16:00,71,363,108764,277568,434,386332,THURSDAY,0,0,8.9,39,31.7,1010.5,Cloudy
4/28/2022 17:00,68,338,101753,246805,406,348558,THURSDAY,0,0,9.4,36,33.5,1010,Cloudy
4/28/2022 18:00,86,344,106122,233126,430,339248,THURSDAY,0,0,10,36,27.7,1009.6,Cloudy
4/28/2022 19:00,100,433,150652,291632,533,442284,THURSDAY,0,0,10.6,33,31.7,1009.4,Cloudy
4/28/2022 20:00,132,620,173816,466466,752,640282,THURSDAY,0,0,10.6,32,31.7,1009.6,Cloudy
4/28/2022 21:00,196,835,302644,592469,1031,895113,THURSDAY,0,0,11.1,29,37.1,1010,Cloudy
4/28/2022 22:00,178,785,215292,600601,963,815893,THURSDAY,0,0,11.1,27,33.5,1010.4,Fair
4/28/2022 23:00,136,525,315029,349048,661,664077,THURSDAY,0,0,10.6,26,27.7,1011.2,Fair
4/29/2022 0:00,84,323,387395,226678,407,614073,FRIDAY,0,0,9.4,26,29.5,1012.2,Cloudy
4/29/2022 1:00,64,236,115449,154103,300,269552,FRIDAY,0,0,8.9,25,25.9,1013.2,Fair
4/29/2022 2:00,89,199,131346,124317,288,255663,FRIDAY,0,0,8.3,26,18.4,1013.4,Fair
4/29/2022 3:00,51,126,97698,75303,177,173001,FRIDAY,0,0,7.8,27,24.1,1013.7,Fair
4/29/2022 4:00,35,64,37840,44238,99,82078,FRIDAY,0,0,7.2,30,16.6,1013.8,Fair
4/29/2022 5:00,27,33,31573,48392,60,79965,FRIDAY,0,0,6.7,29,18.4,1013.6,Fair
4/29/2022 6:00,13,16,66593,14653,29,81246,FRIDAY,0,0,6.1,29,16.6,1013.5,Clear
4/29/2022 7:00,5,18,20522,18066,23,38588,FRIDAY,0,0,6.1,29,16.6,1013.4,Clear
4/29/2022 8:00,6,8,3934,4959,14,8893,FRIDAY,0,0,5,31,14.8,1013.7,Clear
4/29/2022 9:00,3,41,3528,29570,44,33098,FRIDAY,0,0,5,31,18.4,1013.8,Clear
4/29/2022 10:00,17,118,13498,76727,135,90225,FRIDAY,0,0,4.4,33,18.4,1014.2,Clear
4/29/2022 11:00,34,314,32679,227888,348,260567,FRIDAY,0,0,5,31,24.1,1014.6,Fair
4/29/2022 12:00,67,547,81228,387518,614,468746,FRIDAY,0,0,5.6,29,31.7,1014.7,Fair
4/29/2022 13:00,56,414,166782,276161,470,442943,FRIDAY,0,0,6.7,27,31.7,1014.7,Fair
4/29/2022 14:00,47,328,52020,234378,375,286398,FRIDAY,0,0,8.3,26,25.9,1014.4,Fair
4/29/2022 15:00,102,347,144918,246709,449,391627,FRIDAY,0,0,9.4,24,27.7,1014,Fair
4/29/2022 16:00,97,374,310279,262981,471,573260,FRIDAY,0,0,10.6,25,29.5,1013.8,Fair
4/29/2022 17:00,116,408,497993,317314,524,815307,FRIDAY,0,0,11.1,25,29.5,1013.4,Fair
4/29/2022 18:00,135,430,224942,303854,565,528796,FRIDAY,0,0,11.7,25,27.7,1013.1,Cloudy
4/29/2022 19:00,141,451,258284,343449,592,601733,FRIDAY,0,0,12.8,25,33.5,1013,Cloudy
4/29/2022 20:00,192,579,388250,621355,771,1009605,FRIDAY,0,0,12.2,25,31.7,1012.9,Cloudy
4/29/2022 21:00,197,729,241801,629569,926,871370,FRIDAY,0,0,12.2,26,31.7,1013.5,Cloudy
4/29/2022 22:00,188,633,471206,507769,821,978975,FRIDAY,0,0,11.7,27,27.7,1014.5,Cloudy
4/29/2022 23:00,191,506,338589,406472,697,745061,FRIDAY,0,0,11.1,29,29.5,1015.2,Cloudy
4/30/2022 0:00,73,284,81667,225041,357,306708,SATURDAY,1,0,10,30,22.3,1016,Cloudy
4/30/2022 1:00,73,239,139183,179513,312,318696,SATURDAY,1,0,9.4,33,16.6,1016.9,Cloudy
4/30/2022 2:00,97,198,173984,128086,295,302070,SATURDAY,1,0,8.9,35,14.8,1017.5,Cloudy
4/30/2022 3:00,75,163,100743,108566,238,209309,SATURDAY,1,0,8.3,37,18.4,1017.5,Cloudy
4/30/2022 4:00,75,111,127710,76713,186,204423,SATURDAY,1,0,7.8,38,13,1017.3,Cloudy
4/30/2022 5:00,115,118,178119,85979,233,264098,SATURDAY,1,0,7.2,40,14.8,1017.1,Fair
4/30/2022 6:00,62,46,88719,66361,108,155080,SATURDAY,1,0,7.2,40,16.6,1017.1,Fair
4/30/2022 7:00,5,20,2535,17618,25,20153,SATURDAY,1,0,6.7,43,11.2,1017.6,Fair
4/30/2022 8:00,9,16,141258,12836,25,154094,SATURDAY,1,0,6.1,45,16.6,1017.7,Fair
4/30/2022 9:00,8,16,8565,5253,24,13818,SATURDAY,1,0,5.6,44,14.8,1017.7,Fair
4/30/2022 10:00,9,42,61851,29551,51,91402,SATURDAY,1,0,5.6,46,16.6,1018.1,Cloudy
4/30/2022 11:00,20,86,27310,56764,106,84074,SATURDAY,1,0,5.6,49,14.8,1018.5,Cloudy
4/30/2022 12:00,43,160,52209,100135,203,152344,SATURDAY,1,0,6.7,45,16.6,1018.6,Cloudy
4/30/2022 13:00,95,249,211448,187991,344,399439,SATURDAY,1,0,7.2,47,14.8,1018.7,Cloudy
4/30/2022 14:00,157,355,300173,266160,512,566333,SATURDAY,1,0,10,41,13,1018.2,Cloudy
4/30/2022 15:00,244,474,563515,398034,718,961549,SATURDAY,1,0,10.6,38,14.8,1017.9,Cloudy
4/30/2022 16:00,274,504,689437,396529,778,1085966,SATURDAY,1,0,9.4,52,22.3,1018.1,Cloudy
4/30/2022 17:00,272,528,630958,456503,800,1087461,SATURDAY,1,0,9.4,54,24.1,1018.1,Cloudy
4/30/2022 18:00,337,539,765076,514801,876,1279877,SATURDAY,1,0,9.4,56,22.3,1018,Cloudy
4/30/2022 19:00,375,490,817118,422475,865,1239593,SATURDAY,1,0,10,52,16.6,1017.6,Cloudy
4/30/2022 20:00,396,535,1035723,514418,931,1550141,SATURDAY,1,0,10.6,54,16.6,1017.3,Cloudy
4/30/2022 21:00,346,560,774800,496762,906,1271562,SATURDAY,1,0,11.1,50,14.8,1017.1,Cloudy
4/30/2022 22:00,323,513,811122,455967,836,1267089,SATURDAY,1,0,10,54,13,1017.4,Cloudy
4/30/2022 23:00,219,422,384036,334944,641,718980,SATURDAY,1,0,10.6,50,7.6,1017.5,Cloudy
5/1/2022 0:00,169,290,297441,213495,459,510936,SUNDAY,1,0,8.3,74,7.6,1018,Cloudy
5/1/2022 1:00,97,234,145322,157697,331,303019,SUNDAY,1,0,7.8,79,0,1018.6,Cloudy
5/1/2022 2:00,113,179,1823948,129354,292,1953302,SUNDAY,1,0,9.4,56,20.5,1019,Fair
5/1/2022 3:00,76,157,150220,123256,233,273476,SUNDAY,1,0,8.9,51,14.8,1019.2,Fair
5/1/2022 4:00,109,110,3724599,75630,219,3800229,SUNDAY,1,0,8.3,61,16.6,1019.1,Fair
5/1/2022 5:00,151,97,1059640,86995,248,1146635,SUNDAY,1,0,7.8,63,9.4,1019,Fair
5/1/2022 6:00,71,57,1784305,42571,128,1826876,SUNDAY,1,0,8.3,63,0,1018.9,Fair
5/1/2022 7:00,13,30,11377,25881,43,37258,SUNDAY,1,0,7.8,63,13,1019,Fair
5/1/2022 8:00,18,8,40482,5952,26,46434,SUNDAY,1,0,7.8,58,13,1019.1,Fair
5/1/2022 9:00,7,20,11037,15603,27,26640,SUNDAY,1,0,7.8,55,14.8,1019.3,Fair
5/1/2022 10:00,9,45,12381,40418,54,52799,SUNDAY,1,0,7.8,55,14.8,1019.5,Fair
5/1/2022 11:00,16,73,24835,49704,89,74539,SUNDAY,1,0,8.3,54,13,1020.2,Fair
5/1/2022 12:00,55,175,96076,153547,230,249623,SUNDAY,1,0,10.6,48,11.2,1020.4,Fair
5/1/2022 13:00,120,265,253237,205865,385,459102,SUNDAY,1,0,12.8,41,9.4,1020.3,Fair
5/1/2022 14:00,216,382,428607,363061,598,791668,SUNDAY,1,0,14.4,36,14.8,1020.2,Fair
5/1/2022 15:00,428,473,1699439,500048,901,2199487,SUNDAY,1,0,15,39,5.4,1020,Fair
5/1/2022 16:00,408,578,993157,561351,986,1554508,SUNDAY,1,0,15.6,37,16.6,1019.7,Fair
5/1/2022 17:00,539,620,1373448,688741,1159,2062189,SUNDAY,1,0,15.6,42,18.4,1018.9,Fair
5/1/2022 18:00,584,591,2516206,573400,1175,3089606,SUNDAY,1,0,16.1,38,20.5,1018.5,Fair
5/1/2022 19:00,539,572,4582863,592628,1111,5175491,SUNDAY,1,0,13.9,53,35.3,1018.3,Fair
5/1/2022 20:00,588,610,1474023,650174,1198,2124197,SUNDAY,1,0,12.8,52,35.3,1018.1,Fair
5/1/2022 21:00,467,578,5295203,512843,1045,5808046,SUNDAY,1,0,13.3,55,27.7,1017.8,Fair
5/1/2022 22:00,393,528,2690190,511068,921,3201258,SUNDAY,1,0,13.9,55,20.5,1017.6,Fair
5/1/2022 23:00,228,432,545259,353615,660,898874,SUNDAY,1,0,16.1,39,24.1,1017.6,Fair
5/2/2022 0:00,122,256,238360,191394,378,429754,MONDAY,0,0,13.9,47,14.8,1018,Fair
5/2/2022 1:00,62,164,130478,110182,226,240660,MONDAY,0,0,12.8,47,14.8,1018.2,Fair
5/2/2022 2:00,49,114,64930,77058,163,141988,MONDAY,0,0,12.8,45,16.6,1018.2,Fair
5/2/2022 3:00,45,100,59607,58768,145,118375,MONDAY,0,0,11.7,47,11.2,1018.4,Fair
5/2/2022 4:00,23,50,19996,30448,73,50444,MONDAY,0,0,11.1,46,11.2,1018.9,Fair
5/2/2022 5:00,10,18,11538,9835,28,21373,MONDAY,0,0,10.6,48,5.4,1019.3,Fair
5/2/2022 6:00,13,14,32255,9338,27,41593,MONDAY,0,0,8.9,68,11.2,1020,Fair
5/2/2022 7:00,8,5,36918,4454,13,41372,MONDAY,0,0,8.9,71,16.6,1020.1,Fair
5/2/2022 8:00,3,9,4608,6416,12,11024,MONDAY,0,0,8.3,76,16.6,1020.3,Fair
5/2/2022 9:00,14,40,9162,27649,54,36811,MONDAY,0,0,7.8,83,16.6,1020.2,Fair
5/2/2022 10:00,16,154,13913,98312,170,112225,MONDAY,0,0,7.2,90,11.2,1020.3,Fair
5/2/2022 11:00,37,399,31548,297655,436,329203,MONDAY,0,0,8.3,83,9.4,1020.6,Cloudy
5/2/2022 12:00,75,701,713301,496124,776,1209425,MONDAY,0,0,9.4,80,7.6,1021,Cloudy
5/2/2022 13:00,83,435,140638,313974,518,454612,MONDAY,0,0,10,74,7.6,1021.3,Cloudy
5/2/2022 14:00,87,334,170891,214050,421,384941,MONDAY,0,0,11.1,69,5.4,1021.3,Cloudy
5/2/2022 15:00,91,297,406516,208801,388,615317,MONDAY,0,0,13.3,64,14.8,1021.4,Cloudy
5/2/2022 16:00,85,348,124187,345570,433,469757,MONDAY,0,0,12.2,64,18.4,1021.2,Cloudy
5/2/2022 17:00,105,362,151194,243314,467,394508,MONDAY,0,0,11.1,77,14.8,1021,Cloudy
5/2/2022 18:00,93,315,130597,194019,408,324616,MONDAY,0,0,11.7,69,18.4,1020.7,Cloudy
5/2/2022 19:00,80,325,266599,329360,405,595959,MONDAY,0,0,11.7,69,13,1020.3,Rain
5/2/2022 20:00,84,441,84625,350608,525,435233,MONDAY,0,0,11.7,71,16.6,1020,Rain
5/2/2022 21:00,71,583,80679,396200,654,476879,MONDAY,0,0,11.1,77,18.4,1020,Rain
5/2/2022 22:00,71,512,89458,1469647,583,1559105,MONDAY,0,0,10,80,25.9,1019.9,Rain
5/2/2022 23:00,39,227,40308,144118,266,184426,MONDAY,0,0,9.4,86,18.4,1020.3,Rain
5/3/2022 0:00,27,181,25007,121283,208,146290,TUESDAY,0,0,8.3,93,14.8,1020.6,Rain
5/3/2022 1:00,31,151,47347,92788,182,140135,TUESDAY,0,0,8.3,93,13,1020.8,Rain
5/3/2022 2:00,21,80,1328319,51229,101,1379548,TUESDAY,0,0,8.3,90,14.8,1021.2,Rain
5/3/2022 3:00,11,56,7158,32664,67,39822,TUESDAY,0,0,8.3,93,20.5,1020.9,Rain
5/3/2022 4:00,7,26,336090,12704,33,348794,TUESDAY,0,0,7.8,93,18.4,1020.8,Rain
5/3/2022 5:00,10,13,12284,6791,23,19075,TUESDAY,0,0,7.8,93,20.5,1020.8,Rain
5/3/2022 6:00,4,6,4062,2949,10,7011,TUESDAY,0,0,7.8,93,16.6,1020.7,Rain
5/3/2022 7:00,2,6,1288,2788,8,4076,TUESDAY,0,0,7.8,96,18.4,1020.8,Rain
5/3/2022 8:00,9,9,13365,8998,18,22363,TUESDAY,0,0,7.8,96,18.4,1020.7,Rain
5/3/2022 9:00,3,46,2978,29224,49,32202,TUESDAY,0,0,7.8,96,18.4,1021.1,Rain
5/3/2022 10:00,14,143,13175,105742,157,118917,TUESDAY,0,0,7.8,93,18.4,1021.4,Rain
5/3/2022 11:00,44,396,40939,288879,440,329818,TUESDAY,0,0,8.3,93,14.8,1022.2,Rain
5/3/2022 12:00,88,732,80938,513348,820,594286,TUESDAY,0,0,8.3,93,16.6,1022.7,Rain
5/3/2022 13:00,60,494,59494,349963,554,409457,TUESDAY,0,0,8.9,89,18.4,1023.3,Cloudy
5/3/2022 14:00,51,324,61816,235106,375,296922,TUESDAY,0,0,9.4,86,20.5,1023.4,Cloudy
5/3/2022 15:00,75,359,122629,244273,434,366902,TUESDAY,0,0,10,80,16.6,1024,Cloudy
5/3/2022 16:00,66,384,104242,258041,450,362283,TUESDAY,0,0,10,77,18.4,1023.9,Cloudy
5/3/2022 17:00,109,362,278263,239763,471,518026,TUESDAY,0,0,11.1,69,18.4,1023.4,Cloudy
5/3/2022 18:00,124,392,238292,261490,516,499782,TUESDAY,0,0,10.6,74,18.4,1023.4,Cloudy
5/3/2022 19:00,123,478,283033,328384,601,611417,TUESDAY,0,0,10,77,16.6,1023.4,Cloudy
5/3/2022 20:00,142,627,208519,468721,769,677240,TUESDAY,0,0,10.6,77,18.4,1022.7,Cloudy
5/3/2022 21:00,285,951,672566,889786,1236,1562352,TUESDAY,0,0,10.6,71,16.6,1022.6,Cloudy
5/3/2022 22:00,273,847,513145,682067,1120,1195212,TUESDAY,0,0,10,71,13,1022.8,Cloudy
5/3/2022 23:00,133,525,218104,400150,658,618254,TUESDAY,0,0,9.4,77,16.6,1022.7,Cloudy
5/4/2022 0:00,78,312,294981,222228,390,517209,WEDNESDAY,0,0,9.4,74,16.6,1022.8,Cloudy
5/4/2022 1:00,131,275,192850,213654,406,406504,WEDNESDAY,0,0,8.9,77,18.4,1022,Cloudy
5/4/2022 2:00,161,208,982904,151345,369,1134249,WEDNESDAY,0,0,8.9,80,22.3,1021.5,Cloudy
5/4/2022 3:00,47,99,76093,63199,146,139292,WEDNESDAY,0,0,8.3,83,13,1021.4,Cloudy
5/4/2022 4:00,33,55,58233,103896,88,162129,WEDNESDAY,0,0,8.9,80,11.2,1020.8,Cloudy
5/4/2022 5:00,25,18,1916096,16401,43,1932497,WEDNESDAY,0,0,8.9,80,13,1020.2,Cloudy
5/4/2022 6:00,6,11,4704,7306,17,12010,WEDNESDAY,0,0,8.9,80,0,1020.9,Cloudy
5/4/2022 7:00,13,11,14852,10507,24,25359,WEDNESDAY,0,0,8.9,80,5.4,1020.9,Cloudy
5/4/2022 8:00,4,15,4306,12102,19,16408,WEDNESDAY,0,0,8.3,90,11.2,1020,Cloudy
5/4/2022 9:00,7,55,9841,34138,62,43979,WEDNESDAY,0,0,8.3,90,13,1019.1,Cloudy
5/4/2022 10:00,19,151,23973,107211,170,131184,WEDNESDAY,0,0,8.3,93,14.8,1018.5,Rain
5/4/2022 11:00,42,434,119680,301637,476,421317,WEDNESDAY,0,0,8.9,89,9.4,1019,Rain
5/4/2022 12:00,65,619,56859,436720,684,493579,WEDNESDAY,0,0,10,83,5.4,1018.3,Rain
5/4/2022 13:00,38,372,38348,232707,410,271055,WEDNESDAY,0,0,9.4,90,20.5,1017,Rain
5/4/2022 14:00,44,210,56875,141286,254,198161,WEDNESDAY,0,0,9.4,93,16.6,1017,Rain
5/4/2022 15:00,30,176,47864,112855,206,160719,WEDNESDAY,0,0,10,93,9.4,1017,Rain
5/4/2022 16:00,18,132,19791,80241,150,100032,WEDNESDAY,0,0,9.4,97,7.6,1016.8,Rain
5/4/2022 17:00,30,165,65788,92485,195,158273,WEDNESDAY,0,0,10,96,9.4,1015,Rain
5/4/2022 18:00,39,234,40909,143738,273,184647,WEDNESDAY,0,0,10,96,11.2,1014.7,Rain
5/4/2022 19:00,53,329,50256,225501,382,275757,WEDNESDAY,0,0,10,96,9.4,1014.5,Cloudy
5/4/2022 20:00,73,422,64995,2080336,495,2145331,WEDNESDAY,0,0,10,96,9.4,1013.9,Rain
5/4/2022 21:00,114,666,116742,497981,780,614723,WEDNESDAY,0,0,10,93,9.4,1013.8,Cloudy
5/4/2022 22:00,138,645,249849,719367,783,969216,WEDNESDAY,0,0,10.6,96,0,1013.3,Cloudy
5/4/2022 23:00,84,423,786534,294449,507,1080983,WEDNESDAY,0,0,11.1,93,0,1013.2,Cloudy
5/5/2022 0:00,63,307,118304,381841,370,500145,THURSDAY,0,0,12.2,90,11.2,1013.2,Rain
5/5/2022 1:00,72,211,392359,160333,283,552692,THURSDAY,0,0,11.7,89,16.6,1013.8,Cloudy
5/5/2022 2:00,65,173,182189,113417,238,295606,THURSDAY,0,0,11.7,89,16.6,1014.5,Cloudy
5/5/2022 3:00,56,142,76755,94486,198,171241,THURSDAY,0,0,11.1,89,14.8,1014.6,Cloudy
5/5/2022 4:00,40,65,1617120,39245,105,1656365,THURSDAY,0,0,11.1,89,14.8,1014.7,Cloudy
5/5/2022 5:00,30,27,437846,27873,57,465719,THURSDAY,0,0,11.1,89,14.8,1015,Cloudy
5/5/2022 6:00,17,16,21537,9661,33,31198,THURSDAY,0,0,11.1,86,13,1015,Cloudy
5/5/2022 7:00,6,9,5213,5596,15,10809,THURSDAY,0,0,10,93,9.4,1014.9,Cloudy
5/5/2022 8:00,5,9,1357418,6996,14,1364414,THURSDAY,0,0,10,93,11.2,1015.2,Cloudy
5/5/2022 9:00,11,49,12143,36202,60,48345,THURSDAY,0,0,10,89,13,1015.7,Cloudy
5/5/2022 10:00,27,184,20597,137946,211,158543,THURSDAY,0,0,10.6,86,16.6,1015.4,Cloudy
5/5/2022 11:00,65,462,70138,345287,527,415425,THURSDAY,0,0,11.1,83,18.4,1016.1,Fair
5/5/2022 12:00,98,830,100272,610317,928,710589,THURSDAY,0,0,12.8,69,16.6,1016.8,Fair
5/5/2022 13:00,91,569,216471,416485,660,632956,THURSDAY,0,0,13.9,64,14.8,1017.4,Fair
5/5/2022 14:00,95,351,175722,249420,446,425142,THURSDAY,0,0,15.6,49,16.6,1018.1,Fair
5/5/2022 15:00,125,424,230938,325918,549,556856,THURSDAY,0,0,15.6,47,13,1017.7,Cloudy
5/5/2022 16:00,175,471,373867,353959,646,727826,THURSDAY,0,0,15,55,7.6,1017.8,Cloudy
5/5/2022 17:00,173,436,398002,328405,609,726407,THURSDAY,0,0,13.9,62,18.4,1017.3,Cloudy
5/5/2022 18:00,206,466,3434088,356217,672,3790305,THURSDAY,0,0,15.6,53,11.2,1016.9,Cloudy
5/5/2022 19:00,244,589,456893,461383,833,918276,THURSDAY,0,0,17.8,40,11.2,1016.2,Cloudy
5/5/2022 20:00,360,815,1666748,684697,1175,2351445,THURSDAY,0,0,20,28,7.6,1015.4,Cloudy
5/5/2022 21:00,478,1030,951468,890918,1508,1842386,THURSDAY,0,0,20.6,22,14.8,1015.1,Cloudy
5/5/2022 22:00,412,942,907868,877763,1354,1785631,THURSDAY,0,0,20.6,21,13,1014.8,Cloudy
5/5/2022 23:00,315,673,1093050,2234062,988,3327112,THURSDAY,0,0,19.4,23,11.2,1015.2,Cloudy
5/6/2022 0:00,175,451,1300684,339940,626,1640624,FRIDAY,0,0,14.4,49,5.4,1015.8,Cloudy
5/6/2022 1:00,127,284,130198,204795,411,334993,FRIDAY,0,0,16.7,23,9.4,1016.2,Cloudy
5/6/2022 2:00,142,224,214863,176281,366,391144,FRIDAY,0,0,16.7,22,11.2,1016,Cloudy
5/6/2022 3:00,103,139,238920,98563,242,337483,FRIDAY,0,0,15.6,25,11.2,1016.3,Cloudy
5/6/2022 4:00,93,108,416678,81752,201,498430,FRIDAY,0,0,15,25,11.2,1016.5,Cloudy
5/6/2022 5:00,98,78,150371,81942,176,232313,FRIDAY,0,0,15,25,11.2,1016.5,Cloudy
5/6/2022 6:00,42,47,52135,65671,89,117806,FRIDAY,0,0,11.7,36,5.4,1016.1,Cloudy
5/6/2022 7:00,16,26,37141,19449,42,56590,FRIDAY,0,0,10.6,36,7.6,1016.4,Cloudy
5/6/2022 8:00,6,13,4723,10717,19,15440,FRIDAY,0,0,10.6,63,5.4,1016.4,Cloudy
5/6/2022 9:00,5,39,3310,27635,44,30945,FRIDAY,0,0,11.7,48,5.4,1016.4,Cloudy
5/6/2022 10:00,14,143,14000,100494,157,114494,FRIDAY,0,0,11.7,48,5.4,1016.4,Cloudy
5/6/2022 11:00,51,362,49385,285525,413,334910,FRIDAY,0,0,12.8,45,7.6,1016.5,Cloudy
5/6/2022 12:00,71,584,87383,412754,655,500137,FRIDAY,0,0,13.9,42,7.6,1016.7,Cloudy
5/6/2022 13:00,80,450,1024698,325641,530,1350339,FRIDAY,0,0,14.4,42,9.4,1016.5,Cloudy
5/6/2022 14:00,98,357,469769,282892,455,752661,FRIDAY,0,0,15.6,36,9.4,1015.9,Cloudy
5/6/2022 15:00,144,394,244921,296035,538,540956,FRIDAY,0,0,15.6,36,9.4,1015.9,Cloudy
5/6/2022 16:00,193,455,339760,319187,648,658947,FRIDAY,0,0,14.4,44,16.6,1014.8,Cloudy
5/6/2022 17:00,191,455,390998,744007,646,1135005,FRIDAY,0,0,15,42,16.6,1014.2,Cloudy
5/6/2022 18:00,199,425,926528,321174,624,1247702,FRIDAY,0,0,15,42,16.6,1014.2,Cloudy
5/6/2022 19:00,209,500,1240727,394645,709,1635372,FRIDAY,0,0,12.8,55,18.4,1013.6,Cloudy
5/6/2022 20:00,224,646,430959,482100,870,913059,FRIDAY,0,0,12.8,55,20.5,1012.7,Cloudy
5/6/2022 21:00,308,798,578729,709636,1106,1288365,FRIDAY,0,0,12.8,55,16.6,1012.5,Cloudy
5/6/2022 22:00,303,663,2715482,535948,966,3251430,FRIDAY,0,0,11.7,55,11.2,1011.9,Cloudy
5/6/2022 23:00,199,432,324834,329503,631,654337,FRIDAY,0,0,13.3,62,9.4,1011.8,Cloudy
5/7/2022 0:00,160,300,239837,246619,460,486456,SATURDAY,1,0,13.3,62,9.4,1011.8,Cloudy
5/7/2022 1:00,135,273,369395,273042,408,642437,SATURDAY,1,0,12.8,72,9.4,1012.3,Cloudy
5/7/2022 2:00,235,251,2973888,229789,486,3203677,SATURDAY,1,0,12.2,80,13,1011.9,Cloudy
5/7/2022 3:00,188,173,1278529,123955,361,1402484,SATURDAY,1,0,11.7,83,13,1011.8,Cloudy
5/7/2022 4:00,163,131,684598,99540,294,784138,SATURDAY,1,0,11.1,86,9.4,1012.1,Cloudy
5/7/2022 5:00,262,127,1348666,136741,389,1485407,SATURDAY,1,0,11.1,86,9.4,1012.1,Cloudy
5/7/2022 6:00,78,50,382218,148424,128,530642,SATURDAY,1,0,11.1,83,0,1011.7,Cloudy
5/7/2022 7:00,18,25,20727,16838,43,37565,SATURDAY,1,0,9.4,74,20.5,1011.9,Cloudy
5/7/2022 8:00,8,15,12350,12503,23,24853,SATURDAY,1,0,8.9,80,33.5,1012.1,Cloudy
5/7/2022 9:00,5,16,2435,12968,21,15403,SATURDAY,1,0,8.9,80,38.9,1012.1,Cloudy
5/7/2022 10:00,7,48,17155,34861,55,52016,SATURDAY,1,0,8.3,80,38.9,1013.2,Cloudy
5/7/2022 11:00,23,86,60527,62573,109,123100,SATURDAY,1,0,8.3,71,40.7,1014.5,Cloudy
5/7/2022 12:00,35,184,47583,266163,219,313746,SATURDAY,1,0,9.4,59,46.4,1015,Cloudy
5/7/2022 13:00,81,227,165712,141483,308,307195,SATURDAY,1,0,9.4,56,38.9,1015.8,Cloudy
5/7/2022 14:00,128,317,233493,1150897,445,1384390,SATURDAY,1,0,9.4,56,44.6,1015.8,Cloudy
5/7/2022 15:00,167,368,608616,266248,535,874864,SATURDAY,1,0,10,56,44.6,1016.7,Cloudy
5/7/2022 16:00,177,422,392587,334746,599,727333,SATURDAY,1,0,11.1,52,38.9,1016.9,Cloudy
5/7/2022 17:00,196,421,332265,344067,617,676332,SATURDAY,1,0,10.6,54,40.7,1017,Cloudy
5/7/2022 18:00,259,412,477631,338708,671,816339,SATURDAY,1,0,9.4,52,40.7,1017.5,Cloudy
5/7/2022 19:00,215,365,1604994,292997,580,1897991,SATURDAY,1,0,9.4,52,38.9,1017.5,Cloudy
5/7/2022 20:00,215,371,384375,306289,586,690664,SATURDAY,1,0,9.4,42,40.7,1017.4,Cloudy
5/7/2022 21:00,208,405,988544,329248,613,1317792,SATURDAY,1,0,8.9,50,40.7,1017.6,Cloudy
5/7/2022 22:00,177,378,385910,270171,555,656081,SATURDAY,1,0,8.3,58,31.7,1017.8,Cloudy
5/7/2022 23:00,173,318,300539,242284,491,542823,SATURDAY,1,0,7.8,68,35.3,1017.8,Cloudy
5/8/2022 0:00,85,235,115448,161001,320,276449,SUNDAY,1,0,7.8,68,35.3,1017.8,Cloudy
5/8/2022 1:00,70,174,88973,115682,244,204655,SUNDAY,1,0,7.8,65,27.7,1019.9,Cloudy
5/8/2022 2:00,65,146,63383,96970,211,160353,SUNDAY,1,0,7.8,65,27.7,1019.9,Cloudy
5/8/2022 3:00,60,132,65100,88320,192,153420,SUNDAY,1,0,7.8,68,16.6,1019.6,Cloudy
5/8/2022 4:00,92,100,519006,72678,192,591684,SUNDAY,1,0,7.8,68,25.9,1019.7,Cloudy
5/8/2022 5:00,125,100,528190,70715,225,598905,SUNDAY,1,0,7.8,68,25.9,1019.7,Cloudy
5/8/2022 6:00,49,49,76904,43453,98,120357,SUNDAY,1,0,7.8,68,27.7,1019.4,Cloudy
5/8/2022 7:00,8,22,11703,15649,30,27352,SUNDAY,1,0,7.8,71,27.7,1019.8,Cloudy
5/8/2022 8:00,4,8,29863,5567,12,35430,SUNDAY,1,0,7.2,74,25.9,1020.1,Cloudy
5/8/2022 9:00,8,8,9331,5309,16,14640,SUNDAY,1,0,7.2,74,25.9,1020.1,Cloudy
5/8/2022 10:00,8,28,21173,27237,36,48410,SUNDAY,1,0,7.8,73,22.3,1021.8,Cloudy
5/8/2022 11:00,12,73,11829,46735,85,58564,SUNDAY,1,0,8.3,71,31.7,1022.4,Cloudy
5/8/2022 12:00,46,120,112513,86171,166,198684,SUNDAY,1,0,9.4,63,31.7,1023,Cloudy
5/8/2022 13:00,79,253,123252,289448,332,412700,SUNDAY,1,0,9.4,61,29.5,1023.7,Cloudy
5/8/2022 14:00,179,324,407150,247103,503,654253,SUNDAY,1,0,9.4,61,29.5,1023.7,Cloudy
5/8/2022 15:00,197,365,405983,322252,562,728235,SUNDAY,1,0,10.6,48,29.5,1024.4,Cloudy
5/8/2022 16:00,232,436,416049,353385,668,769434,SUNDAY,1,0,11.7,35,33.5,1024.3,Cloudy
5/8/2022 17:00,238,427,936330,489015,665,1425345,SUNDAY,1,0,11.1,44,33.5,1024.2,Cloudy
5/8/2022 18:00,245,398,537432,376274,643,913706,SUNDAY,1,0,11.1,44,33.5,1024,Cloudy
5/8/2022 19:00,316,442,1084261,376280,758,1460541,SUNDAY,1,0,11.1,44,37.1,1024,Cloudy
5/8/2022 20:00,284,390,805422,528103,674,1333525,SUNDAY,1,0,10,50,29.5,1023.9,Cloudy
5/8/2022 21:00,245,427,455497,774958,672,1230455,SUNDAY,1,0,8.9,54,25.9,1023.4,Cloudy
5/8/2022 22:00,180,396,2248567,290458,576,2539025,SUNDAY,1,0,8.9,50,24.1,1023.6,Cloudy
5/8/2022 23:00,127,361,268253,267350,488,535603,SUNDAY,1,0,8.3,48,22.3,1023.8,Cloudy
5/9/2022 0:00,71,224,88161,158954,295,247115,MONDAY,0,0,8.3,48,22.3,1023.8,Cloudy
5/9/2022 1:00,47,149,1048339,83519,196,1131858,MONDAY,0,0,6.7,60,18.4,1024.1,Cloudy
5/9/2022 2:00,34,119,44137,65307,153,109444,MONDAY,0,0,6.7,62,13,1023.9,Cloudy
5/9/2022 3:00,45,82,90817,49960,127,140777,MONDAY,0,0,6.1,70,14.8,1023.9,Cloudy
5/9/2022 4:00,15,39,25213,25965,54,51178,MONDAY,0,0,6.1,70,14.8,1023.9,Cloudy
5/9/2022 5:00,11,38,15728,26784,49,42512,MONDAY,0,0,5.6,76,18.4,1023.8,Cloudy
5/9/2022 6:00,4,11,2521,5553,15,8074,MONDAY,0,0,5.6,76,18.4,1023.6,Cloudy
5/9/2022 7:00,2,10,3242,6294,12,9536,MONDAY,0,0,5.6,73,20.5,1023.6,Cloudy
5/9/2022 8:00,7,7,5242,4034,14,9276,MONDAY,0,0,5.6,73,20.5,1023.8,Cloudy
5/9/2022 9:00,9,45,12355,29085,54,41440,MONDAY,0,0,5.6,73,20.5,1023.8,Cloudy
5/9/2022 10:00,18,152,252342,99164,170,351506,MONDAY,0,0,7.2,65,25.9,1025.4,Fair
5/9/2022 11:00,37,380,33352,286008,417,319360,MONDAY,0,0,9.4,56,29.5,1026,Cloudy
5/9/2022 12:00,67,665,93828,583137,732,676965,MONDAY,0,0,11.1,46,33.5,1026.6,Cloudy
5/9/2022 13:00,50,430,57277,287647,480,344924,MONDAY,0,0,12.2,40,33.5,1027.1,Cloudy
5/9/2022 14:00,66,337,116140,228241,403,344381,MONDAY,0,0,12.2,40,40.7,1027.1,Cloudy
5/9/2022 15:00,86,286,228332,192763,372,421095,MONDAY,0,0,13.3,42,29.5,1027.3,Cloudy
5/9/2022 16:00,123,376,200444,257035,499,457479,MONDAY,0,0,11.7,45,35.3,1027.7,Cloudy
5/9/2022 17:00,114,329,230397,241758,443,472155,MONDAY,0,0,12.8,40,33.5,1027.9,Cloudy
5/9/2022 18:00,104,356,162842,242658,460,405500,MONDAY,0,0,12.8,40,37.1,1027.9,Cloudy
5/9/2022 19:00,123,373,211044,285191,496,496235,MONDAY,0,0,12.8,37,29.5,1028.1,Cloudy
5/9/2022 20:00,151,571,387898,435273,722,823171,MONDAY,0,0,12.2,37,29.5,1028.6,Cloudy
5/9/2022 21:00,189,844,422668,666425,1033,1089093,MONDAY,0,0,12.2,28,31.7,1028.6,Fair
5/9/2022 22:00,172,757,1209671,613179,929,1822850,MONDAY,0,0,10.6,38,31.7,1028.8,Fair
5/9/2022 23:00,108,552,285318,443451,660,728769,MONDAY,0,0,10.6,38,27.7,1028.8,Fair
5/10/2022 0:00,65,310,222849,209635,375,432484,TUESDAY,0,0,9.4,46,22.3,1029.7,Fair
5/10/2022 1:00,48,183,171989,132626,231,304615,TUESDAY,0,0,9.4,46,22.3,1029.7,Fair
5/10/2022 2:00,35,156,43448,108897,191,152345,TUESDAY,0,0,9.4,46,24.1,1029.4,Fair
5/10/2022 3:00,39,101,111938,69685,140,181623,TUESDAY,0,0,10,41,24.1,1029.1,Clear
5/10/2022 4:00,20,41,64146,26290,61,90436,TUESDAY,0,0,9.4,46,25.9,1028.9,Clear
5/10/2022 5:00,13,20,11700,8381,33,20081,TUESDAY,0,0,9.4,46,25.9,1028.9,Clear
5/10/2022 6:00,7,8,8873,4295,15,13168,TUESDAY,0,0,8.3,56,24.1,1028.6,Clear
5/10/2022 7:00,5,7,7889,2781,12,10670,TUESDAY,0,0,7.8,60,20.5,1028.8,Clear
5/10/2022 8:00,7,8,6773,6617,15,13390,TUESDAY,0,0,8.3,58,22.3,1029.1,Clear
5/10/2022 9:00,13,48,8496,29625,61,38121,TUESDAY,0,0,8.3,58,22.3,1029.1,Clear
5/10/2022 10:00,19,184,16349,179902,203,196251,TUESDAY,0,0,10,54,22.3,1030.6,Clear
5/10/2022 11:00,61,476,61708,368986,537,430694,TUESDAY,0,0,11.1,46,29.5,1030.9,Clear
5/10/2022 12:00,95,858,110937,634139,953,745076,TUESDAY,0,0,12.2,43,35.3,1031.4,Fair
5/10/2022 13:00,56,494,126290,363891,550,490181,TUESDAY,0,0,12.2,43,35.3,1031.4,Fair
5/10/2022 14:00,69,368,93205,1538091,437,1631296,TUESDAY,0,0,13.9,37,27.7,1032.2,Fair
5/10/2022 15:00,105,335,1184420,242290,440,1426710,TUESDAY,0,0,13.9,39,31.7,1031.9,Fair
5/10/2022 16:00,83,419,153179,298297,502,451476,TUESDAY,0,0,13.9,39,31.7,1031.9,Fair
5/10/2022 17:00,105,368,218542,306657,473,525199,TUESDAY,0,0,13.9,36,27.7,1031.4,Fair
5/10/2022 18:00,115,390,181563,272144,505,453707,TUESDAY,0,0,13.9,36,27.7,1031.4,Fair
5/10/2022 19:00,140,470,271823,1185375,610,1457198,TUESDAY,0,0,13.3,38,25.9,1031,Fair
5/10/2022 20:00,203,674,566192,538401,877,1104593,TUESDAY,0,0,12.8,37,25.9,1030.7,Fair
5/10/2022 21:00,255,946,430192,798353,1201,1228545,TUESDAY,0,0,12.2,41,27.7,1030.4,Fair
5/10/2022 22:00,228,821,713697,726705,1049,1440402,TUESDAY,0,0,12.2,41,27.7,1030.4,Fair
5/10/2022 23:00,144,582,188420,547955,726,736375,TUESDAY,0,0,10.6,54,18.4,1030.1,Fair
5/11/2022 0:00,104,377,202953,283814,481,486767,WEDNESDAY,0,0,10,54,14.8,1030.2,Fair
5/11/2022 1:00,90,251,131772,184217,341,315989,WEDNESDAY,0,0,9.4,56,16.6,1030.3,Fair
5/11/2022 2:00,62,156,100059,109598,218,209657,WEDNESDAY,0,0,8.9,58,14.8,1029.4,Fair
5/11/2022 3:00,87,136,163898,134775,223,298673,WEDNESDAY,0,0,8.3,61,14.8,1029.2,Fair
5/11/2022 4:00,33,66,61571,35255,99,96826,WEDNESDAY,0,0,8.3,61,14.8,1029.2,Fair
5/11/2022 5:00,9,38,7822,27506,47,35328,WEDNESDAY,0,0,7.8,60,18.4,1028.4,Fair
5/11/2022 6:00,6,19,3490,13482,25,16972,WEDNESDAY,0,0,7.8,63,18.4,1027.8,Clear
5/11/2022 7:00,2,8,2038,6064,10,8102,WEDNESDAY,0,0,7.8,65,14.8,1027.6,Clear
5/11/2022 8:00,4,8,2905,23488,12,26393,WEDNESDAY,0,0,8.9,63,14.8,1027.5,Fair
5/11/2022 9:00,12,40,9615,27006,52,36621,WEDNESDAY,0,0,8.9,63,14.8,1027.5,Fair
5/11/2022 10:00,24,183,26122,143478,207,169600,WEDNESDAY,0,0,10,56,20.5,1028.6,Cloudy
5/11/2022 11:00,53,434,81655,329350,487,411005,WEDNESDAY,0,0,10.6,61,20.5,1029.1,Cloudy
5/11/2022 12:00,82,715,91477,557784,797,649261,WEDNESDAY,0,0,12.2,55,29.5,1029,Cloudy
5/11/2022 13:00,56,459,75247,312536,515,387783,WEDNESDAY,0,0,12.2,55,29.5,1029,Cloudy
5/11/2022 14:00,73,335,139282,252876,408,392158,WEDNESDAY,0,0,12.8,57,22.3,1029,Cloudy
5/11/2022 15:00,112,396,182934,275823,508,458757,WEDNESDAY,0,0,12.2,72,24.1,1028.4,Cloudy
5/11/2022 16:00,131,419,213681,301026,550,514707,WEDNESDAY,0,0,12.2,72,24.1,1027.9,Cloudy
5/11/2022 17:00,138,445,219219,342962,583,562181,WEDNESDAY,0,0,12.2,72,25.9,1027.6,Cloudy
5/11/2022 18:00,136,407,1310701,274838,543,1585539,WEDNESDAY,0,0,12.2,72,25.9,1027.6,Cloudy
5/11/2022 19:00,163,490,269446,444361,653,713807,WEDNESDAY,0,0,13.3,69,20.5,1026.8,Cloudy
5/11/2022 20:00,221,655,395321,572375,876,967696,WEDNESDAY,0,0,11.7,77,22.3,1026.8,Cloudy
5/11/2022 21:00,345,1047,529259,1685106,1392,2214365,WEDNESDAY,0,0,11.7,80,22.3,1026.9,Cloudy
5/11/2022 22:00,275,829,1804510,692292,1104,2496802,WEDNESDAY,0,0,11.7,80,22.3,1026.9,Cloudy
5/11/2022 23:00,174,606,242058,526268,780,768326,WEDNESDAY,0,0,9.4,97,18.4,1026.9,Cloudy
5/12/2022 0:00,85,382,1159032,300688,467,1459720,THURSDAY,0,0,10,93,13,1026.8,Cloudy
5/12/2022 1:00,111,293,179206,218715,404,397921,THURSDAY,0,0,10.6,89,9.4,1027.1,Cloudy
5/12/2022 2:00,122,234,277434,173740,356,451174,THURSDAY,0,0,10.6,89,9.4,1027.1,Cloudy
5/12/2022 3:00,64,106,139133,75943,170,215076,THURSDAY,0,0,10.6,96,9.4,1026.8,Cloudy
5/12/2022 4:00,27,73,55779,46914,100,102693,THURSDAY,0,0,11.1,97,5.4,1026.3,Cloudy
5/12/2022 5:00,13,40,15205,25027,53,40232,THURSDAY,0,0,11.7,96,11.2,1026.5,Cloudy
5/12/2022 6:00,10,18,11852,12998,28,24850,THURSDAY,0,0,11.7,96,11.2,1026.5,Cloudy
5/12/2022 7:00,4,14,14740,5622,18,20362,THURSDAY,0,0,11.7,100,7.6,1025.9,Cloudy
5/12/2022 8:00,8,12,9965,6659,20,16624,THURSDAY,0,0,12.2,97,9.4,1026.1,Cloudy
5/12/2022 9:00,14,40,17742,29590,54,47332,THURSDAY,0,0,12.2,97,9.4,1026.1,Cloudy
5/12/2022 10:00,20,160,17561,111165,180,128726,THURSDAY,0,0,12.2,100,14.8,1027.5,Cloudy
5/12/2022 11:00,48,383,40543,289278,431,329821,THURSDAY,0,0,12.8,100,13,1027.4,Cloudy
5/12/2022 12:00,91,709,108547,519037,800,627584,THURSDAY,0,0,12.8,100,13,1027.4,Cloudy
5/12/2022 13:00,100,497,347329,480413,597,827742,THURSDAY,0,0,13.3,97,9.4,1027.9,Cloudy
5/12/2022 14:00,98,356,213212,242197,454,455409,THURSDAY,0,0,12.2,93,16.6,1028.7,Cloudy
5/12/2022 15:00,113,375,206355,266060,488,472415,THURSDAY,0,0,12.8,89,18.4,1028.3,Cloudy
5/12/2022 16:00,142,407,306472,299595,549,606067,THURSDAY,0,0,12.8,89,18.4,1028.3,Cloudy
5/12/2022 17:00,164,394,410449,293914,558,704363,THURSDAY,0,0,13.9,83,14.8,1028,Cloudy
5/12/2022 18:00,230,373,1002753,310464,603,1313217,THURSDAY,0,0,15,81,13,1028,Cloudy
5/12/2022 19:00,226,448,449778,330152,674,779930,THURSDAY,0,0,13.3,87,18.4,1028.3,Cloudy
5/12/2022 20:00,243,661,366945,570832,904,937777,THURSDAY,0,0,12.8,87,16.6,1028.2,Cloudy
5/12/2022 21:00,381,971,1073203,883518,1352,1956721,THURSDAY,0,0,12.2,90,11.2,1027.7,Cloudy
5/12/2022 22:00,297,817,895433,658005,1114,1553438,THURSDAY,0,0,12.2,90,11.2,1027.7,Cloudy
5/12/2022 23:00,223,587,336067,468742,810,804809,THURSDAY,0,0,10.6,96,11.2,1027.4,Cloudy
5/13/2022 0:00,124,383,385300,284602,507,669902,FRIDAY,0,0,10.6,100,7.6,1027.6,Cloudy
5/13/2022 1:00,112,266,139028,388406,378,527434,FRIDAY,0,0,10.6,100,0,1027.2,Cloudy
5/13/2022 2:00,101,203,177052,177776,304,354828,FRIDAY,0,0,11.1,93,5.4,1026.6,Cloudy
5/13/2022 3:00,77,130,319059,91816,207,410875,FRIDAY,0,0,11.1,93,5.4,1026.6,Cloudy
5/13/2022 4:00,64,98,1351588,63092,162,1414680,FRIDAY,0,0,11.7,93,5.4,1026.5,Cloudy
5/13/2022 5:00,45,38,44244,25423,83,69667,FRIDAY,0,0,11.7,96,5.4,1026.6,Cloudy
5/13/2022 6:00,29,22,110928,80579,51,191507,FRIDAY,0,0,11.7,96,5.4,1026.6,Cloudy
5/13/2022 7:00,8,15,166995,13504,23,180499,FRIDAY,0,0,11.7,100,9.4,1026.7,Cloudy
5/13/2022 8:00,14,13,10325,9930,27,20255,FRIDAY,0,0,11.7,100,9.4,1026.7,Cloudy
5/13/2022 9:00,13,45,727678,30087,58,757765,FRIDAY,0,0,11.7,96,7.6,1026.2,Cloudy
5/13/2022 10:00,19,150,371461,95564,169,467025,FRIDAY,0,0,11.7,96,7.6,1026.2,Cloudy
5/13/2022 11:00,61,335,97214,237483,396,334697,FRIDAY,0,0,12.2,97,0,1026.6,Cloudy
5/13/2022 12:00,74,631,1003113,450741,705,1453854,FRIDAY,0,0,13.9,100,5.4,1027.2,Cloudy
5/13/2022 13:00,86,429,140920,307495,515,448415,FRIDAY,0,0,13.3,97,9.4,1027.6,Cloudy
5/13/2022 14:00,115,328,245908,286186,443,532094,FRIDAY,0,0,15.6,90,11.2,1027.5,Cloudy
5/13/2022 15:00,185,392,1003880,284733,577,1288613,FRIDAY,0,0,18.3,84,13,1026.9,Cloudy
5/13/2022 16:00,174,492,1463324,1671425,666,3134749,FRIDAY,0,0,18.3,84,13,1026.9,Cloudy
5/13/2022 17:00,224,499,544439,393752,723,938191,FRIDAY,0,0,18.3,78,20.5,1024.9,Cloudy
5/13/2022 18:00,279,463,1405936,371558,742,1777494,FRIDAY,0,0,18.3,78,20.5,1024.9,Cloudy
5/13/2022 19:00,338,597,779081,533377,935,1312458,FRIDAY,0,0,19.4,76,18.4,1022.6,Cloudy
5/13/2022 20:00,389,707,2373254,616685,1096,2989939,FRIDAY,0,0,19.4,73,13,1021.8,Cloudy
5/13/2022 21:00,447,816,803705,763482,1263,1567187,FRIDAY,0,0,26.1,56,13,1021.2,Cloudy
5/13/2022 22:00,382,775,1032803,710657,1157,1743460,FRIDAY,0,0,26.1,56,29.5,1021.2,Cloudy
5/13/2022 23:00,435,655,1087850,649576,1090,1737426,FRIDAY,0,0,22.2,71,27.7,1021,Cloudy
5/14/2022 0:00,253,442,595353,392748,695,988101,SATURDAY,1,0,21.1,78,20.5,1021.4,Cloudy
5/14/2022 1:00,190,268,1212417,219755,458,1432172,SATURDAY,1,0,21.1,78,20.5,1021.4,Cloudy
5/14/2022 2:00,225,259,1505363,219112,484,1724475,SATURDAY,1,0,19.4,91,18.4,1021.6,Cloudy
5/14/2022 3:00,193,218,323395,179930,411,503325,SATURDAY,1,0,19.4,91,18.4,1021.6,Cloudy
5/14/2022 4:00,178,146,935160,126309,324,1061469,SATURDAY,1,0,18.9,90,18.4,1020.8,Cloudy
5/14/2022 5:00,276,124,3846042,116743,400,3962785,SATURDAY,1,0,18.9,90,18.4,1020.1,Cloudy
5/14/2022 6:00,114,67,532220,58020,181,590240,SATURDAY,1,0,18.3,93,13,1019.8,Cloudy
5/14/2022 7:00,40,39,101279,40252,79,141531,SATURDAY,1,0,18.3,93,13,1019.8,Cloudy
5/14/2022 8:00,12,9,12183,10049,21,22232,SATURDAY,1,0,18.3,93,14.8,1019,Cloudy
5/14/2022 9:00,9,12,4524,7097,21,11621,SATURDAY,1,0,18.9,93,13,1019.4,Cloudy
5/14/2022 10:00,16,48,20106,27530,64,47636,SATURDAY,1,0,19.4,87,14.8,1019.2,Cloudy
5/14/2022 11:00,32,98,84103,76562,130,160665,SATURDAY,1,0,21.7,76,16.6,1019,Cloudy
5/14/2022 12:00,65,206,110643,184116,271,294759,SATURDAY,1,0,23.9,66,14.8,1018.6,Cloudy
5/14/2022 13:00,198,296,608117,263253,494,871370,SATURDAY,1,0,23.9,66,14.8,1018.6,Cloudy
5/14/2022 14:00,291,427,715056,457439,718,1172495,SATURDAY,1,0,27.2,49,20.5,1017.8,Cloudy
5/14/2022 15:00,404,549,1495753,540032,953,2035785,SATURDAY,1,0,28.3,46,13,1016.9,Cloudy
5/14/2022 16:00,470,584,1186692,574629,1054,1761321,SATURDAY,1,0,28.9,41,14.8,1016,Cloudy
5/14/2022 17:00,580,560,1563680,538138,1140,2101818,SATURDAY,1,0,28.9,41,14.8,1016,Cloudy
5/14/2022 18:00,534,529,1887628,562476,1063,2450104,SATURDAY,1,0,28.9,46,20.5,1014.9,Cloudy
5/14/2022 19:00,576,501,2034342,499020,1077,2533362,SATURDAY,1,0,27.8,51,18.4,1014.4,Cloudy
5/14/2022 20:00,546,513,1127308,503494,1059,1630802,SATURDAY,1,0,26.7,54,25.9,1014.2,Cloudy
5/14/2022 21:00,577,511,2256814,500047,1088,2756861,SATURDAY,1,0,26.7,54,25.9,1014.2,Cloudy
5/14/2022 22:00,513,477,1150817,472089,990,1622906,SATURDAY,1,0,26.1,56,24.1,1013.5,Cloudy
5/14/2022 23:00,400,423,1271048,1435983,823,2707031,SATURDAY,1,0,23.9,62,22.3,1013.6,Cloudy
5/15/2022 0:00,320,332,1069649,305190,652,1374839,SUNDAY,1,0,22.2,68,11.2,1014.2,Cloudy
5/15/2022 1:00,223,265,331504,211128,488,542632,SUNDAY,1,0,22.2,73,13,1014.6,Cloudy
5/15/2022 2:00,216,231,817498,231876,447,1049374,SUNDAY,1,0,20.6,84,13,1014.8,Cloudy
5/15/2022 3:00,222,184,740419,291866,406,1032285,SUNDAY,1,0,20.6,84,13,1014.8,Cloudy
5/15/2022 4:00,209,158,610894,140607,367,751501,SUNDAY,1,0,20,90,11.2,1014.1,Cloudy
5/15/2022 5:00,188,86,378328,81730,274,460058,SUNDAY,1,0,18.3,97,5.4,1013.8,Cloudy
5/15/2022 6:00,65,60,150496,56832,125,207328,SUNDAY,1,0,18.3,97,5.4,1013.8,Cloudy
5/15/2022 7:00,21,21,151718,13303,42,165021,SUNDAY,1,0,17.8,96,7.6,1013.1,Cloudy
5/15/2022 8:00,15,9,35466,9274,24,44740,SUNDAY,1,0,17.8,100,7.6,1012.7,Cloudy
5/15/2022 9:00,12,16,18642,14226,28,32868,SUNDAY,1,0,17.8,96,9.4,1012.5,Cloudy
5/15/2022 10:00,5,43,7055,32583,48,39638,SUNDAY,1,0,17.8,96,0,1012.4,Cloudy
5/15/2022 11:00,28,57,65062,48645,85,113707,SUNDAY,1,0,18.3,93,11.2,1012.4,Cloudy
5/15/2022 12:00,65,167,126385,147087,232,273472,SUNDAY,1,0,18.3,93,11.2,1012.4,Cloudy
5/15/2022 13:00,125,264,555028,237802,389,792830,SUNDAY,1,0,20.6,81,14.8,1012,Cloudy
5/15/2022 14:00,227,331,568859,317856,558,886715,SUNDAY,1,0,21.1,82,11.2,1011.7,Cloudy
5/15/2022 15:00,360,420,919891,443315,780,1363206,SUNDAY,1,0,22.2,73,13,1011.2,Cloudy
5/15/2022 16:00,416,465,970876,852612,881,1823488,SUNDAY,1,0,21.1,78,18.4,1010.4,Cloudy
5/15/2022 17:00,542,519,1352872,532469,1061,1885341,SUNDAY,1,0,21.1,78,18.4,1010.4,Cloudy
5/15/2022 18:00,535,568,1119507,571374,1103,1690881,SUNDAY,1,0,25,56,14.8,1008.9,Cloudy
5/15/2022 19:00,535,536,2496604,535030,1071,3031634,SUNDAY,1,0,25,58,20.5,1008.3,Cloudy
5/15/2022 20:00,445,459,1117615,414722,904,1532337,SUNDAY,1,0,25,58,20.5,1007.7,Cloudy
5/15/2022 21:00,444,425,1175489,438709,869,1614198,SUNDAY,1,0,24.4,60,24.1,1007.4,Cloudy
5/15/2022 22:00,553,544,1755517,497537,1097,2253054,SUNDAY,1,0,24.4,60,24.1,1007.4,Cloudy
5/15/2022 23:00,386,454,2354387,439661,840,2794048,SUNDAY,1,0,21.7,71,18.4,1007.7,Cloudy
5/16/2022 0:00,256,294,1188624,274344,550,1462968,MONDAY,0,0,20.6,73,18.4,1008.3,Cloudy
5/16/2022 1:00,163,203,332373,244544,366,576917,MONDAY,0,0,20.6,73,18.4,1008.3,Cloudy
5/16/2022 2:00,144,151,685569,112134,295,797703,MONDAY,0,0,20,76,7.6,1008.7,Cloudy
5/16/2022 3:00,91,100,164848,91269,191,256117,MONDAY,0,0,20,76,7.6,1008.7,Cloudy
5/16/2022 4:00,42,54,381094,45032,96,426126,MONDAY,0,0,17.8,87,18.4,1008,Cloudy
5/16/2022 5:00,31,24,48791,22342,55,71133,MONDAY,0,0,17.8,87,13,1007.8,Cloudy
5/16/2022 6:00,18,14,22330,12352,32,34682,MONDAY,0,0,17.2,90,9.4,1007.3,Cloudy
5/16/2022 7:00,13,11,13116,8432,24,21548,MONDAY,0,0,17.2,90,9.4,1007.3,Cloudy
5/16/2022 8:00,13,11,39428,8131,24,47559,MONDAY,0,0,16.7,93,11.2,1006.5,Cloudy
5/16/2022 9:00,21,56,21928,38011,77,59939,MONDAY,0,0,17.2,90,14.8,1007,Cloudy
5/16/2022 10:00,18,156,28891,110636,174,139527,MONDAY,0,0,17.8,87,13,1007.2,Cloudy
5/16/2022 11:00,41,383,55121,305773,424,360894,MONDAY,0,0,18.3,87,13,1007.3,Cloudy
5/16/2022 12:00,93,712,112194,560950,805,673144,MONDAY,0,0,18.3,87,13,1007.3,Cloudy
5/16/2022 13:00,85,421,123370,288254,506,411624,MONDAY,0,0,20,81,16.6,1006.8,Cloudy
5/16/2022 14:00,117,307,212164,223103,424,435267,MONDAY,0,0,15.6,86,16.6,1006.5,Cloudy
5/16/2022 15:00,153,331,496695,242297,484,738992,MONDAY,0,0,16.7,84,14.8,1006.3,Cloudy
5/16/2022 16:00,167,342,428528,237629,509,666157,MONDAY,0,0,16.7,84,14.8,1006.3,Cloudy
5/16/2022 17:00,176,369,370887,295955,545,666842,MONDAY,0,0,18.3,78,16.6,1005.4,Cloudy
5/16/2022 18:00,243,404,571647,324168,647,895815,MONDAY,0,0,19.4,71,14.8,1002.9,Cloudy
5/16/2022 19:00,231,440,509686,369522,671,879208,MONDAY,0,0,26.1,58,14.8,1001.9,Rain
5/16/2022 20:00,250,612,379980,517746,862,897726,MONDAY,0,0,25,60,27.7,1001,Rain
5/16/2022 21:00,347,990,575401,851753,1337,1427154,MONDAY,0,0,25,60,31.7,1001,Rain
5/16/2022 22:00,397,893,1039022,844845,1290,1883867,MONDAY,0,0,22.2,64,33.5,1000.6,Cloudy
5/16/2022 23:00,240,593,1491089,476095,833,1967184,MONDAY,0,0,20.6,75,29.5,1000.1,Cloudy
5/17/2022 0:00,127,343,228215,267988,470,496203,TUESDAY,0,0,20,78,24.1,1000.8,Cloudy
5/17/2022 1:00,52,119,149856,133571,171,283427,TUESDAY,0,0,17.2,93,16.6,1000.4,Cloudy
5/17/2022 2:00,26,85,20348,57572,111,77920,TUESDAY,0,0,17.2,93,16.6,1000.4,Cloudy
5/17/2022 3:00,35,63,81201,39449,98,120650,TUESDAY,0,0,17.2,93,24.1,1000.8,Cloudy
5/17/2022 4:00,45,49,273711,37168,94,310879,TUESDAY,0,0,16.7,93,20.5,1000.5,Cloudy
5/17/2022 5:00,25,16,146947,7171,41,154118,TUESDAY,0,0,16.7,93,20.5,1000.5,Cloudy
5/17/2022 6:00,6,11,6073,6702,17,12775,TUESDAY,0,0,16.1,72,25.9,1000.5,Cloudy
5/17/2022 7:00,4,7,2006,10698,11,12704,TUESDAY,0,0,16.1,72,25.9,1000.5,Cloudy
5/17/2022 8:00,5,11,7807,9614,16,17421,TUESDAY,0,0,15,67,27.7,1002.1,Cloudy
5/17/2022 9:00,9,58,8077,43451,67,51528,TUESDAY,0,0,14.4,70,22.3,1002.6,Cloudy
5/17/2022 10:00,23,212,26851,148789,235,175640,TUESDAY,0,0,15,62,27.7,1003.5,Fair
5/17/2022 11:00,52,465,1306675,367467,517,1674142,TUESDAY,0,0,16.7,56,27.7,1003.9,Fair
5/17/2022 12:00,106,881,140469,719120,987,859589,TUESDAY,0,0,16.7,56,27.7,1003.9,Fair
5/17/2022 13:00,132,475,226341,329825,607,556166,TUESDAY,0,0,19.4,45,33.5,1004,Fair
5/17/2022 14:00,92,348,242472,278765,440,521237,TUESDAY,0,0,20.6,39,35.3,1003.6,Fair
5/17/2022 15:00,156,385,255620,283930,541,539550,TUESDAY,0,0,22.2,34,38.9,1003.4,Fair
5/17/2022 16:00,156,438,264267,337368,594,601635,TUESDAY,0,0,22.2,35,33.5,1002.9,Fair
5/17/2022 17:00,135,337,365061,226928,472,591989,TUESDAY,0,0,22.2,35,29.5,1002.9,Fair
5/17/2022 18:00,158,393,285317,301549,551,586866,TUESDAY,0,0,20,45,27.7,1003,Fair
5/17/2022 19:00,203,489,412376,392844,692,805220,TUESDAY,0,0,22.8,37,24.1,1002.6,Fair
5/17/2022 20:00,232,695,3417369,560378,927,3977747,TUESDAY,0,0,22.2,31,37.1,1003.1,Fair
5/17/2022 21:00,358,1074,1731417,965813,1432,2697230,TUESDAY,0,0,22.2,31,37.1,1003.1,Fair
5/17/2022 22:00,308,915,887449,775640,1223,1663089,TUESDAY,0,0,20,31,38.9,1005,Cloudy
5/17/2022 23:00,288,620,1510405,487607,908,1998012,TUESDAY,0,0,18.9,34,31.7,1006.2,Fair
5/18/2022 0:00,166,362,776071,266888,528,1042959,WEDNESDAY,0,0,17.8,38,29.5,1007.1,Fair
5/18/2022 1:00,148,251,278899,184999,399,463898,WEDNESDAY,0,0,17.2,40,29.5,1007.7,Fair
5/18/2022 2:00,124,221,198077,282408,345,480485,WEDNESDAY,0,0,16.1,44,37.1,1008.1,Fair
5/18/2022 3:00,66,123,1346414,94349,189,1440763,WEDNESDAY,0,0,16.1,44,33.5,1008.1,Fair
5/18/2022 4:00,29,48,118598,53629,77,172227,WEDNESDAY,0,0,15,51,27.7,1008.5,Fair
5/18/2022 5:00,21,34,28416,23202,55,51618,WEDNESDAY,0,0,14.4,56,24.1,1008.4,Fair
5/18/2022 6:00,8,13,8989,10459,21,19448,WEDNESDAY,0,0,13.3,60,20.5,1008.5,Fair
5/18/2022 7:00,10,6,15488,4508,16,19996,WEDNESDAY,0,0,13.3,60,20.5,1008.5,Fair
5/18/2022 8:00,4,9,3717,19332,13,23049,WEDNESDAY,0,0,12.2,64,18.4,1009.8,Fair
5/18/2022 9:00,11,65,8170,46356,76,54526,WEDNESDAY,0,0,12.2,57,22.3,1010.5,Fair
5/18/2022 10:00,23,187,23553,145963,210,169516,WEDNESDAY,0,0,13.3,49,22.3,1010.9,Fair
5/18/2022 11:00,75,449,97430,344670,524,442100,WEDNESDAY,0,0,13.3,49,22.3,1010.9,Fair
5/18/2022 12:00,103,870,115902,677645,973,793547,WEDNESDAY,0,0,15,39,31.7,1011.4,Fair
5/18/2022 13:00,88,500,139251,379302,588,518553,WEDNESDAY,0,0,16.1,31,27.7,1011.7,Fair
5/18/2022 14:00,119,348,259123,239210,467,498333,WEDNESDAY,0,0,17.2,27,25.9,1012.3,Fair
5/18/2022 15:00,125,375,897306,279885,500,1177191,WEDNESDAY,0,0,18.9,21,27.7,1011.8,Fair
5/18/2022 16:00,154,392,550682,299447,546,850129,WEDNESDAY,0,0,18.9,21,27.7,1011.8,Fair
5/18/2022 17:00,169,430,1744268,333819,599,2078087,WEDNESDAY,0,0,21.1,18,25.9,1011,Fair
5/18/2022 18:00,225,443,433785,352378,668,786163,WEDNESDAY,0,0,22.2,17,20.5,1010.6,Fair
5/18/2022 19:00,263,521,898128,394815,784,1292943,WEDNESDAY,0,0,22.2,17,14.8,1010.6,Fair
5/18/2022 20:00,321,737,2331458,616643,1058,2948101,WEDNESDAY,0,0,22.2,17,5.4,1010.6,Fair
5/18/2022 21:00,460,1123,800370,1004477,1583,1804847,WEDNESDAY,0,0,22.2,17,5.4,1010.6,Fair
5/18/2022 22:00,354,899,1599774,1473861,1253,3073635,WEDNESDAY,0,0,21.1,15,13,1010.9,Cloudy
5/18/2022 23:00,258,650,464427,633091,908,1097518,WEDNESDAY,0,0,21.1,44,9.4,1011,Cloudy
5/19/2022 0:00,211,404,457117,327595,615,784712,THURSDAY,0,0,15.6,44,9.4,1011,Cloudy
5/19/2022 1:00,203,330,349349,276633,533,625982,THURSDAY,0,0,14.4,51,5.4,1011.5,Cloudy
5/19/2022 2:00,130,209,182913,172003,339,354916,THURSDAY,0,0,14.4,51,5.4,1011.5,Cloudy
5/19/2022 3:00,79,147,128809,133496,226,262305,THURSDAY,0,0,16.1,44,0,1011.8,Cloudy
5/19/2022 4:00,32,67,26025,52339,99,78364,THURSDAY,0,0,16.1,50,9.4,1012,Cloudy
5/19/2022 5:00,29,35,39027,20288,64,59315,THURSDAY,0,0,16.1,42,7.6,1011.7,Cloudy
5/19/2022 6:00,10,17,16977,72055,27,89032,THURSDAY,0,0,15.6,41,5.4,1011.4,Cloudy
5/19/2022 7:00,6,14,10418,14691,20,25109,THURSDAY,0,0,15.6,41,5.4,1011.4,Cloudy
5/19/2022 8:00,6,7,13661,6618,13,20279,THURSDAY,0,0,16.7,35,5.4,1011.8,Cloudy
5/19/2022 9:00,7,51,4483,32143,58,36626,THURSDAY,0,0,16.7,35,5.4,1011.8,Cloudy
5/19/2022 10:00,17,152,16444,93040,169,109484,THURSDAY,0,0,15,47,7.6,1011,Cloudy
5/19/2022 11:00,36,312,24919,220138,348,245057,THURSDAY,0,0,15,47,7.6,1011,Cloudy
5/19/2022 12:00,80,635,76047,467796,715,543843,THURSDAY,0,0,13.9,64,13,1010.7,Rain
5/19/2022 13:00,87,444,158608,294105,531,452713,THURSDAY,0,0,13.9,57,9.4,1010.4,Rain
5/19/2022 14:00,66,276,115590,177249,342,292839,THURSDAY,0,0,13.9,57,9.4,1010.4,Rain
5/19/2022 15:00,52,196,69482,119612,248,189094,THURSDAY,0,0,13.9,77,14.8,1009.4,Rain
5/19/2022 16:00,83,325,96256,203281,408,299537,THURSDAY,0,0,13.9,74,18.4,1008.2,Rain
5/19/2022 17:00,117,329,250483,349488,446,599971,THURSDAY,0,0,13.3,77,18.4,1007.4,Rain
5/19/2022 18:00,104,376,599048,250825,480,849873,THURSDAY,0,0,13.3,80,14.8,1006.7,Rain
5/19/2022 19:00,149,433,248604,298738,582,547342,THURSDAY,0,0,13.3,80,14.8,1006.7,Rain
5/19/2022 20:00,193,566,345897,454456,759,800353,THURSDAY,0,0,13.3,87,13,1006,Rain
5/19/2022 21:00,188,791,222951,669348,979,892299,THURSDAY,0,0,13.3,87,13,1006,Rain
5/19/2022 22:00,226,616,321158,478494,842,799652,THURSDAY,0,0,11.7,96,13,1006.7,Cloudy
5/19/2022 23:00,137,474,171317,353185,611,524502,THURSDAY,0,0,12.2,97,5.4,1006.9,Cloudy
5/20/2022 0:00,103,338,179255,255897,441,435152,FRIDAY,0,0,12.2,97,5.4,1006.9,Cloudy
5/20/2022 1:00,86,212,104993,145276,298,250269,FRIDAY,0,0,13.3,90,14.8,1007.9,Cloudy
5/20/2022 2:00,105,198,253551,711253,303,964804,FRIDAY,0,0,13.3,90,14.8,1007.9,Cloudy
5/20/2022 3:00,99,147,127367,112468,246,239835,FRIDAY,0,0,13.9,87,9.4,1008.5,Cloudy
5/20/2022 4:00,46,76,68480,52559,122,121039,FRIDAY,0,0,13.3,90,11.2,1009.2,Fair
5/20/2022 5:00,38,33,53709,28483,71,82192,FRIDAY,0,0,13.9,87,9.4,1009.9,Fair
5/20/2022 6:00,23,15,30192,72631,38,102823,FRIDAY,0,0,13.3,87,5.4,1010.5,Fair
5/20/2022 7:00,8,11,8210,9868,19,18078,FRIDAY,0,0,13.3,87,5.4,1010.5,Fair
5/20/2022 8:00,13,10,12627,5054,23,17681,FRIDAY,0,0,11.7,93,5.4,1011.1,Cloudy
5/20/2022 9:00,5,48,3168,44583,53,47751,FRIDAY,0,0,12.2,97,9.4,1012.1,Cloudy
5/20/2022 10:00,25,163,31370,124743,188,156113,FRIDAY,0,0,11.1,100,9.4,1014.2,Cloudy
5/20/2022 11:00,63,345,146776,291354,408,438130,FRIDAY,0,0,11.1,100,18.4,1014.2,Cloudy
5/20/2022 12:00,80,580,90015,439879,660,529894,FRIDAY,0,0,11.1,100,13,1016,Cloudy
5/20/2022 13:00,83,429,129820,309693,512,439513,FRIDAY,0,0,11.7,93,14.8,1017.1,Cloudy
5/20/2022 14:00,104,292,1472668,213566,396,1686234,FRIDAY,0,0,12.2,90,11.2,1017.1,Cloudy
5/20/2022 15:00,157,389,337044,287591,546,624635,FRIDAY,0,0,13.3,87,13,1017.7,Cloudy
5/20/2022 16:00,222,457,592707,337329,679,930036,FRIDAY,0,0,14.4,81,20.5,1017.6,Cloudy
5/20/2022 17:00,245,426,440793,352708,671,793501,FRIDAY,0,0,14.4,81,22.3,1017.1,Cloudy
5/20/2022 18:00,268,444,937611,380915,712,1318526,FRIDAY,0,0,15,78,24.1,1016.7,Cloudy
5/20/2022 19:00,299,511,660553,404093,810,1064646,FRIDAY,0,0,15,78,24.1,1016.7,Cloudy
5/20/2022 20:00,391,671,625366,579987,1062,1205353,FRIDAY,0,0,13.9,83,25.9,1016.1,Fair
5/20/2022 21:00,435,825,1099473,726761,1260,1826234,FRIDAY,0,0,15.6,80,13,1016,Fair
5/20/2022 22:00,449,696,1973758,690831,1145,2664589,FRIDAY,0,0,16.1,78,5.4,1016,Cloudy
5/20/2022 23:00,331,526,1594727,458494,857,2053221,FRIDAY,0,0,16.1,78,5.4,1016,Cloudy
5/21/2022 0:00,181,333,434141,311092,514,745233,SATURDAY,1,0,17.8,78,16.6,1017.3,Cloudy
5/21/2022 1:00,190,293,324155,246031,483,570186,SATURDAY,1,0,17.8,78,16.6,1017.3,Cloudy
5/21/2022 2:00,224,228,553192,175837,452,729029,SATURDAY,1,0,16.1,81,16.6,1017.8,Cloudy
5/21/2022 3:00,178,187,928966,146225,365,1075191,SATURDAY,1,0,13.3,87,20.5,1017.2,Cloudy
5/21/2022 4:00,91,105,152989,88991,196,241980,SATURDAY,1,0,13.3,87,20.5,1017.2,Rain
5/21/2022 5:00,139,104,1125826,125664,243,1251490,SATURDAY,1,0,12.8,96,9.4,1016.3,Rain
5/21/2022 6:00,42,57,57951,92844,99,150795,SATURDAY,1,0,12.8,93,9.4,1015.9,Rain
5/21/2022 7:00,9,23,9472,21370,32,30842,SATURDAY,1,0,12.8,93,9.4,1015.9,Rain
5/21/2022 8:00,7,8,8440,6164,15,14604,SATURDAY,1,0,13.3,93,7.6,1015.5,Rain
5/21/2022 9:00,3,17,2462,15806,20,18268,SATURDAY,1,0,13.3,97,5.4,1014.9,Rain
5/21/2022 10:00,9,43,15148,32337,52,47485,SATURDAY,1,0,13.9,96,7.6,1015.6,Cloudy
5/21/2022 11:00,30,88,49602,80614,118,130216,SATURDAY,1,0,14.4,97,11.2,1016.3,Cloudy
5/21/2022 12:00,59,172,117616,171459,231,289075,SATURDAY,1,0,16.1,97,5.4,1016.6,Cloudy
5/21/2022 13:00,144,291,328715,278499,435,607214,SATURDAY,1,0,16.1,97,5.4,1016.6,Cloudy
5/21/2022 14:00,205,326,1255271,278179,531,1533450,SATURDAY,1,0,16.7,96,9.4,1016.7,Cloudy
5/21/2022 15:00,341,438,728244,422413,779,1150657,SATURDAY,1,0,16.7,90,7.6,1017.1,Cloudy
5/21/2022 16:00,420,488,1050368,431080,908,1481448,SATURDAY,1,0,20,81,13,1016.2,Cloudy
5/21/2022 17:00,530,484,1217949,451886,1014,1669835,SATURDAY,1,0,20.6,75,11.2,1015.9,Cloudy
5/21/2022 18:00,560,482,2443654,494268,1042,2937922,SATURDAY,1,0,20.6,75,11.2,1015.9,Cloudy
5/21/2022 19:00,607,485,2209656,861846,1092,3071502,SATURDAY,1,0,21.1,76,14.8,1015.5,Cloudy
5/21/2022 20:00,507,560,2215184,545761,1067,2760945,SATURDAY,1,0,16.7,86,14.8,1015.5,Cloudy
5/21/2022 21:00,493,478,1012752,563725,971,1576477,SATURDAY,1,0,16.7,90,14.8,1014.9,Cloudy
5/21/2022 22:00,511,532,2401373,591293,1043,2992666,SATURDAY,1,0,17.2,90,9.4,1014.9,Fair
5/21/2022 23:00,611,472,1445557,459021,1083,1904578,SATURDAY,1,0,17.2,90,9.4,1014.9,Cloudy
5/22/2022 0:00,352,383,689231,336199,735,1025430,SUNDAY,1,0,15.6,90,11.2,1014.9,Cloudy
5/22/2022 1:00,248,242,1153145,210230,490,1363375,SUNDAY,1,0,15.6,93,0,1015.5,Cloudy
5/22/2022 2:00,214,191,1013837,175274,405,1189111,SUNDAY,1,0,16.1,87,9.4,1016.2,Fair
5/22/2022 3:00,307,238,857274,195606,545,1052880,SUNDAY,1,0,16.1,87,9.4,1016.2,Fair
5/22/2022 4:00,219,156,514908,198948,375,713856,SUNDAY,1,0,18.3,87,5.4,1016.2,Fair
5/22/2022 5:00,240,117,1194643,102373,357,1297016,SUNDAY,1,0,19.4,87,7.6,1015.7,Fair
5/22/2022 6:00,130,77,413388,78782,207,492170,SUNDAY,1,0,20.6,84,5.4,1015.3,Fair
5/22/2022 7:00,30,23,50218,28307,53,78525,SUNDAY,1,0,20.6,84,0,1015.3,Fair
5/22/2022 8:00,6,19,8198,16360,25,24558,SUNDAY,1,0,16.7,90,13,1015.4,Fair
5/22/2022 9:00,12,19,8058,20702,31,28760,SUNDAY,1,0,13.9,96,13,1015.4,Fair
5/22/2022 10:00,20,39,39791,29838,59,69629,SUNDAY,1,0,15,90,5.4,1016,Fair
5/22/2022 11:00,60,105,101421,87812,165,189233,SUNDAY,1,0,16.1,84,7.6,1016.2,Fair
5/22/2022 12:00,123,239,301451,254414,362,555865,SUNDAY,1,0,17.8,81,7.6,1016.1,Fair
5/22/2022 13:00,217,283,564130,242883,500,807013,SUNDAY,1,0,17.8,81,11.2,1015.7,Fair
5/22/2022 14:00,356,324,847166,496709,680,1343875,SUNDAY,1,0,20,76,11.2,1015.7,Fair
5/22/2022 15:00,436,414,891637,428563,850,1320200,SUNDAY,1,0,18.9,75,20.5,1014.9,Fair
5/22/2022 16:00,466,474,2783318,436223,940,3219541,SUNDAY,1,0,18.9,73,16.6,1014.4,Fair
5/22/2022 17:00,481,495,1048117,492865,976,1540982,SUNDAY,1,0,20,70,14.8,1013.3,Fair
5/22/2022 18:00,452,427,2962546,430821,879,3393367,SUNDAY,1,0,20,70,14.8,1013.3,Cloudy
5/22/2022 19:00,473,430,1067184,402459,903,1469643,SUNDAY,1,0,31.1,50,22.3,1010.9,Cloudy
5/22/2022 20:00,434,477,1082328,464066,911,1546394,SUNDAY,1,0,31.1,50,22.3,1010.9,Cloudy
5/22/2022 21:00,462,456,1268200,423544,918,1691744,SUNDAY,1,0,29.4,63,22.3,1010.8,Cloudy
5/22/2022 22:00,402,429,1886702,367648,831,2254350,SUNDAY,1,0,25,71,14.8,1011.4,Cloudy
5/22/2022 23:00,416,445,1798470,491994,861,2290464,SUNDAY,1,0,25,71,14.8,1011.4,Cloudy
5/23/2022 0:00,339,336,912607,320180,675,1232787,MONDAY,0,0,25,71,22.3,1012.6,Cloudy
5/23/2022 1:00,176,228,320103,190684,404,510787,MONDAY,0,0,24.4,67,29.5,1014.9,Cloudy
5/23/2022 2:00,119,143,620899,109893,262,730792,MONDAY,0,0,22.8,76,18.4,1014.8,Cloudy
5/23/2022 3:00,75,105,266725,71972,180,338697,MONDAY,0,0,22.8,76,18.4,1014.8,Cloudy
5/23/2022 4:00,37,58,51939,46536,95,98475,MONDAY,0,0,22.2,79,11.2,1014,Cloudy
5/23/2022 5:00,33,29,357936,23308,62,381244,MONDAY,0,0,21.7,81,13,1014.6,Cloudy
5/23/2022 6:00,16,19,26126,12715,35,38841,MONDAY,0,0,21.1,84,20.5,1015.5,Cloudy
5/23/2022 7:00,9,8,7995,8247,17,16242,MONDAY,0,0,18.9,75,24.1,1016.8,Cloudy
5/23/2022 8:00,6,12,6066,9707,18,15773,MONDAY,0,0,18.9,75,24.1,1016.8,Cloudy
5/23/2022 9:00,23,49,63651,35564,72,99215,MONDAY,0,0,17.8,70,24.1,1017.7,Cloudy
5/23/2022 10:00,17,173,28334,129128,190,157462,MONDAY,0,0,16.7,58,24.1,1019.7,Cloudy
5/23/2022 11:00,59,429,56787,398603,488,455390,MONDAY,0,0,16.7,56,24.1,1020.2,Cloudy
5/23/2022 12:00,96,689,116086,515701,785,631787,MONDAY,0,0,16.7,56,25.9,1020.2,Cloudy
5/23/2022 13:00,92,517,135300,369301,609,504601,MONDAY,0,0,16.7,56,20.5,1021,Cloudy
5/23/2022 14:00,121,314,228968,251469,435,480437,MONDAY,0,0,18.9,52,16.6,1021.7,Cloudy
5/23/2022 15:00,139,359,313442,280048,498,593490,MONDAY,0,0,18.9,59,16.6,1021.8,Cloudy
5/23/2022 16:00,225,420,486034,279494,645,765528,MONDAY,0,0,19.4,57,16.6,1021.4,Cloudy
5/23/2022 17:00,184,424,964455,308068,608,1272523,MONDAY,0,0,18.9,45,16.6,1021.4,Cloudy
5/23/2022 18:00,195,385,470580,322205,580,792785,MONDAY,0,0,18.9,45,27.7,1021.4,Cloudy
5/23/2022 19:00,204,444,379185,363235,648,742420,MONDAY,0,0,17.2,54,20.5,1021.5,Cloudy
5/23/2022 20:00,261,630,545997,532213,891,1078210,MONDAY,0,0,16.7,54,16.6,1021.6,Cloudy
5/23/2022 21:00,363,998,581975,839541,1361,1421516,MONDAY,0,0,16.1,54,13,1021.7,Cloudy
5/23/2022 22:00,289,880,917823,672548,1169,1590371,MONDAY,0,0,15,53,11.2,1022.2,Cloudy
5/23/2022 23:00,244,623,344282,529005,867,873287,MONDAY,0,0,15,53,11.2,1022.2,Cloudy
5/24/2022 0:00,183,448,303331,363804,631,667135,TUESDAY,0,0,15.6,46,0,1023.5,Cloudy
5/24/2022 1:00,98,251,218031,188506,349,406537,TUESDAY,0,0,16.7,36,0,1024.1,Cloudy
5/24/2022 2:00,67,161,96676,121891,228,218567,TUESDAY,0,0,16.1,39,0,1024.2,Cloudy
5/24/2022 3:00,116,145,206578,105282,261,311860,TUESDAY,0,0,16.1,39,0,1024.2,Cloudy
5/24/2022 4:00,24,49,48879,35585,73,84464,TUESDAY,0,0,13.9,69,5.4,1024.9,Cloudy
5/24/2022 5:00,20,20,18825,19218,40,38043,TUESDAY,0,0,12.8,77,13,1025.3,Cloudy
5/24/2022 6:00,12,12,27925,154715,24,182640,TUESDAY,0,0,13.9,59,24.1,1025.9,Cloudy
5/24/2022 7:00,5,7,6599,4946,12,11545,TUESDAY,0,0,13.3,53,24.1,1026.2,Cloudy
5/24/2022 8:00,3,8,3579,5660,11,9239,TUESDAY,0,0,13.3,53,31.7,1026.2,Cloudy
5/24/2022 9:00,12,64,13980,43755,76,57735,TUESDAY,0,0,12.2,61,18.4,1027,Cloudy
5/24/2022 10:00,23,195,24917,132893,218,157810,TUESDAY,0,0,12.8,57,22.3,1027.3,Cloudy
5/24/2022 11:00,77,496,74430,402531,573,476961,TUESDAY,0,0,13.3,55,16.6,1027.7,Cloudy
5/24/2022 12:00,119,846,218405,630448,965,848853,TUESDAY,0,0,13.3,53,18.4,1028.2,Cloudy
5/24/2022 13:00,87,509,170498,407094,596,577592,TUESDAY,0,0,13.3,53,18.4,1028.2,Cloudy
5/24/2022 14:00,103,354,197169,266980,457,464149,TUESDAY,0,0,15,53,18.4,1028.3,Cloudy
5/24/2022 15:00,140,381,333267,362180,521,695447,TUESDAY,0,0,15,53,18.4,1028.3,Cloudy
5/24/2022 16:00,153,440,355175,321940,593,677115,TUESDAY,0,0,16,53,24.1,1028,Cloudy
5/24/2022 17:00,164,386,1073776,281187,550,1354963,TUESDAY,0,0,15.4,52,16.6,1028,Cloudy
5/24/2022 18:00,198,406,357705,312443,604,670148,TUESDAY,0,0,13.9,64,20.5,1027.6,Cloudy
5/24/2022 19:00,197,512,458102,656050,709,1114152,TUESDAY,0,0,13.9,69,20.5,1027.8,Cloudy
5/24/2022 20:00,275,701,2716712,586997,976,3303709,TUESDAY,0,0,13.3,72,22.3,1027.5,Cloudy
5/24/2022 21:00,342,1049,961905,892041,1391,1853946,TUESDAY,0,0,12.8,77,20.5,1027.3,Cloudy
5/24/2022 22:00,356,873,912684,762435,1229,1675119,TUESDAY,0,0,12.8,77,20.5,1027.3,Cloudy
5/24/2022 23:00,222,587,508346,663809,809,1172155,TUESDAY,0,0,12.2,75,16.6,1027.4,Cloudy
5/25/2022 0:00,120,428,158345,390934,548,549279,WEDNESDAY,0,0,12.2,75,14.8,1027.7,Cloudy
5/25/2022 1:00,85,256,593005,207875,341,800880,WEDNESDAY,0,0,11.7,71,13,1028.2,Cloudy
5/25/2022 2:00,85,172,106554,120976,257,227530,WEDNESDAY,0,0,11.7,71,9.4,1028.3,Fair
5/25/2022 3:00,55,137,147109,103249,192,250358,WEDNESDAY,0,0,11.7,71,9.4,1028.3,Fair
5/25/2022 4:00,31,57,38050,44934,88,82984,WEDNESDAY,0,0,11.1,74,7.6,1028.3,Fair
5/25/2022 5:00,15,30,17580,19206,45,36786,WEDNESDAY,0,0,11.1,69,7.6,1027.9,Fair
5/25/2022 6:00,6,15,6406,11497,21,17903,WEDNESDAY,0,0,11.1,69,7.6,1028,Fair
5/25/2022 7:00,3,4,3828,2840,7,6668,WEDNESDAY,0,0,11.1,71,11.2,1028.1,Fair
5/25/2022 8:00,2,10,2430,6131,12,8561,WEDNESDAY,0,0,11.1,71,11.2,1028.1,Cloudy
5/25/2022 9:00,13,61,7343,424374,74,431717,WEDNESDAY,0,0,10.6,77,5.4,1029,Cloudy
5/25/2022 10:00,31,223,33670,167824,254,201494,WEDNESDAY,0,0,12.2,75,9.4,1029.2,Cloudy
5/25/2022 11:00,69,474,65263,353237,543,418500,WEDNESDAY,0,0,12.8,74,9.4,1029.4,Cloudy
5/25/2022 12:00,129,833,142359,654777,962,797136,WEDNESDAY,0,0,12.8,74,9.4,1029.4,Cloudy
5/25/2022 13:00,134,579,225425,432648,713,658073,WEDNESDAY,0,0,15.6,55,16.6,1029.8,Cloudy
5/25/2022 14:00,92,363,152927,299364,455,452291,WEDNESDAY,0,0,17.2,52,13,1029.6,Cloudy
5/25/2022 15:00,169,380,354906,305830,549,660736,WEDNESDAY,0,0,16.7,52,22.3,1029.3,Cloudy
5/25/2022 16:00,156,434,347262,1035340,590,1382602,WEDNESDAY,0,0,17.2,52,22.3,1028.9,Cloudy
5/25/2022 17:00,178,431,348129,323301,609,671430,WEDNESDAY,0,0,17.2,52,25.9,1028.9,Cloudy
5/25/2022 18:00,184,432,368623,770476,616,1139099,WEDNESDAY,0,0,17.8,50,27.7,1028,Cloudy
5/25/2022 19:00,202,459,886372,385133,661,1271505,WEDNESDAY,0,0,17.2,54,31.7,1027.5,Cloudy
5/25/2022 20:00,240,706,1411361,829098,946,2240459,WEDNESDAY,0,0,17.2,54,31.7,1027.1,Cloudy
5/25/2022 21:00,366,1101,812512,1010329,1467,1822841,WEDNESDAY,0,0,17.2,54,31.7,1027.1,Cloudy
5/25/2022 22:00,348,874,1184872,814948,1222,1999820,WEDNESDAY,0,0,20.6,45,22.3,1026.5,Cloudy
5/25/2022 23:00,304,728,622818,632323,1032,1255141,WEDNESDAY,0,0,16.7,50,24.1,1027.2,Cloudy
5/26/2022 0:00,168,429,235041,338491,597,573532,THURSDAY,0,0,15,55,24.1,1027.6,Cloudy
5/26/2022 1:00,85,310,487280,241683,395,728963,THURSDAY,0,0,13.9,55,16.6,1028,Cloudy
5/26/2022 2:00,80,199,93278,160217,279,253495,THURSDAY,0,0,13.3,53,16.6,1028,Cloudy
5/26/2022 3:00,62,154,60474,95312,216,155786,THURSDAY,0,0,13.3,53,16.6,1028,Cloudy
5/26/2022 4:00,29,52,66389,29691,81,96080,THURSDAY,0,0,12.2,57,13,1028.3,Cloudy
5/26/2022 5:00,18,19,49098,11946,37,61044,THURSDAY,0,0,11.7,59,14.8,1027.9,Cloudy
5/26/2022 6:00,8,11,8502,36825,19,45327,THURSDAY,0,0,11.7,61,11.2,1028,Cloudy
5/26/2022 7:00,4,11,5157,10522,15,15679,THURSDAY,0,0,11.7,61,11.2,1028,Cloudy
5/26/2022 8:00,3,10,3453,5864,13,9317,THURSDAY,0,0,10.6,71,11.2,1028.1,Cloudy
5/26/2022 9:00,9,57,10074,47300,66,57374,THURSDAY,0,0,11.1,69,11.2,1027.8,Cloudy
5/26/2022 10:00,37,206,48785,138225,243,187010,THURSDAY,0,0,11.7,71,11.2,1028.1,Cloudy
5/26/2022 11:00,90,475,98303,364368,565,462671,THURSDAY,0,0,13.9,59,11.2,1028.1,Cloudy
5/26/2022 12:00,126,835,219709,617990,961,837699,THURSDAY,0,0,15,51,11.2,1027.8,Cloudy
5/26/2022 13:00,107,498,159576,394353,605,553929,THURSDAY,0,0,15,51,11.2,1027.8,Cloudy
5/26/2022 14:00,131,380,282852,285665,511,568517,THURSDAY,0,0,19.4,37,18.4,1026.6,Cloudy
5/26/2022 15:00,176,389,447802,341716,565,789518,THURSDAY,0,0,21.7,34,24.1,1025.7,Cloudy
5/26/2022 16:00,184,396,313519,317982,580,631501,THURSDAY,0,0,21.7,31,24.1,1024.8,Cloudy
5/26/2022 17:00,183,393,327851,294702,576,622553,THURSDAY,0,0,21.7,31,24.1,1024.8,Cloudy
5/26/2022 18:00,219,425,413757,351877,644,765634,THURSDAY,0,0,20,40,25.9,1023,Cloudy
5/26/2022 19:00,261,525,444217,434164,786,878381,THURSDAY,0,0,21.1,42,24.1,1021.9,Cloudy
5/26/2022 20:00,348,717,595787,596316,1065,1192103,THURSDAY,0,0,20.6,47,27.7,1021.3,Cloudy
5/26/2022 21:00,468,1097,811515,962276,1565,1773791,THURSDAY,0,0,19.4,52,27.7,1021.2,Cloudy
5/26/2022 22:00,414,922,1624715,761660,1336,2386375,THURSDAY,0,0,19.4,52,27.7,1021.2,Cloudy
5/26/2022 23:00,318,632,1174179,536989,950,1711168,THURSDAY,0,0,17.2,67,24.1,1019.9,Cloudy
5/27/2022 0:00,181,422,465790,342483,603,808273,FRIDAY,0,0,16.7,72,24.1,1019.9,Cloudy
5/27/2022 1:00,120,311,437010,250550,431,687560,FRIDAY,0,0,16.1,78,24.1,1020.1,Cloudy
5/27/2022 2:00,123,257,205981,202875,380,408856,FRIDAY,0,0,16.1,78,24.1,1020.1,Cloudy
5/27/2022 3:00,142,183,305425,154909,325,460334,FRIDAY,0,0,15.6,83,20.5,1018.9,Cloudy
5/27/2022 4:00,55,87,59665,100254,142,159919,FRIDAY,0,0,16.1,81,25.9,1018.3,Cloudy
5/27/2022 5:00,57,64,71165,46126,121,117291,FRIDAY,0,0,16.1,84,16.6,1017.9,Cloudy
5/27/2022 6:00,22,26,29566,17890,48,47456,FRIDAY,0,0,16.1,84,16.6,1017.9,Cloudy
5/27/2022 7:00,12,15,19488,13090,27,32578,FRIDAY,0,0,15.6,90,14.8,1017.2,Cloudy
5/27/2022 8:00,10,12,691932,7633,22,699565,FRIDAY,0,0,16.1,90,9.4,1016.6,Cloudy
5/27/2022 9:00,14,53,15105,39282,67,54387,FRIDAY,0,0,17.8,90,16.6,1015.8,Cloudy
5/27/2022 10:00,19,149,17559,112634,168,130193,FRIDAY,0,0,17.8,90,16.6,1015.8,Cloudy
5/27/2022 11:00,62,300,76794,229200,362,305994,FRIDAY,0,0,20,87,24.1,1015.5,Cloudy
5/27/2022 12:00,104,620,166148,470860,724,637008,FRIDAY,0,0,20,87,24.1,1015.5,Cloudy
5/27/2022 13:00,134,429,219211,342114,563,561325,FRIDAY,0,0,22.2,79,20.5,1014.4,Cloudy
5/27/2022 14:00,188,350,388281,271917,538,660198,FRIDAY,0,0,22.2,79,24.1,1014,Cloudy
5/27/2022 15:00,241,369,588511,288917,610,877428,FRIDAY,0,0,23.9,74,22.3,1013.4,Cloudy
5/27/2022 16:00,297,451,921032,385967,748,1306999,FRIDAY,0,0,23.9,74,24.1,1012.7,Cloudy
5/27/2022 17:00,347,480,816335,384875,827,1201210,FRIDAY,0,0,23.9,74,24.1,1012.7,Cloudy
5/27/2022 18:00,371,465,1860364,377127,836,2237491,FRIDAY,0,0,26.1,62,27.7,1011.3,Cloudy
5/27/2022 19:00,407,557,1052385,525383,964,1577768,FRIDAY,0,0,27.2,57,24.1,1010.5,Cloudy
5/27/2022 20:00,469,652,1839612,691211,1121,2530823,FRIDAY,0,0,26.7,58,24.1,1010.2,Cloudy
5/27/2022 21:00,437,785,902403,781605,1222,1684008,FRIDAY,0,0,26.7,58,33.5,1010.2,Cloudy
5/27/2022 22:00,441,679,801610,683343,1120,1484953,FRIDAY,0,0,23.9,71,24.1,1010.2,Cloudy
5/27/2022 23:00,340,511,627622,455403,851,1083025,FRIDAY,0,0,22.8,76,22.3,1009.8,Cloudy
5/28/2022 0:00,225,346,779229,290316,571,1069545,SATURDAY,1,0,20.6,87,25.9,1009.5,Cloudy
5/28/2022 1:00,189,297,413096,248847,486,661943,SATURDAY,1,0,20,87,25.9,1008.7,Cloudy
5/28/2022 2:00,232,241,450185,196925,473,647110,SATURDAY,1,0,20,87,25.9,1008.7,Cloudy
5/28/2022 3:00,386,278,646929,250685,664,897614,SATURDAY,1,0,19.4,84,22.3,1009.2,Cloudy
5/28/2022 4:00,337,202,991678,296059,539,1287737,SATURDAY,1,0,19.4,84,25.9,1008.6,Cloudy
5/28/2022 5:00,299,126,777411,178178,425,955589,SATURDAY,1,0,19.4,84,25.9,1008.6,Cloudy
5/28/2022 6:00,126,66,791967,63759,192,855726,SATURDAY,1,0,19.4,87,20.5,1007.8,Cloudy
5/28/2022 7:00,7,15,23500,15291,22,38791,SATURDAY,1,0,18.9,93,25.9,1007.6,Cloudy
5/28/2022 8:00,3,8,3281,8198,11,11479,SATURDAY,1,0,18.3,97,9.4,1006.3,Cloudy
5/28/2022 9:00,2,13,4491,5170,15,9661,SATURDAY,1,0,18.9,96,11.2,1005.9,Cloudy
5/28/2022 10:00,11,50,13392,34081,61,47473,SATURDAY,1,0,18.9,96,14.8,1006,Cloudy
5/28/2022 11:00,38,77,58833,67283,115,126116,SATURDAY,1,0,20,93,13,1005.7,Cloudy
5/28/2022 12:00,77,183,115189,144501,260,259690,SATURDAY,1,0,20,93,13,1005.7,Cloudy
5/28/2022 13:00,148,239,284471,205468,387,489939,SATURDAY,1,0,20.6,84,18.4,1005.5,Cloudy
5/28/2022 14:00,283,379,808441,335601,662,1144042,SATURDAY,1,0,20.6,84,18.4,1005.3,Cloudy
5/28/2022 15:00,362,432,938130,383834,794,1321964,SATURDAY,1,0,21.7,79,20.5,1005.2,Cloudy
5/28/2022 16:00,391,515,1419135,493174,906,1912309,SATURDAY,1,0,21.7,79,20.5,1005.2,Cloudy
5/28/2022 17:00,404,447,795061,414273,851,1209334,SATURDAY,1,0,21.7,81,18.4,1004.8,Cloudy
5/28/2022 18:00,475,457,881688,452282,932,1333970,SATURDAY,1,0,23.3,74,24.1,1004.1,Cloudy
5/28/2022 19:00,406,376,660199,346526,782,1006725,SATURDAY,1,0,23.3,74,24.1,1004.1,Cloudy
5/28/2022 20:00,63,106,468837,75126,169,543963,SATURDAY,1,0,19.4,91,16.6,1005,Cloudy
5/28/2022 21:00,195,231,316383,191417,426,507800,SATURDAY,1,0,21.1,82,13,1004.5,Cloudy
5/28/2022 22:00,272,287,686171,252611,559,938782,SATURDAY,1,0,21.1,82,13,1004.5,Cloudy
5/28/2022 23:00,275,335,511907,373047,610,884954,SATURDAY,1,0,20.6,84,13,1006.8,Cloudy
5/29/2022 0:00,221,297,357462,272998,518,630460,SUNDAY,1,0,20,84,14.8,1007.8,Cloudy
5/29/2022 1:00,238,215,454967,223384,453,678351,SUNDAY,1,0,20,81,11.2,1009.1,Cloudy
5/29/2022 2:00,241,202,296490,155605,443,452095,SUNDAY,1,0,20,81,11.2,1009.1,Cloudy
5/29/2022 3:00,176,163,667151,171221,339,838372,SUNDAY,1,0,18.9,68,22.3,1011,Fair
5/29/2022 4:00,111,144,500211,105356,255,605567,SUNDAY,1,0,18.9,61,22.3,1011,Fair
5/29/2022 5:00,173,90,530885,79942,263,610827,SUNDAY,1,0,17.8,68,16.6,1011.7,Fair
5/29/2022 6:00,74,65,907709,63038,139,970747,SUNDAY,1,0,17.2,67,16.6,1011.9,Fair
5/29/2022 7:00,21,33,233656,27521,54,261177,SUNDAY,1,0,16.7,70,16.6,1012.6,Fair
5/29/2022 8:00,10,11,26592,6672,21,33264,SUNDAY,1,0,16.1,72,13,1013,Fair
5/29/2022 9:00,34,30,49450,27522,64,76972,SUNDAY,1,0,15.6,75,11.2,1015,Fair
5/29/2022 10:00,61,78,102739,55255,139,157994,SUNDAY,1,0,16.7,70,9.4,1015.7,Fair
5/29/2022 11:00,90,100,428337,83062,190,511399,SUNDAY,1,0,16.7,70,9.4,1015.7,Fair
5/29/2022 12:00,98,162,207734,175461,260,383195,SUNDAY,1,0,21.1,47,9.4,1017.3,Cloudy
5/29/2022 13:00,217,248,531091,222914,465,754005,SUNDAY,1,0,21.1,46,14.8,1017.7,Cloudy
5/29/2022 14:00,402,355,1172166,354676,757,1526842,SUNDAY,1,0,21.1,49,16.6,1018,Cloudy
5/29/2022 15:00,539,409,1569241,461332,948,2030573,SUNDAY,1,0,21.1,49,14.8,1018.1,Cloudy
5/29/2022 16:00,643,489,1613451,551715,1132,2165166,SUNDAY,1,0,21.1,49,14.8,1018.1,Cloudy
5/29/2022 17:00,716,491,1695503,532997,1207,2228500,SUNDAY,1,0,21.1,51,16.6,1017.8,Cloudy
5/29/2022 18:00,721,465,1734608,500977,1186,2235585,SUNDAY,1,0,21.1,53,18.4,1017.7,Cloudy
5/29/2022 19:00,748,506,1811087,570938,1254,2382025,SUNDAY,1,0,22.2,43,20.5,1017.5,Cloudy
5/29/2022 20:00,764,514,2508065,532848,1278,3040913,SUNDAY,1,0,21.1,47,20.5,1017.3,Cloudy
5/29/2022 21:00,758,528,2026063,589661,1286,2615724,SUNDAY,1,0,21.1,47,20.5,1017.3,Cloudy
5/29/2022 22:00,583,487,1980973,526763,1070,2507736,SUNDAY,1,0,20,51,18.4,1017.1,Cloudy
5/29/2022 23:00,553,430,2081996,418669,983,2500665,SUNDAY,1,0,19.4,55,13,1017.4,Cloudy
5/30/2022 0:00,356,335,605628,293002,691,898630,MONDAY,0,1,18.9,68,18.4,1017.7,Cloudy
5/30/2022 1:00,281,256,1277310,241802,537,1519112,MONDAY,0,1,18.3,70,14.8,1018.3,Cloudy
5/30/2022 2:00,270,179,782094,154479,449,936573,MONDAY,0,1,18.3,70,14.8,1018.3,Cloudy
5/30/2022 3:00,364,234,1537540,238228,598,1775768,MONDAY,0,1,17.8,73,14.8,1018.9,Cloudy
5/30/2022 4:00,185,115,504243,130670,300,634913,MONDAY,0,1,16.7,78,11.2,1018.7,Cloudy
5/30/2022 5:00,101,55,185391,47552,156,232943,MONDAY,0,1,16.1,81,9.4,1018.4,Cloudy
5/30/2022 6:00,50,30,480182,23882,80,504064,MONDAY,0,1,16.1,81,9.4,1018.4,Fair
5/30/2022 7:00,10,16,47946,12783,26,60729,MONDAY,0,1,16.1,81,14.8,1017.9,Fair
5/30/2022 8:00,18,12,35592,11929,30,47521,MONDAY,0,1,15.6,83,14.8,1018.1,Fair
5/30/2022 9:00,19,13,30253,13322,32,43575,MONDAY,0,1,16.1,81,13,1018.4,Cloudy
5/30/2022 10:00,17,55,29573,43368,72,72941,MONDAY,0,1,18.3,73,14.8,1018.8,Cloudy
5/30/2022 11:00,37,94,100935,72913,131,173848,MONDAY,0,1,20,65,9.4,1018.6,Cloudy
5/30/2022 12:00,106,199,233315,176505,305,409820,MONDAY,0,1,20,65,9.4,1018.6,Cloudy
5/30/2022 13:00,158,304,281662,258969,462,540631,MONDAY,0,1,24.4,52,7.6,1018.3,Cloudy
5/30/2022 14:00,295,347,672595,319862,642,992457,MONDAY,0,1,26.7,42,16.6,1017.6,Cloudy
5/30/2022 15:00,357,405,969299,427461,762,1396760,MONDAY,0,1,28.3,34,16.6,1016.8,Cloudy
5/30/2022 16:00,411,440,1211472,432398,851,1643870,MONDAY,0,1,28.3,34,16.6,1016.8,Cloudy
5/30/2022 17:00,440,435,1191816,420470,875,1612286,MONDAY,0,1,29.4,32,9.4,1015.7,Cloudy
5/30/2022 18:00,479,445,1367100,452950,924,1820050,MONDAY,0,1,30,32,9.4,1015.3,Cloudy
5/30/2022 19:00,446,476,936943,473158,922,1410101,MONDAY,0,1,30.6,32,18.4,1014.5,Cloudy
5/30/2022 20:00,461,435,1065779,441862,896,1507641,MONDAY,0,1,30,36,22.3,1014.3,Cloudy
5/30/2022 21:00,476,534,1231545,488336,1010,1719881,MONDAY,0,1,30,36,22.3,1014.3,Cloudy
5/30/2022 22:00,429,529,911092,463080,958,1374172,MONDAY,0,1,29.4,37,16.6,1014.3,Cloudy
5/30/2022 23:00,352,492,828961,440551,844,1269512,MONDAY,0,1,30,36,11.2,1014,Cloudy
5/31/2022 0:00,245,345,472439,318848,590,791287,TUESDAY,0,0,30,36,11.2,1014,Cloudy
5/31/2022 1:00,215,268,383545,234885,483,618430,TUESDAY,0,0,26.1,50,18.4,1013.7,Cloudy
5/31/2022 2:00,181,189,424473,158775,370,583248,TUESDAY,0,0,26.1,50,18.4,1013.7,Cloudy
5/31/2022 3:00,94,93,280614,107312,187,387926,TUESDAY,0,0,24.4,62,22.3,1012.7,Cloudy
5/31/2022 4:00,36,68,34936,53734,104,88670,TUESDAY,0,0,24.4,62,16.6,1012.4,Cloudy
5/31/2022 5:00,29,31,34238,20994,60,55232,TUESDAY,0,0,24.4,62,18.4,1011.9,Cloudy
5/31/2022 6:00,12,14,26067,22735,26,48802,TUESDAY,0,0,24.4,62,18.4,1011.9,Fair
5/31/2022 7:00,1,7,1448,4529,8,5977,TUESDAY,0,0,23.9,64,14.8,1011.5,Cloudy
5/31/2022 8:00,7,8,12124,8444,15,20568,TUESDAY,0,0,24.4,62,13,1011.6,Cloudy
5/31/2022 9:00,14,60,45248,48232,74,93480,TUESDAY,0,0,24.4,62,9.4,1011.9,Cloudy
5/31/2022 10:00,28,183,65217,128829,211,194046,TUESDAY,0,0,25.6,58,11.2,1012.1,Cloudy
5/31/2022 11:00,67,474,63535,399896,541,463431,TUESDAY,0,0,25.6,58,11.2,1012.1,Cloudy
5/31/2022 12:00,111,800,161755,682431,911,844186,TUESDAY,0,0,27.2,53,18.4,1012.4,Cloudy
5/31/2022 13:00,81,484,136322,371019,565,507341,TUESDAY,0,0,16.7,65,27.7,1015.1,Cloudy
5/31/2022 14:00,132,346,234547,273778,478,508325,TUESDAY,0,0,16.1,70,29.5,1016,Cloudy
5/31/2022 15:00,173,358,402478,266233,531,668711,TUESDAY,0,0,16.1,70,29.5,1016,Cloudy
5/31/2022 16:00,173,410,312805,311189,583,623994,TUESDAY,0,0,15.6,72,25.9,1016.5,Cloudy
5/31/2022 17:00,170,381,358661,279765,551,638426,TUESDAY,0,0,15.6,69,29.5,1016.5,Cloudy
5/31/2022 18:00,161,383,363400,311384,544,674784,TUESDAY,0,0,15.6,67,24.1,1016.3,Cloudy
5/31/2022 19:00,181,512,361805,506256,693,868061,TUESDAY,0,0,15.6,72,22.3,1016,Cloudy
5/31/2022 20:00,242,664,592368,577205,906,1169573,TUESDAY,0,0,15.6,72,22.3,1016,Cloudy
5/31/2022 21:00,302,1061,532845,935394,1363,1468239,TUESDAY,0,0,13.3,84,18.4,1016.2,Cloudy
5/31/2022 22:00,315,903,484069,776077,1218,1260146,TUESDAY,0,0,13.3,84,16.6,1016.2,Cloudy
5/31/2022 23:00,213,596,667906,561392,809,1229298,TUESDAY,0,0,12.8,87,11.2,1016.6,Cloudy
6/1/2022 0:00,103,406,130978,459020,509,589998,WEDNESDAY,0,0,12.8,87,11.2,1016.6,Cloudy
6/1/2022 1:00,90,260,112315,205067,350,317382,WEDNESDAY,0,0,12.8,87,11.2,1017.1,Cloudy
6/1/2022 2:00,71,168,98360,133272,239,231632,WEDNESDAY,0,0,13.3,80,9.4,1017.6,Cloudy
6/1/2022 3:00,25,91,31140,59191,116,90331,WEDNESDAY,0,0,13.3,80,0,1017.7,Cloudy
6/1/2022 4:00,24,21,33663,13373,45,47036,WEDNESDAY,0,0,13.3,84,7.6,1017.3,Fair
6/1/2022 5:00,9,24,12741,16903,33,29644,WEDNESDAY,0,0,13.3,80,0,1017.5,Fair
6/1/2022 6:00,3,12,3557,8942,15,12499,WEDNESDAY,0,0,13.3,80,0,1017.5,Fair
6/1/2022 7:00,2,7,1572,8280,9,9852,WEDNESDAY,0,0,13.3,75,7.6,1017,Fair
6/1/2022 8:00,5,17,4084,16432,22,20516,WEDNESDAY,0,0,13.3,80,11.2,1017.1,Fair
6/1/2022 9:00,7,68,5913,49335,75,55248,WEDNESDAY,0,0,13.3,80,7.6,1017.6,Cloudy
6/1/2022 10:00,18,198,18939,146232,216,165171,WEDNESDAY,0,0,13.9,77,5.4,1017.7,Cloudy
6/1/2022 11:00,62,488,56586,373583,550,430169,WEDNESDAY,0,0,13.9,77,5.4,1017.7,Cloudy
6/1/2022 12:00,143,929,171570,711687,1072,883257,WEDNESDAY,0,0,15,69,7.6,1017.5,Cloudy
6/1/2022 13:00,93,545,210458,418432,638,628890,WEDNESDAY,0,0,14.4,72,9.4,1017.4,Cloudy
6/1/2022 14:00,94,335,233560,298366,429,531926,WEDNESDAY,0,0,15.6,78,13,1016.9,Cloudy
6/1/2022 15:00,102,333,1548431,273878,435,1822309,WEDNESDAY,0,0,15.6,78,18.4,1016.6,Cloudy
6/1/2022 16:00,132,372,199044,321584,504,520628,WEDNESDAY,0,0,15.6,78,18.4,1016.6,Cloudy
6/1/2022 17:00,131,315,492379,263987,446,756366,WEDNESDAY,0,0,13.9,83,13,1016,Cloudy
6/1/2022 18:00,69,174,1406766,869730,243,2276496,WEDNESDAY,0,0,12.8,89,16.6,1015.6,Cloudy
6/1/2022 19:00,15,130,13414,90051,145,103465,WEDNESDAY,0,0,12.8,89,16.6,1015.6,Cloudy
6/1/2022 20:00,95,429,155766,336410,524,492176,WEDNESDAY,0,0,12.8,93,18.4,1013.6,Cloudy
6/1/2022 21:00,174,885,460743,744444,1059,1205187,WEDNESDAY,0,0,13.3,90,9.4,1013.7,Cloudy
6/1/2022 22:00,198,756,283152,595577,954,878729,WEDNESDAY,0,0,13.3,90,13,1013,Cloudy
6/1/2022 23:00,156,566,2170298,414120,722,2584418,WEDNESDAY,0,0,13.3,93,14.8,1012.5,Cloudy
6/2/2022 0:00,86,317,111832,232917,403,344749,THURSDAY,0,0,13.3,93,16.6,1011.7,Cloudy
6/2/2022 1:00,75,265,103726,214080,340,317806,THURSDAY,0,0,13.3,93,16.6,1011.7,Cloudy
6/2/2022 2:00,124,177,166525,139711,301,306236,THURSDAY,0,0,14.4,70,18.4,1010.7,Cloudy
6/2/2022 3:00,43,88,121758,108246,131,230004,THURSDAY,0,0,14.4,67,11.2,1010,Cloudy
6/2/2022 4:00,26,49,28520,37612,75,66132,THURSDAY,0,0,14.4,67,11.2,1010,Cloudy
6/2/2022 5:00,7,13,4602,9613,20,14215,THURSDAY,0,0,13.9,72,9.4,1009.5,Cloudy
6/2/2022 6:00,13,9,41822,6900,22,48722,THURSDAY,0,0,13.9,72,9.4,1009.5,Fair
6/2/2022 7:00,4,8,3352,5839,12,9191,THURSDAY,0,0,13.9,74,11.2,1008.5,Fair
6/2/2022 8:00,6,10,6294,9864,16,16158,THURSDAY,0,0,13.9,90,5.4,1008.2,Cloudy
6/2/2022 9:00,5,38,1756,28895,43,30651,THURSDAY,0,0,13.9,93,5.4,1008,Cloudy
6/2/2022 10:00,13,105,7695,69794,118,77489,THURSDAY,0,0,13.3,97,5.4,1008.9,Cloudy
6/2/2022 11:00,43,347,67160,294997,390,362157,THURSDAY,0,0,13.3,97,16.6,1008.9,Cloudy
6/2/2022 12:00,100,770,90617,614364,870,704981,THURSDAY,0,0,13.9,93,5.4,1008.8,Cloudy
6/2/2022 13:00,75,524,85516,369920,599,455436,THURSDAY,0,0,13.9,93,5.4,1008.8,Cloudy
6/2/2022 14:00,108,362,181573,295268,470,476841,THURSDAY,0,0,16.7,80,5.4,1008.5,Cloudy
6/2/2022 15:00,118,355,813085,273661,473,1086746,THURSDAY,0,0,16.7,80,5.4,1008.5,Cloudy
6/2/2022 16:00,144,401,235017,307699,545,542716,THURSDAY,0,0,16.7,80,14.8,1008.5,Fair
6/2/2022 17:00,150,363,407973,303609,513,711582,THURSDAY,0,0,15.6,80,20.5,1008.7,Fair
6/2/2022 18:00,177,401,1033086,303220,578,1336306,THURSDAY,0,0,15.6,80,20.5,1008.7,Fair
6/2/2022 19:00,178,461,1834890,342542,639,2177432,THURSDAY,0,0,15.6,80,14.8,1008.7,Fair
6/2/2022 20:00,222,619,322922,526576,841,849498,THURSDAY,0,0,13.9,90,20.5,1008.8,Fair
6/2/2022 21:00,251,972,537486,819511,1223,1356997,THURSDAY,0,0,13.9,90,20.5,1008.8,Fair
6/2/2022 22:00,276,830,697337,689905,1106,1387242,THURSDAY,0,0,13.3,90,18.4,1008.8,Fair
6/2/2022 23:00,181,623,403854,512634,804,916488,THURSDAY,0,0,13.3,90,18.4,1008.8,Fair
6/3/2022 0:00,147,414,698428,330367,561,1028795,FRIDAY,0,0,13.3,90,11.2,1009.2,Fair
6/3/2022 1:00,85,289,82029,225802,374,307831,FRIDAY,0,0,13.3,90,11.2,1009.2,Fair
6/3/2022 2:00,78,194,320170,150945,272,471115,FRIDAY,0,0,12.8,93,7.6,1009.3,Fair
6/3/2022 3:00,88,188,83235,148570,276,231805,FRIDAY,0,0,12.8,93,9.4,1009.1,Fair
6/3/2022 4:00,49,71,80405,91811,120,172216,FRIDAY,0,0,12.2,97,9.4,1009.3,Fair
6/3/2022 5:00,35,30,45687,23381,65,69068,FRIDAY,0,0,12.2,97,9.4,1009.3,Fair
6/3/2022 6:00,12,17,154654,15354,29,170008,FRIDAY,0,0,12.2,97,9.4,1008.5,Cloudy
6/3/2022 7:00,2,11,2683,9086,13,11769,FRIDAY,0,0,11.7,100,11.2,1008.2,Cloudy
6/3/2022 8:00,11,11,12619,9517,22,22136,FRIDAY,0,0,11.7,100,11.2,1008.2,Cloudy
6/3/2022 9:00,4,57,10182,38626,61,48808,FRIDAY,0,0,11.7,100,11.2,1008.3,Cloudy
6/3/2022 10:00,17,162,21007,131460,179,152467,FRIDAY,0,0,12.2,97,9.4,1008.6,Cloudy
6/3/2022 11:00,42,339,48266,276979,381,325245,FRIDAY,0,0,12.2,97,9.4,1008.6,Cloudy
6/3/2022 12:00,79,642,98289,1626356,721,1724645,FRIDAY,0,0,13.3,93,9.4,1008.9,Cloudy
6/3/2022 13:00,41,319,60659,204895,360,265554,FRIDAY,0,0,12.8,96,9.4,1009.4,Fair
6/3/2022 14:00,42,247,42131,170370,289,212501,FRIDAY,0,0,12.8,96,9.4,1009.4,Fair
6/3/2022 15:00,64,232,90041,168480,296,258521,FRIDAY,0,0,13.9,93,5.4,1009.5,Fair
6/3/2022 16:00,82,275,482624,196387,357,679011,FRIDAY,0,0,14.4,90,13,1009.1,Fair
6/3/2022 17:00,150,378,3744917,274874,528,4019791,FRIDAY,0,0,14.4,90,13,1009.1,Fair
6/3/2022 18:00,165,425,456845,314610,590,771455,FRIDAY,0,0,16.1,84,14.8,1008.7,Fair
6/3/2022 19:00,248,492,433389,387101,740,820490,FRIDAY,0,0,16.1,81,11.2,1008.7,Fair
6/3/2022 20:00,284,657,469070,2031334,941,2500404,FRIDAY,0,0,16.1,81,11.2,1008.7,Fair
6/3/2022 21:00,349,858,2394039,756148,1207,3150187,FRIDAY,0,0,15,87,14.8,1008.9,Fair
6/3/2022 22:00,325,745,2426639,611753,1070,3038392,FRIDAY,0,0,14.4,90,16.6,1009.6,Fair
6/3/2022 23:00,193,564,481129,612954,757,1094083,FRIDAY,0,0,13.9,93,14.8,1010.7,Cloudy
6/4/2022 0:00,141,392,1059228,311766,533,1370994,SATURDAY,1,0,13.9,93,14.8,1010.7,Fair
6/4/2022 1:00,95,269,684327,211966,364,896293,SATURDAY,1,0,13.3,93,14.8,1010.7,Cloudy
6/4/2022 2:00,86,169,158451,682131,255,840582,SATURDAY,1,0,13.3,93,18.4,1010.7,Cloudy
6/4/2022 3:00,104,126,197934,203116,230,401050,SATURDAY,1,0,13.3,90,14.8,1011.9,Fair
6/4/2022 4:00,100,92,1341576,65768,192,1407344,SATURDAY,1,0,13.9,87,11.2,1012,Cloudy
6/4/2022 5:00,128,93,296535,189691,221,486226,SATURDAY,1,0,13.9,87,11.2,1012,Fair
6/4/2022 6:00,79,56,203596,56615,135,260211,SATURDAY,1,0,12.8,93,13,1011.1,Fair
6/4/2022 7:00,18,26,68711,27056,44,95767,SATURDAY,1,0,12.8,96,0,1011.3,Fair
6/4/2022 8:00,9,13,7786,19767,22,27553,SATURDAY,1,0,12.2,100,0,1011.8,Cloudy
6/4/2022 9:00,8,21,8903,37639,29,46542,SATURDAY,1,0,13.3,93,7.6,1012,Cloudy
6/4/2022 10:00,16,50,42495,47694,66,90189,SATURDAY,1,0,13.3,93,7.6,1012.3,Cloudy
6/4/2022 11:00,33,93,88968,70056,126,159024,SATURDAY,1,0,13.3,93,7.6,1012.3,Fair
6/4/2022 12:00,77,215,131501,177095,292,308596,SATURDAY,1,0,15.6,83,9.4,1012.4,Fair
6/4/2022 13:00,172,281,829249,231626,453,1060875,SATURDAY,1,0,16.1,84,11.2,1012.3,Fair
6/4/2022 14:00,209,391,394061,361886,600,755947,SATURDAY,1,0,17.8,75,13,1011.8,Fair
6/4/2022 15:00,353,507,854797,522750,860,1377547,SATURDAY,1,0,17.8,75,13,1011.8,Fair
6/4/2022 16:00,395,567,832910,577927,962,1410837,SATURDAY,1,0,19.4,66,20.5,1011.4,Cloudy
6/4/2022 17:00,484,615,2820885,637972,1099,3458857,SATURDAY,1,0,17.8,75,20.5,1011.2,Cloudy
6/4/2022 18:00,571,591,6191314,654568,1162,6845882,SATURDAY,1,0,16.7,78,27.7,1010.7,Fair
6/4/2022 19:00,547,550,1903395,606101,1097,2509496,SATURDAY,1,0,17.2,78,25.9,1010.1,Fair
6/4/2022 20:00,562,547,2812850,553528,1109,3366378,SATURDAY,1,0,17.2,78,25.9,1010.1,Fair
6/4/2022 21:00,531,597,1493724,3756108,1128,5249832,SATURDAY,1,0,17.8,78,9.4,1008.9,Fair
6/4/2022 22:00,429,589,795922,611237,1018,1407159,SATURDAY,1,0,21.1,59,20.5,1008.8,Fair
6/4/2022 23:00,427,534,1188537,651459,961,1839996,SATURDAY,1,0,19.4,71,20.5,1008.8,Fair
6/5/2022 0:00,289,364,727868,300269,653,1028137,SUNDAY,1,0,19.4,71,27.7,1008.8,Fair
6/5/2022 1:00,174,255,3468565,197607,429,3666172,SUNDAY,1,0,16.7,84,24.1,1010,Fair
6/5/2022 2:00,201,228,1388285,201627,429,1589912,SUNDAY,1,0,16.7,86,18.4,1010.5,Fair
6/5/2022 3:00,182,181,2767337,162899,363,2930236,SUNDAY,1,0,17.8,86,14.8,1011.1,Fair
6/5/2022 4:00,176,159,462006,134039,335,596045,SUNDAY,1,0,17.8,48,20.5,1011.6,Cloudy
6/5/2022 5:00,228,117,891438,108379,345,999817,SUNDAY,1,0,16.1,38,14.8,1012.2,Cloudy
6/5/2022 6:00,102,54,2968867,54095,156,3022962,SUNDAY,1,0,15,42,18.4,1012.4,Fair
6/5/2022 7:00,22,16,31098,14982,38,46080,SUNDAY,1,0,15,42,18.4,1012.4,Fair
6/5/2022 8:00,12,10,21405,5705,22,27110,SUNDAY,1,0,13.3,53,16.6,1012.8,Fair
6/5/2022 9:00,11,20,14527,16757,31,31284,SUNDAY,1,0,13.9,51,16.6,1013.6,Fair
6/5/2022 10:00,17,61,21500,58373,78,79873,SUNDAY,1,0,13.9,51,16.6,1013.6,Fair
6/5/2022 11:00,27,97,37883,77679,124,115562,SUNDAY,1,0,16.1,44,18.4,1014.1,Fair
6/5/2022 12:00,81,191,170651,153310,272,323961,SUNDAY,1,0,18.3,40,14.8,1015,Fair
6/5/2022 13:00,164,287,382697,251366,451,634063,SUNDAY,1,0,19.4,36,14.8,1014.8,Fair
6/5/2022 14:00,301,359,679349,343098,660,1022447,SUNDAY,1,0,20.6,33,13,1014.5,Fair
6/5/2022 15:00,365,498,1589802,484896,863,2074698,SUNDAY,1,0,20.6,33,13,1014.5,Fair
6/5/2022 16:00,420,536,1000797,516679,956,1517476,SUNDAY,1,0,22.8,29,13,1013.8,Fair
6/5/2022 17:00,475,580,1320423,782448,1055,2102871,SUNDAY,1,0,23.9,24,20.5,1013.8,Fair
6/5/2022 18:00,514,594,1543193,598934,1108,2142127,SUNDAY,1,0,24.4,25,20.5,1013.6,Fair
6/5/2022 19:00,545,593,3179038,640581,1138,3819619,SUNDAY,1,0,24.4,24,22.3,1013.6,Fair
6/5/2022 20:00,532,570,1745068,636459,1102,2381527,SUNDAY,1,0,24.4,24,22.3,1013.6,Fair
6/5/2022 21:00,482,562,7199979,529707,1044,7729686,SUNDAY,1,0,23.3,26,13,1013.9,Fair
6/5/2022 22:00,426,542,1008596,482887,968,1491483,SUNDAY,1,0,23.3,25,18.4,1014,Fair
6/5/2022 23:00,378,543,901068,525688,921,1426756,SUNDAY,1,0,23.3,25,18.4,1014.2,Fair
6/6/2022 0:00,212,349,355549,290162,561,645711,MONDAY,0,0,18.9,50,16.6,1014.2,Fair
6/6/2022 1:00,130,199,523064,157470,329,680534,MONDAY,0,0,17.8,60,14.8,1015.2,Fair
6/6/2022 2:00,149,215,475446,174505,364,649951,MONDAY,0,0,16.1,65,14.8,1015.3,Fair
6/6/2022 3:00,61,108,108408,76260,169,184668,MONDAY,0,0,16.1,62,9.4,1015.3,Fair
6/6/2022 4:00,37,50,95216,41571,87,136787,MONDAY,0,0,16.7,60,0,1015.3,Fair
6/6/2022 5:00,23,20,1134845,19413,43,1154258,MONDAY,0,0,16.7,60,0,1015.3,Cloudy
6/6/2022 6:00,12,10,31145,8094,22,39239,MONDAY,0,0,15.6,62,9.4,1015.6,Fair
6/6/2022 7:00,0,4,0,4860,4,4860,MONDAY,0,0,15,64,7.6,1016,Cloudy
6/6/2022 8:00,7,14,9222,11614,21,20836,MONDAY,0,0,15,62,5.4,1016.2,Cloudy
6/6/2022 9:00,8,71,5659,43392,79,49051,MONDAY,0,0,15,62,5.4,1016.2,Cloudy
6/6/2022 10:00,27,187,89787,131853,214,221640,MONDAY,0,0,15,60,5.4,1016.8,Fair
6/6/2022 11:00,67,447,84590,339091,514,423681,MONDAY,0,0,20,44,7.6,1017.3,Fair
6/6/2022 12:00,124,861,155970,657824,985,813794,MONDAY,0,0,20.6,45,5.4,1017.4,Fair
6/6/2022 13:00,106,521,170015,377719,627,547734,MONDAY,0,0,20.6,44,11.2,1017.5,Fair
6/6/2022 14:00,104,323,403189,286046,427,689235,MONDAY,0,0,20.6,44,11.2,1017.5,Fair
6/6/2022 15:00,124,324,1104410,256432,448,1360842,MONDAY,0,0,22.8,33,20.5,1016.9,Fair
6/6/2022 16:00,161,372,764638,281762,533,1046400,MONDAY,0,0,22.8,33,20.5,1016.9,Fair
6/6/2022 17:00,156,364,1533792,268707,520,1802499,MONDAY,0,0,21.7,44,18.4,1016.8,Fair
6/6/2022 18:00,184,347,4774990,274541,531,5049531,MONDAY,0,0,22.8,35,24.1,1016.7,Fair
6/6/2022 19:00,182,439,661102,387156,621,1048258,MONDAY,0,0,22.8,35,24.1,1016.7,Fair
6/6/2022 20:00,224,695,353527,582405,919,935932,MONDAY,0,0,21.7,46,20.5,1016.3,Fair
6/6/2022 21:00,375,1115,3545458,1368605,1490,4914063,MONDAY,0,0,21.1,53,16.6,1016.2,Fair
6/6/2022 22:00,362,960,3483305,869996,1322,4353301,MONDAY,0,0,21.1,53,16.6,1016.2,Fair
6/6/2022 23:00,288,687,449701,587460,975,1037161,MONDAY,0,0,21.7,42,18.4,1016.2,Fair
6/7/2022 0:00,215,458,4398507,743487,673,5141994,TUESDAY,0,0,21.7,42,18.4,1016.2,Fair
6/7/2022 1:00,153,294,287100,237920,447,525020,TUESDAY,0,0,20,49,16.6,1016.8,Fair
6/7/2022 2:00,69,169,160903,817654,238,978557,TUESDAY,0,0,19.4,51,9.4,1016.8,Fair
6/7/2022 3:00,63,88,140975,71626,151,212601,TUESDAY,0,0,18.3,56,9.4,1017.1,Fair
6/7/2022 4:00,40,51,117444,38640,91,156084,TUESDAY,0,0,16.7,70,9.4,1017.3,Fair
6/7/2022 5:00,11,13,36392,7531,24,43923,TUESDAY,0,0,16.7,70,9.4,1017.3,Fair
6/7/2022 6:00,12,10,46214,6460,22,52674,TUESDAY,0,0,17.2,65,16.6,1017.4,Fair
6/7/2022 7:00,0,5,0,5583,5,5583,TUESDAY,0,0,16.7,65,13,1017.5,Fair
6/7/2022 8:00,4,18,3049,17795,22,20844,TUESDAY,0,0,16.1,67,14.8,1017.6,Fair
6/7/2022 9:00,10,71,15991,47402,81,63393,TUESDAY,0,0,16.1,65,11.2,1017.9,Fair
6/7/2022 10:00,29,240,24424,182602,269,207026,TUESDAY,0,0,16.1,65,11.2,1017.9,Fair
6/7/2022 11:00,76,586,79837,451566,662,531403,TUESDAY,0,0,21.1,42,14.8,1018.5,Fair
6/7/2022 12:00,149,978,227955,823552,1127,1051507,TUESDAY,0,0,23.3,42,20.5,1018.5,Fair
6/7/2022 13:00,99,619,180169,458039,718,638208,TUESDAY,0,0,24.4,31,22.3,1018.4,Fair
6/7/2022 14:00,118,371,215180,279321,489,494501,TUESDAY,0,0,25.6,29,18.4,1018.1,Fair
6/7/2022 15:00,160,336,337392,249439,496,586831,TUESDAY,0,0,25.6,29,18.4,1018.1,Fair
6/7/2022 16:00,154,413,748968,335362,567,1084330,TUESDAY,0,0,26.7,29,27.7,1017.2,Fair
6/7/2022 17:00,170,394,314078,306506,564,620584,TUESDAY,0,0,26.7,33,24.1,1016.8,Fair
6/7/2022 18:00,211,387,500496,317431,598,817927,TUESDAY,0,0,25.6,47,24.1,1016.9,Fair
6/7/2022 19:00,206,476,378247,377474,682,755721,TUESDAY,0,0,25.6,47,29.5,1016.9,Fair
6/7/2022 20:00,292,714,546331,589389,1006,1135720,TUESDAY,0,0,23.3,52,31.7,1016.6,Fair
6/7/2022 21:00,419,1250,1677322,1092876,1669,2770198,TUESDAY,0,0,23.3,53,25.9,1016.1,Fair
6/7/2022 22:00,395,1009,817178,941027,1404,1758205,TUESDAY,0,0,22.8,51,27.7,1015.8,Fair
6/7/2022 23:00,241,733,645236,596472,974,1241708,TUESDAY,0,0,22.8,51,27.7,1015.8,Fair
6/8/2022 0:00,176,531,253592,490850,707,744442,WEDNESDAY,0,0,20.6,61,27.7,1015.9,Fair
6/8/2022 1:00,100,326,256748,258139,426,514887,WEDNESDAY,0,0,19.4,73,20.5,1016.1,Fair
6/8/2022 2:00,127,189,176591,158406,316,334997,WEDNESDAY,0,0,20,65,22.3,1015.9,Fair
6/8/2022 3:00,57,114,110510,125074,171,235584,WEDNESDAY,0,0,20,65,22.3,1015.6,Fair
6/8/2022 4:00,19,36,23125,25490,55,48615,WEDNESDAY,0,0,18.9,75,29.5,1015.2,Fair
6/8/2022 5:00,8,17,7600,10440,25,18040,WEDNESDAY,0,0,18.9,75,29.5,1015.2,Fair
6/8/2022 6:00,5,5,3164,3715,10,6879,WEDNESDAY,0,0,17.8,90,24.1,1013.8,Fair
6/8/2022 7:00,3,4,2776,2782,7,5558,WEDNESDAY,0,0,17.2,93,20.5,1012.8,Fair
6/8/2022 8:00,6,7,15560,4762,13,20322,WEDNESDAY,0,0,17.2,93,20.5,1012.8,Fair
6/8/2022 9:00,0,25,0,21061,25,21061,WEDNESDAY,0,0,17.2,93,18.4,1012.1,Fair
6/8/2022 10:00,15,117,10970,80844,132,91814,WEDNESDAY,0,0,17.8,93,16.6,1011.3,Fair
6/8/2022 11:00,40,290,41282,199494,330,240776,WEDNESDAY,0,0,18.3,97,18.4,1011.3,Fair
6/8/2022 12:00,100,820,91075,648787,920,739862,WEDNESDAY,0,0,18.3,97,18.4,1011.3,Fair
6/8/2022 13:00,89,576,152626,403725,665,556351,WEDNESDAY,0,0,20,93,22.3,1010.5,Fair
6/8/2022 14:00,93,327,177301,259224,420,436525,WEDNESDAY,0,0,21.1,87,20.5,1010.1,Fair
6/8/2022 15:00,79,295,162753,231773,374,394526,WEDNESDAY,0,0,23.9,74,18.4,1009.9,Fair
6/8/2022 16:00,139,329,276565,311371,468,587936,WEDNESDAY,0,0,26.1,50,29.5,1009.8,Fair
6/8/2022 17:00,140,414,264577,364335,554,628912,WEDNESDAY,0,0,27.2,46,29.5,1009.7,Fair
6/8/2022 18:00,181,389,312577,303546,570,616123,WEDNESDAY,0,0,26.7,41,29.5,1010.1,Fair
6/8/2022 19:00,194,494,350207,396661,688,746868,WEDNESDAY,0,0,26.1,42,18.4,1009.8,Fair
6/8/2022 20:00,270,739,546350,1087477,1009,1633827,WEDNESDAY,0,0,26.1,42,18.4,1009.8,Fair
6/8/2022 21:00,465,1256,2035553,1152011,1721,3187564,WEDNESDAY,0,0,26.1,38,16.6,1009.9,Fair
6/8/2022 22:00,465,1100,1711494,2339996,1565,4051490,WEDNESDAY,0,0,25,40,20.5,1010.2,Fair
6/8/2022 23:00,331,777,804611,2399818,1108,3204429,WEDNESDAY,0,0,24.4,40,14.8,1010.6,Fair
6/9/2022 0:00,275,607,1320223,1372719,882,2692942,THURSDAY,0,0,24.4,40,14.8,1010.6,Fair
6/9/2022 1:00,145,371,575096,300581,516,875677,THURSDAY,0,0,23.3,46,9.4,1011.5,Fair
6/9/2022 2:00,168,292,508580,275802,460,784382,THURSDAY,0,0,23.3,46,9.4,1011.5,Fair
6/9/2022 3:00,193,278,2447378,243109,471,2690487,THURSDAY,0,0,21.1,55,0,1011,Fair
6/9/2022 4:00,113,120,193080,106239,233,299319,THURSDAY,0,0,21.1,55,0,1011,Fair
6/9/2022 5:00,37,50,205141,36429,87,241570,THURSDAY,0,0,18.3,78,5.4,1010.4,Fair
6/9/2022 6:00,14,19,43730,16055,33,59785,THURSDAY,0,0,17.8,84,5.4,1009.8,Fair
6/9/2022 7:00,5,8,10440,17312,13,27752,THURSDAY,0,0,17.8,84,0,1009.2,Fair
6/9/2022 8:00,5,14,38857,13361,19,52218,THURSDAY,0,0,17.2,90,9.4,1008.5,Fair
6/9/2022 9:00,8,64,4085,43717,72,47802,THURSDAY,0,0,17.2,90,9.4,1008.5,Fair
6/9/2022 10:00,15,114,13485,76789,129,90274,THURSDAY,0,0,16.7,96,13,1006.5,Cloudy
6/9/2022 11:00,13,105,10512,72288,118,82800,THURSDAY,0,0,17.2,97,13,1005.7,Fair
6/9/2022 12:00,13,184,1764116,121912,197,1886028,THURSDAY,0,0,17.2,97,13,1005.7,Fair
6/9/2022 13:00,12,152,9236,104182,164,113418,THURSDAY,0,0,16.7,100,20.5,1003.4,Fair
6/9/2022 14:00,57,278,100529,173898,335,274427,THURSDAY,0,0,17.2,97,7.6,1001.7,Fair
6/9/2022 15:00,55,310,229525,215449,365,444974,THURSDAY,0,0,23.9,79,24.1,1000.2,Fair
6/9/2022 16:00,119,369,280432,641642,488,922074,THURSDAY,0,0,26.1,69,22.3,999.5,Fair
6/9/2022 17:00,124,379,322397,282310,503,604707,THURSDAY,0,0,27.2,61,22.3,998.4,Fair
6/9/2022 18:00,166,372,427958,722032,538,1149990,THURSDAY,0,0,27.8,56,24.1,998.4,Fair
6/9/2022 19:00,187,413,4346016,368039,600,4714055,THURSDAY,0,0,27.8,56,24.1,998.4,Fair
6/9/2022 20:00,239,669,391773,567784,908,959557,THURSDAY,0,0,27.8,49,31.7,998.9,Fair
6/9/2022 21:00,377,1058,579583,995374,1435,1574957,THURSDAY,0,0,25,45,33.5,1000.5,Fair
6/9/2022 22:00,365,882,823721,873306,1247,1697027,THURSDAY,0,0,24.4,47,35.3,1001.7,Fair
6/9/2022 23:00,287,672,523511,771297,959,1294808,THURSDAY,0,0,24.4,47,31.7,1001.7,Fair
6/10/2022 0:00,262,526,3141427,450799,788,3592226,FRIDAY,0,0,21.7,57,14.8,1003.8,Fair
6/10/2022 1:00,149,317,2843137,401469,466,3244606,FRIDAY,0,0,21.1,59,16.6,1004.6,Fair
6/10/2022 2:00,120,245,1510887,199747,365,1710634,FRIDAY,0,0,20,61,20.5,1005,Fair
6/10/2022 3:00,84,140,119113,2034122,224,2153235,FRIDAY,0,0,18.9,63,22.3,1005.4,Fair
6/10/2022 4:00,52,59,2407293,39352,111,2446645,FRIDAY,0,0,18.9,63,22.3,1005.4,Fair
6/10/2022 5:00,39,29,59901,28865,68,88766,FRIDAY,0,0,17.8,65,20.5,1005.7,Fair
6/10/2022 6:00,22,33,25594,28473,55,54067,FRIDAY,0,0,17.2,65,16.6,1005.6,Fair
6/10/2022 7:00,6,9,10888,7593,15,18481,FRIDAY,0,0,16.7,67,14.8,1005.9,Fair
6/10/2022 8:00,11,18,13376,11665,29,25041,FRIDAY,0,0,16.1,70,16.6,1006.1,Cloudy
6/10/2022 9:00,12,69,10002,51408,81,61410,FRIDAY,0,0,16.1,70,16.6,1006.1,Cloudy
6/10/2022 10:00,30,193,40968,148583,223,189551,FRIDAY,0,0,17.2,67,18.4,1007.3,Fair
6/10/2022 11:00,54,400,74117,444219,454,518336,FRIDAY,0,0,18.3,63,18.4,1007.7,Fair
6/10/2022 12:00,123,765,229227,583737,888,812964,FRIDAY,0,0,20.6,55,14.8,1007.7,Fair
6/10/2022 13:00,115,568,227714,424687,683,652401,FRIDAY,0,0,20.6,55,14.8,1007.7,Fair
6/10/2022 14:00,146,398,664134,338259,544,1002393,FRIDAY,0,0,22.8,46,20.5,1007.9,Fair
6/10/2022 15:00,217,377,480682,313011,594,793693,FRIDAY,0,0,23.9,43,22.3,1008.1,Fair
6/10/2022 16:00,179,433,1413536,346371,612,1759907,FRIDAY,0,0,25,39,24.1,1008.1,Fair
6/10/2022 17:00,256,469,1625470,383505,725,2008975,FRIDAY,0,0,24.4,39,25.9,1007.8,Fair
6/10/2022 18:00,297,468,567753,371694,765,939447,FRIDAY,0,0,24.4,39,25.9,1007.8,Fair
6/10/2022 19:00,297,543,694314,472332,840,1166646,FRIDAY,0,0,24.4,37,20.5,1007.5,Fair
6/10/2022 20:00,377,735,576830,647514,1112,1224344,FRIDAY,0,0,24.4,35,20.5,1007.9,Fair
6/10/2022 21:00,383,972,764312,924373,1355,1688685,FRIDAY,0,0,24.4,33,18.4,1008.3,Fair
6/10/2022 22:00,472,830,1419723,1156349,1302,2576072,FRIDAY,0,0,24.4,35,18.4,1008.6,Fair
6/10/2022 23:00,460,663,889531,635594,1123,1525125,FRIDAY,0,0,24.4,35,18.4,1008.6,Fair
6/11/2022 0:00,346,536,1953964,468816,882,2422780,SATURDAY,1,0,22.2,40,16.6,1010.1,Fair
6/11/2022 1:00,266,362,1763410,326625,628,2090035,SATURDAY,1,0,21.7,39,13,1011.2,Fair
6/11/2022 2:00,201,273,356907,247463,474,604370,SATURDAY,1,0,20.6,42,13,1011.3,Fair
6/11/2022 3:00,468,373,4973535,362195,841,5335730,SATURDAY,1,0,20.6,42,13,1011.6,Fair
6/11/2022 4:00,369,252,2503965,238469,621,2742434,SATURDAY,1,0,20.6,42,13,1011.6,Fair
6/11/2022 5:00,324,156,3516307,182319,480,3698626,SATURDAY,1,0,18.9,47,13,1011.9,Fair
6/11/2022 6:00,128,95,442717,100613,223,543330,SATURDAY,1,0,18.3,50,13,1012,Fair
6/11/2022 7:00,22,23,92284,49316,45,141600,SATURDAY,1,0,18.3,50,11.2,1012.1,Fair
6/11/2022 8:00,7,11,8058,13204,18,21262,SATURDAY,1,0,18.3,52,13,1012.1,Fair
6/11/2022 9:00,13,31,2493489,26250,44,2519739,SATURDAY,1,0,18.3,52,13,1012.1,Fair
6/11/2022 10:00,10,63,8228,49105,73,57333,SATURDAY,1,0,18.3,52,14.8,1012.6,Fair
6/11/2022 11:00,29,118,1973713,106489,147,2080202,SATURDAY,1,0,18.3,52,16.6,1013.2,Fair
6/11/2022 12:00,61,215,148983,175395,276,324378,SATURDAY,1,0,20,51,11.2,1013.3,Fair
6/11/2022 13:00,139,315,378895,342279,454,721174,SATURDAY,1,0,20,51,11.2,1013.3,Fair
6/11/2022 14:00,321,431,1093247,429030,752,1522277,SATURDAY,1,0,22.2,48,5.4,1013.4,Fair
6/11/2022 15:00,399,498,1763011,458125,897,2221136,SATURDAY,1,0,23.9,43,7.6,1013,Fair
6/11/2022 16:00,496,545,1190500,531369,1041,1721869,SATURDAY,1,0,24.4,40,7.6,1012.7,Fair
6/11/2022 17:00,515,568,1196316,558798,1083,1755114,SATURDAY,1,0,25.6,30,24.1,1012.5,Fair
6/11/2022 18:00,535,556,1172510,528071,1091,1700581,SATURDAY,1,0,26.1,30,24.1,1012.2,Fair
6/11/2022 19:00,547,634,1360773,648506,1181,2009279,SATURDAY,1,0,26.1,30,24.1,1012.2,Fair
6/11/2022 20:00,538,594,1063817,614568,1132,1678385,SATURDAY,1,0,24.4,33,7.6,1011.7,Fair
6/11/2022 21:00,556,608,2025229,655580,1164,2680809,SATURDAY,1,0,24.4,36,14.8,1011.4,Fair
6/11/2022 22:00,541,586,3603725,800166,1127,4403891,SATURDAY,1,0,24.4,36,14.8,1011.4,Fair
6/11/2022 23:00,489,557,2492408,542884,1046,3035292,SATURDAY,1,0,23.3,33,13,1012.2,Fair
6/12/2022 0:00,318,397,850474,723271,715,1573745,SUNDAY,1,0,21.7,51,14.8,1012.8,Fair
6/12/2022 1:00,233,300,474790,277035,533,751825,SUNDAY,1,0,21.1,55,20.5,1013.4,Fair
6/12/2022 2:00,246,244,2234980,240836,490,2475816,SUNDAY,1,0,20.6,57,16.6,1013.6,Fair
6/12/2022 3:00,221,225,1240895,233772,446,1474667,SUNDAY,1,0,20.6,57,16.6,1013.6,Fair
6/12/2022 4:00,172,139,2272697,142322,311,2415019,SUNDAY,1,0,18.9,61,9.4,1013.6,Fair
6/12/2022 5:00,226,113,597269,123622,339,720891,SUNDAY,1,0,18.9,61,7.6,1013.9,Fair
6/12/2022 6:00,143,66,291956,66148,209,358104,SUNDAY,1,0,17.8,65,13,1014.4,Fair
6/12/2022 7:00,20,22,25620,24730,42,50350,SUNDAY,1,0,16.1,75,7.6,1014.8,Cloudy
6/12/2022 8:00,11,12,15194,9711,23,24905,SUNDAY,1,0,16.1,75,7.6,1014.8,Cloudy
6/12/2022 9:00,10,18,12458,17189,28,29647,SUNDAY,1,0,16.1,78,13,1015.6,Cloudy
6/12/2022 10:00,16,60,25173,62812,76,87985,SUNDAY,1,0,16.1,78,13,1015.6,Fair
6/12/2022 11:00,39,105,125211,85891,144,211102,SUNDAY,1,0,19.4,76,7.6,1016.1,Fair
6/12/2022 12:00,78,179,162319,167728,257,330047,SUNDAY,1,0,21.7,63,11.2,1015.8,Fair
6/12/2022 13:00,167,268,1292450,237195,435,1529645,SUNDAY,1,0,21.7,63,11.2,1015.8,Fair
6/12/2022 14:00,257,386,555975,351112,643,907087,SUNDAY,1,0,23.9,54,14.8,1016,Fair
6/12/2022 15:00,349,492,762372,484687,841,1247059,SUNDAY,1,0,24.4,48,14.8,1015.8,Fair
6/12/2022 16:00,469,566,2123346,3188657,1035,5312003,SUNDAY,1,0,23.9,50,14.8,1015.3,Fair
6/12/2022 17:00,484,605,3816158,871870,1089,4688028,SUNDAY,1,0,23.9,50,24.1,1015.3,Fair
6/12/2022 18:00,464,565,1813691,594956,1029,2408647,SUNDAY,1,0,23.9,58,25.9,1015.3,Fair
6/12/2022 19:00,549,628,1920527,646258,1177,2566785,SUNDAY,1,0,24.4,56,25.9,1014.3,Fair
6/12/2022 20:00,547,642,1391565,595051,1189,1986616,SUNDAY,1,0,23.9,55,25.9,1014.1,Cloudy
6/12/2022 21:00,489,638,4291621,1533179,1127,5824800,SUNDAY,1,0,22.8,61,24.1,1014.2,Cloudy
6/12/2022 22:00,406,612,1762187,1534026,1018,3296213,SUNDAY,1,0,21.7,66,20.5,1014.5,Cloudy
6/12/2022 23:00,264,507,2794927,472985,771,3267912,SUNDAY,1,0,21.7,66,20.5,1014.5,Cloudy
6/13/2022 0:00,178,310,388079,263368,488,651447,MONDAY,0,0,20,76,16.6,1014.5,Cloudy
6/13/2022 1:00,169,239,351347,190250,408,541597,MONDAY,0,0,18.9,84,13,1014.6,Cloudy
6/13/2022 2:00,96,138,162744,117046,234,279790,MONDAY,0,0,18.9,84,5.4,1014.6,Cloudy
6/13/2022 3:00,75,116,1370529,97503,191,1468032,MONDAY,0,0,18.9,84,5.4,1014.6,Rain
6/13/2022 4:00,30,41,203467,59898,71,263365,MONDAY,0,0,19.4,87,9.4,1013.9,Rain
6/13/2022 5:00,27,22,28825,20332,49,49157,MONDAY,0,0,18.9,90,9.4,1013.4,Rain
6/13/2022 6:00,10,15,12163,13774,25,25937,MONDAY,0,0,18.9,93,11.2,1012.8,Cloudy
6/13/2022 7:00,5,5,9569,3383,10,12952,MONDAY,0,0,18.9,93,11.2,1012.8,Cloudy
6/13/2022 8:00,1,3,1182,2127,4,3309,MONDAY,0,0,18.9,96,11.2,1012.4,Rain
6/13/2022 9:00,5,34,3203,25434,39,28637,MONDAY,0,0,18.9,96,11.2,1012.4,Cloudy
6/13/2022 10:00,25,173,21877,117407,198,139284,MONDAY,0,0,19.4,97,5.4,1011.8,Rain
6/13/2022 11:00,76,458,248555,341662,534,590217,MONDAY,0,0,20,93,11.2,1012.3,Rain
6/13/2022 12:00,127,874,168526,670222,1001,838748,MONDAY,0,0,20,93,11.2,1012.3,Cloudy
6/13/2022 13:00,83,546,117284,442357,629,559641,MONDAY,0,0,22.2,82,11.2,1012.3,Cloudy
6/13/2022 14:00,92,332,478004,252264,424,730268,MONDAY,0,0,25,66,9.4,1011.5,Cloudy
6/13/2022 15:00,146,341,317647,251313,487,568960,MONDAY,0,0,26.7,56,14.8,1011,Cloudy
6/13/2022 16:00,152,370,1931514,291477,522,2222991,MONDAY,0,0,24.4,67,0,1010.8,Fair
6/13/2022 17:00,181,368,387978,287596,549,675574,MONDAY,0,0,24.4,67,0,1010.8,Fair
6/13/2022 18:00,153,366,323023,306360,519,629383,MONDAY,0,0,27.2,53,11.2,1010.3,Cloudy
6/13/2022 19:00,204,459,715419,349622,663,1065041,MONDAY,0,0,24.4,76,16.6,1009.7,Clear
6/13/2022 20:00,246,649,462111,509161,895,971272,MONDAY,0,0,24.4,69,14.8,1009.3,Fair
6/13/2022 21:00,367,1235,715498,1075437,1602,1790935,MONDAY,0,0,28.9,33,14.8,1009.3,Fair
6/13/2022 22:00,390,935,1214758,817625,1325,2032383,MONDAY,0,0,28.9,33,14.8,1009.3,Fair
6/13/2022 23:00,348,841,1313257,743447,1189,2056704,MONDAY,0,0,27.2,32,22.3,1010.3,Cloudy
6/14/2022 0:00,268,587,496772,488573,855,985345,TUESDAY,0,0,25.6,26,14.8,1010.5,Cloudy
6/14/2022 1:00,147,357,276449,801748,504,1078197,TUESDAY,0,0,24.4,25,13,1010.8,Fair
6/14/2022 2:00,103,199,196993,155995,302,352988,TUESDAY,0,0,23.9,29,16.6,1011.1,Fair
6/14/2022 3:00,101,199,160433,466742,300,627175,TUESDAY,0,0,23.9,29,16.6,1011.1,Fair
6/14/2022 4:00,60,72,124939,55373,132,180312,TUESDAY,0,0,21.1,49,18.4,1011.8,Fair
6/14/2022 5:00,24,37,195037,27237,61,222274,TUESDAY,0,0,20.6,51,11.2,1011.8,Fair
6/14/2022 6:00,5,14,50562,9363,19,59925,TUESDAY,0,0,20,55,14.8,1012,Fair
6/14/2022 7:00,3,11,2057,9153,14,11210,TUESDAY,0,0,18.9,59,16.6,1012,Fair
6/14/2022 8:00,6,13,13488,12958,19,26446,TUESDAY,0,0,18.3,58,20.5,1012,Fair
6/14/2022 9:00,12,93,13515,69785,105,83300,TUESDAY,0,0,18.3,58,20.5,1012,Fair
6/14/2022 10:00,43,236,47090,174544,279,221634,TUESDAY,0,0,18.9,56,18.4,1012.1,Fair
6/14/2022 11:00,121,582,140144,477407,703,617551,TUESDAY,0,0,20,55,16.6,1012.3,Fair
6/14/2022 12:00,183,1134,282468,875320,1317,1157788,TUESDAY,0,0,21.7,49,20.5,1012.3,Fair
6/14/2022 13:00,126,619,237338,507267,745,744605,TUESDAY,0,0,21.7,49,20.5,1012.3,Fair
6/14/2022 14:00,121,366,264646,294686,487,559332,TUESDAY,0,0,24.4,40,18.4,1011.9,Fair
6/14/2022 15:00,187,309,375413,244621,496,620034,TUESDAY,0,0,25.6,37,9.4,1011.7,Fair
6/14/2022 16:00,206,417,1124629,365631,623,1490260,TUESDAY,0,0,26.1,36,11.2,1011.2,Fair
6/14/2022 17:00,162,370,349752,275631,532,625383,TUESDAY,0,0,26.1,36,11.2,1011.2,Fair
6/14/2022 18:00,249,374,1267528,335689,623,1603217,TUESDAY,0,0,24.4,42,13,1010.9,Fair
6/14/2022 19:00,244,497,471874,407138,741,879012,TUESDAY,0,0,25.6,39,13,1011.1,Fair
6/14/2022 20:00,308,806,543093,656591,1114,1199684,TUESDAY,0,0,23.3,50,11.2,1011.3,Fair
6/14/2022 21:00,519,1306,2751606,1121470,1825,3873076,TUESDAY,0,0,26.7,35,11.2,1011,Fair
6/14/2022 22:00,530,1084,2328461,1017612,1614,3346073,TUESDAY,0,0,26.7,35,22.3,1011,Cloudy
6/14/2022 23:00,374,752,3866139,710799,1126,4576938,TUESDAY,0,0,25.6,37,16.6,1011.3,Cloudy
6/15/2022 0:00,289,517,640969,517528,806,1158497,WEDNESDAY,0,0,25,40,16.6,1012,Fair
6/15/2022 1:00,241,423,411003,349121,664,760124,WEDNESDAY,0,0,23.9,45,11.2,1012.6,Fair
6/15/2022 2:00,251,296,1824720,250292,547,2075012,WEDNESDAY,0,0,23.9,45,11.2,1012.6,Fair
6/15/2022 3:00,68,134,86736,103315,202,190051,WEDNESDAY,0,0,22.2,49,14.8,1013.4,Fair
6/15/2022 4:00,43,57,71153,48440,100,119593,WEDNESDAY,0,0,21.1,53,14.8,1013.9,Fair
6/15/2022 5:00,17,20,20545,12668,37,33213,WEDNESDAY,0,0,19.4,63,14.8,1014.8,Fair
6/15/2022 6:00,6,14,6683,11138,20,17821,WEDNESDAY,0,0,17.8,75,18.4,1015.3,Fair
6/15/2022 7:00,7,4,37569,3677,11,41246,WEDNESDAY,0,0,16.7,80,11.2,1015.9,Fair
6/15/2022 8:00,4,11,1412815,12039,15,1424854,WEDNESDAY,0,0,16.7,80,11.2,1015.9,Fair
6/15/2022 9:00,12,82,17320,60557,94,77877,WEDNESDAY,0,0,16.7,84,13,1017.8,Fair
6/15/2022 10:00,40,231,85345,163331,271,248676,WEDNESDAY,0,0,17.2,84,13,1018.5,Fair
6/15/2022 11:00,101,614,1296150,492189,715,1788339,WEDNESDAY,0,0,17.2,84,13,1018.5,Fair
6/15/2022 12:00,185,1118,196407,1903773,1303,2100180,WEDNESDAY,0,0,17.8,81,14.8,1018.7,Fair
6/15/2022 13:00,106,609,174208,609222,715,783430,WEDNESDAY,0,0,18.9,75,22.3,1019.9,Fair
6/15/2022 14:00,129,362,274335,290639,491,564974,WEDNESDAY,0,0,19.4,71,20.5,1019.9,Fair
6/15/2022 15:00,144,364,259537,261745,508,521282,WEDNESDAY,0,0,19.4,66,18.4,1020.7,Fair
6/15/2022 16:00,169,423,296262,325326,592,621588,WEDNESDAY,0,0,19.4,71,18.4,1021.1,Fair
6/15/2022 17:00,151,398,277435,474378,549,751813,WEDNESDAY,0,0,19.4,71,18.4,1021.1,Fair
6/15/2022 18:00,171,411,361503,334725,582,696228,WEDNESDAY,0,0,20,68,14.8,1021,Fair
6/15/2022 19:00,244,501,615230,406452,745,1021682,WEDNESDAY,0,0,20,63,16.6,1020.6,Cloudy
6/15/2022 20:00,298,814,488157,693542,1112,1181699,WEDNESDAY,0,0,20,65,13,1020.2,Cloudy
6/15/2022 21:00,498,1258,775760,1102900,1756,1878660,WEDNESDAY,0,0,20.6,55,18.4,1020,Cloudy
6/15/2022 22:00,476,1151,846711,1110952,1627,1957663,WEDNESDAY,0,0,20.6,55,18.4,1020,Cloudy
6/15/2022 23:00,323,721,631168,1349917,1044,1981085,WEDNESDAY,0,0,19.4,49,0,1021.3,Cloudy
6/16/2022 0:00,261,595,724158,509197,856,1233355,THURSDAY,0,0,18.3,56,9.4,1021.8,Cloudy
6/16/2022 1:00,187,393,356618,356684,580,713302,THURSDAY,0,0,17.2,67,11.2,1022.1,Cloudy
6/16/2022 2:00,216,292,304335,251324,508,555659,THURSDAY,0,0,17.2,67,11.2,1022.1,Fair
6/16/2022 3:00,102,148,2693425,119403,250,2812828,THURSDAY,0,0,16.7,70,9.4,1022.2,Fair
6/16/2022 4:00,44,75,59114,51305,119,110419,THURSDAY,0,0,15,81,9.4,1022.4,Fair
6/16/2022 5:00,36,30,98324,25572,66,123896,THURSDAY,0,0,15,83,7.6,1022.4,Fair
6/16/2022 6:00,7,11,36238,6988,18,43226,THURSDAY,0,0,15.6,78,7.6,1022.2,Fair
6/16/2022 7:00,12,5,24572,4214,17,28786,THURSDAY,0,0,15.6,78,7.6,1022.2,Fair
6/16/2022 8:00,5,14,8466,18715,19,27181,THURSDAY,0,0,14.4,87,9.4,1022.2,Fair
6/16/2022 9:00,14,83,15411,61857,97,77268,THURSDAY,0,0,15,87,11.2,1022.4,Fair
6/16/2022 10:00,35,244,607444,185934,279,793378,THURSDAY,0,0,16.7,80,11.2,1022.6,Fair
6/16/2022 11:00,95,568,100796,457791,663,558587,THURSDAY,0,0,19.4,73,14.8,1022.6,Cloudy
6/16/2022 12:00,170,1102,211625,808389,1272,1020014,THURSDAY,0,0,19.4,73,14.8,1022.6,Cloudy
6/16/2022 13:00,145,589,276702,2108578,734,2385280,THURSDAY,0,0,21.1,61,18.4,1021.6,Cloudy
6/16/2022 14:00,117,390,276119,1638761,507,1914880,THURSDAY,0,0,21.7,59,20.5,1021.3,Cloudy
6/16/2022 15:00,147,366,268435,322273,513,590708,THURSDAY,0,0,21.1,55,20.5,1021,Cloudy
6/16/2022 16:00,200,473,511357,356453,673,867810,THURSDAY,0,0,20.6,55,25.9,1020.7,Cloudy
6/16/2022 17:00,210,444,2164975,336064,654,2501039,THURSDAY,0,0,20.6,55,25.9,1020.7,Cloudy
6/16/2022 18:00,184,387,345882,300920,571,646802,THURSDAY,0,0,20.6,51,24.1,1020.1,Cloudy
6/16/2022 19:00,234,489,403640,409827,723,813467,THURSDAY,0,0,22.8,44,31.7,1017.9,Cloudy
6/16/2022 20:00,355,807,2066146,677702,1162,2743848,THURSDAY,0,0,21.1,49,31.7,1016.7,Cloudy
6/16/2022 21:00,489,1291,741038,1140462,1780,1881500,THURSDAY,0,0,21.7,51,29.5,1015.3,Cloudy
6/16/2022 22:00,411,1049,2543524,939807,1460,3483331,THURSDAY,0,0,21.7,51,29.5,1015.3,Cloudy
6/16/2022 23:00,435,820,705899,714264,1255,1420163,THURSDAY,0,0,20,61,20.5,1016.1,Cloudy
6/17/2022 0:00,334,633,1027395,550618,967,1578013,FRIDAY,0,0,18.9,73,20.5,1015.8,Cloudy
6/17/2022 1:00,206,353,438950,290301,559,729251,FRIDAY,0,0,18.3,76,20.5,1014.6,Cloudy
6/17/2022 2:00,163,275,202265,218044,438,420309,FRIDAY,0,0,18.3,76,20.5,1014.6,Cloudy
6/17/2022 3:00,238,309,1706701,303733,547,2010434,FRIDAY,0,0,18.9,73,24.1,1013.3,Cloudy
6/17/2022 4:00,157,151,582501,115197,308,697698,FRIDAY,0,0,19.4,71,18.4,1012.2,Cloudy
6/17/2022 5:00,58,66,2181537,62482,124,2244019,FRIDAY,0,0,19.4,71,24.1,1011.2,Cloudy
6/17/2022 6:00,40,23,107374,19441,63,126815,FRIDAY,0,0,19.4,71,24.1,1011.2,Cloudy
6/17/2022 7:00,10,12,12540,11932,22,24472,FRIDAY,0,0,20,73,22.3,1009.1,Cloudy
6/17/2022 8:00,16,13,22720,9476,29,32196,FRIDAY,0,0,20,73,22.3,1009.1,Cloudy
6/17/2022 9:00,10,72,489678,51362,82,541040,FRIDAY,0,0,20,78,24.1,1007.8,Cloudy
6/17/2022 10:00,32,191,43668,133088,223,176756,FRIDAY,0,0,20.6,81,18.4,1007.2,Cloudy
6/17/2022 11:00,59,427,227714,334051,486,561765,FRIDAY,0,0,20.6,81,18.4,1007.2,Cloudy
6/17/2022 12:00,114,785,156145,1017303,899,1173448,FRIDAY,0,0,22.8,76,20.5,1006,Cloudy
6/17/2022 13:00,128,542,388995,411697,670,800692,FRIDAY,0,0,24.4,71,20.5,1004.7,Cloudy
6/17/2022 14:00,163,345,320166,269005,508,589171,FRIDAY,0,0,26.1,65,24.1,1004.1,Cloudy
6/17/2022 15:00,176,388,356750,307172,564,663922,FRIDAY,0,0,26.7,62,29.5,1003.2,Cloudy
6/17/2022 16:00,257,458,1418716,332178,715,1750894,FRIDAY,0,0,28.9,57,20.5,1002,Fair
6/17/2022 17:00,241,448,441442,339612,689,781054,FRIDAY,0,0,28.9,57,20.5,1002,Cloudy
6/17/2022 18:00,220,425,1563878,332277,645,1896155,FRIDAY,0,0,26.1,50,22.3,1000.5,Cloudy
6/17/2022 19:00,276,521,564049,630538,797,1194587,FRIDAY,0,0,26.1,58,24.1,1000.3,Cloudy
6/17/2022 20:00,318,702,569833,612307,1020,1182140,FRIDAY,0,0,26.1,58,20.5,999.7,Cloudy
6/17/2022 21:00,402,913,747850,795009,1315,1542859,FRIDAY,0,0,28.3,46,22.3,999.6,Cloudy
6/17/2022 22:00,422,861,2147643,817059,1283,2964702,FRIDAY,0,0,28.3,46,22.3,999.6,Cloudy
6/17/2022 23:00,380,711,1146826,676910,1091,1823736,FRIDAY,0,0,27.8,32,24.1,1000.6,Cloudy
6/18/2022 0:00,337,527,646631,498448,864,1145079,SATURDAY,1,0,26.1,35,22.3,1001,Cloudy
6/18/2022 1:00,288,344,1021875,308302,632,1330177,SATURDAY,1,0,25,37,20.5,1001.5,Fair
6/18/2022 2:00,314,285,3497659,259579,599,3757238,SATURDAY,1,0,25,37,20.5,1001.5,Fair
6/18/2022 3:00,232,268,1671592,285131,500,1956723,SATURDAY,1,0,23.3,41,24.1,1000,Fair
6/18/2022 4:00,169,166,731266,150193,335,881459,SATURDAY,1,0,22.8,43,18.4,999.2,Fair
6/18/2022 5:00,207,155,2405460,151606,362,2557066,SATURDAY,1,0,22.8,43,24.1,999,Fair
6/18/2022 6:00,150,79,611985,81010,229,692995,SATURDAY,1,0,22.2,43,24.1,999,Fair
6/18/2022 7:00,24,28,38618,23495,52,62113,SATURDAY,1,0,22.2,43,27.7,999,Fair
6/18/2022 8:00,13,11,17480,22246,24,39726,SATURDAY,1,0,21.1,47,29.5,999,Fair
6/18/2022 9:00,5,30,52697,24605,35,77302,SATURDAY,1,0,20.6,49,20.5,999.5,Fair
6/18/2022 10:00,31,74,2020284,45197,105,2065481,SATURDAY,1,0,20,53,18.4,1000.3,Cloudy
6/18/2022 11:00,37,132,885250,107416,169,992666,SATURDAY,1,0,18.3,61,18.4,1001.5,Cloudy
6/18/2022 12:00,64,219,287008,181590,283,468598,SATURDAY,1,0,18.3,61,27.7,1001.5,Cloudy
6/18/2022 13:00,169,370,427550,295309,539,722859,SATURDAY,1,0,18.9,47,25.9,1001.9,Cloudy
6/18/2022 14:00,235,454,456496,402462,689,858958,SATURDAY,1,0,18.9,45,25.9,1002.4,Cloudy
6/18/2022 15:00,382,492,927179,457195,874,1384374,SATURDAY,1,0,19.4,44,25.9,1002.3,Cloudy
6/18/2022 16:00,461,621,1210277,549299,1082,1759576,SATURDAY,1,0,19.4,44,31.7,1002.3,Cloudy
6/18/2022 17:00,525,608,1173393,720571,1133,1893964,SATURDAY,1,0,20.6,41,24.1,1002.7,Cloudy
6/18/2022 18:00,512,576,1451647,537475,1088,1989122,SATURDAY,1,0,20,44,24.1,1003.2,Cloudy
6/18/2022 19:00,518,588,1066127,574546,1106,1640673,SATURDAY,1,0,19.4,45,24.1,1003.7,Cloudy
6/18/2022 20:00,496,551,913533,545028,1047,1458561,SATURDAY,1,0,17.8,48,29.5,1004.5,Cloudy
6/18/2022 21:00,375,568,1320607,523348,943,1843955,SATURDAY,1,0,17.8,48,33.5,1004.5,Cloudy
6/18/2022 22:00,328,481,527019,418539,809,945558,SATURDAY,1,0,16.7,50,20.5,1005.3,Cloudy
6/18/2022 23:00,231,378,494826,316753,609,811579,SATURDAY,1,0,16.1,50,20.5,1006.2,Cloudy
6/19/2022 0:00,154,337,238287,448435,491,686722,SUNDAY,1,1,15,53,31.7,1006.7,Cloudy
6/19/2022 1:00,127,220,265888,156159,347,422047,SUNDAY,1,1,13.9,62,22.3,1007.1,Rain
6/19/2022 2:00,145,194,322195,159591,339,481786,SUNDAY,1,1,13.9,62,22.3,1007.1,Rain
6/19/2022 3:00,130,162,3356618,151800,292,3508418,SUNDAY,1,1,13.3,64,33.5,1006.8,Rain
6/19/2022 4:00,69,79,86005,59322,148,145327,SUNDAY,1,1,12.8,69,22.3,1006.9,Rain
6/19/2022 5:00,117,61,2213960,51688,178,2265648,SUNDAY,1,1,12.8,69,22.3,1006.9,Rain
6/19/2022 6:00,39,38,98140,32207,77,130347,SUNDAY,1,1,11.7,83,14.8,1007.6,Rain
6/19/2022 7:00,17,5,24791,3815,22,28606,SUNDAY,1,1,11.7,83,14.8,1007.6,Rain
6/19/2022 8:00,3,1,4496,471,4,4967,SUNDAY,1,1,11.1,86,22.3,1008.5,Rain
6/19/2022 9:00,4,9,2520,8783,13,11303,SUNDAY,1,1,11.1,86,24.1,1008.9,Rain
6/19/2022 10:00,1,16,1805,9868,17,11673,SUNDAY,1,1,10.6,89,22.3,1009.4,Rain
6/19/2022 11:00,12,26,22830,15169,38,37999,SUNDAY,1,1,10.6,89,22.3,1009.4,Cloudy
6/19/2022 12:00,20,82,39105,60946,102,100051,SUNDAY,1,1,12.2,77,18.4,1009.2,Rain
6/19/2022 13:00,72,225,132071,153963,297,286034,SUNDAY,1,1,12.8,69,18.4,1009.3,Cloudy
6/19/2022 14:00,172,306,492378,340144,478,832522,SUNDAY,1,1,15.6,55,20.5,1009.3,Cloudy
6/19/2022 15:00,218,413,483944,397433,631,881377,SUNDAY,1,1,15,49,20.5,1009.7,Cloudy
6/19/2022 16:00,347,426,754353,384372,773,1138725,SUNDAY,1,1,15,49,25.9,1009.7,Cloudy
6/19/2022 17:00,280,426,700057,1781161,706,2481218,SUNDAY,1,1,16.1,44,16.6,1010.4,Cloudy
6/19/2022 18:00,322,437,872877,2148648,759,3021525,SUNDAY,1,1,16.1,44,20.5,1011,Cloudy
6/19/2022 19:00,241,415,541289,356296,656,897585,SUNDAY,1,1,15.6,47,20.5,1011.9,Cloudy
6/19/2022 20:00,315,467,592177,528154,782,1120331,SUNDAY,1,1,15,49,22.3,1012.7,Cloudy
6/19/2022 21:00,249,507,1679374,440868,756,2120242,SUNDAY,1,1,15,49,22.3,1012.7,Cloudy
6/19/2022 22:00,231,430,420376,377765,661,798141,SUNDAY,1,1,14.4,56,5.4,1013.8,Cloudy
6/19/2022 23:00,196,343,716422,290870,539,1007292,SUNDAY,1,1,14.4,56,5.4,1013.8,Cloudy
6/20/2022 0:00,136,298,1036690,258894,434,1295584,MONDAY,0,1,12.8,74,7.6,1014.4,Cloudy
6/20/2022 1:00,107,184,231425,179970,291,411395,MONDAY,0,1,13.3,72,7.6,1014.9,Cloudy
6/20/2022 2:00,47,149,74662,167059,196,241721,MONDAY,0,1,13.3,72,7.6,1014.9,Cloudy
6/20/2022 3:00,39,79,69556,56865,118,126421,MONDAY,0,1,13.3,69,9.4,1015.3,Cloudy
6/20/2022 4:00,39,47,1329428,29539,86,1358967,MONDAY,0,1,12.8,77,11.2,1015.2,Cloudy
6/20/2022 5:00,29,25,60915,23292,54,84207,MONDAY,0,1,12.8,74,5.4,1015.1,Cloudy
6/20/2022 6:00,13,21,14401,15464,34,29865,MONDAY,0,1,12.8,74,5.4,1015.1,Cloudy
6/20/2022 7:00,9,9,13147,4980,18,18127,MONDAY,0,1,11.1,86,5.4,1014.7,Cloudy
6/20/2022 8:00,5,15,6448,15300,20,21748,MONDAY,0,1,11.1,89,0,1015.6,Cloudy
6/20/2022 9:00,7,47,8225,36166,54,44391,MONDAY,0,1,11.7,89,0,1016.3,Fair
6/20/2022 10:00,25,121,31887,88386,146,120273,MONDAY,0,1,14.4,67,11.2,1016.9,Fair
6/20/2022 11:00,47,262,67209,201594,309,268803,MONDAY,0,1,14.4,67,11.2,1016.9,Fair
6/20/2022 12:00,77,460,154240,389741,537,543981,MONDAY,0,1,18.3,47,16.6,1017.5,Fair
6/20/2022 13:00,120,448,286849,355885,568,642734,MONDAY,0,1,20,40,18.4,1017.4,Fair
6/20/2022 14:00,163,414,489384,354810,577,844194,MONDAY,0,1,21.7,32,13,1017.2,Fair
6/20/2022 15:00,280,442,720716,371422,722,1092138,MONDAY,0,1,22.8,28,13,1017.1,Fair
6/20/2022 16:00,342,562,854642,496734,904,1351376,MONDAY,0,1,22.8,28,27.7,1017.1,Fair
6/20/2022 17:00,362,458,1483493,451806,820,1935299,MONDAY,0,1,25,25,18.4,1016.7,Fair
6/20/2022 18:00,386,532,2756459,518444,918,3274903,MONDAY,0,1,25.6,23,14.8,1016.6,Fair
6/20/2022 19:00,387,577,760708,1148091,964,1908799,MONDAY,0,1,20.6,41,14.8,1017,Fair
6/20/2022 20:00,430,736,2982974,699531,1166,3682505,MONDAY,0,1,20.6,41,27.7,1017,Fair
6/20/2022 21:00,491,880,1891336,770878,1371,2662214,MONDAY,0,1,18.3,54,22.3,1017.5,Rain
6/20/2022 22:00,448,925,1290054,846992,1373,2137046,MONDAY,0,1,17.2,60,20.5,1018.3,Fair
6/20/2022 23:00,344,648,727142,560068,992,1287210,MONDAY,0,1,16.7,56,14.8,1018.2,Cloudy
6/21/2022 0:00,233,489,346139,775142,722,1121281,TUESDAY,0,0,16.1,60,11.2,1018.8,Cloudy
6/21/2022 1:00,188,312,670202,236457,500,906659,TUESDAY,0,0,15.6,67,9.4,1019.6,Cloudy
6/21/2022 2:00,201,227,281109,185675,428,466784,TUESDAY,0,0,15.6,67,9.4,1019.6,Cloudy
6/21/2022 3:00,43,100,85179,140075,143,225254,TUESDAY,0,0,14.4,70,9.4,1019.8,Cloudy
6/21/2022 4:00,30,40,47577,37129,70,84706,TUESDAY,0,0,13.9,72,9.4,1019.9,Cloudy
6/21/2022 5:00,9,31,11947,23023,40,34970,TUESDAY,0,0,13.3,77,7.6,1020,Cloudy
6/21/2022 6:00,6,14,11309,14402,20,25711,TUESDAY,0,0,13.3,77,7.6,1020,Fair
6/21/2022 7:00,6,11,5271,9840,17,15111,TUESDAY,0,0,15,72,0,1020.4,Fair
6/21/2022 8:00,6,15,9439,15697,21,25136,TUESDAY,0,0,12.2,86,7.6,1020.8,Fair
6/21/2022 9:00,16,64,25107,42979,80,68086,TUESDAY,0,0,13.3,80,9.4,1021.2,Fair
6/21/2022 10:00,45,258,50469,198498,303,248967,TUESDAY,0,0,15.6,75,7.6,1022,Fair
6/21/2022 11:00,97,613,124041,518477,710,642518,TUESDAY,0,0,15.6,75,7.6,1022,Cloudy
6/21/2022 12:00,167,1096,229592,853941,1263,1083533,TUESDAY,0,0,16.1,84,11.2,1022.1,Cloudy
6/21/2022 13:00,106,570,238646,432630,676,671276,TUESDAY,0,0,18.9,70,9.4,1022.2,Cloudy
6/21/2022 14:00,130,377,317342,2104863,507,2422205,TUESDAY,0,0,18.9,73,14.8,1021.8,Cloudy
6/21/2022 15:00,128,389,231248,311976,517,543224,TUESDAY,0,0,18.9,68,20.5,1021.8,Fair
6/21/2022 16:00,164,398,347625,295110,562,642735,TUESDAY,0,0,18.9,68,20.5,1021.8,Fair
6/21/2022 17:00,184,363,1329022,286116,547,1615138,TUESDAY,0,0,20,63,20.5,1021.3,Fair
6/21/2022 18:00,198,374,419967,493589,572,913556,TUESDAY,0,0,20,63,24.1,1020.7,Fair
6/21/2022 19:00,231,508,1758448,421779,739,2180227,TUESDAY,0,0,20,63,24.1,1020.2,Cloudy
6/21/2022 20:00,299,806,566307,704504,1105,1270811,TUESDAY,0,0,20,63,31.7,1020.2,Fair
6/21/2022 21:00,454,1366,1515946,1179626,1820,2695572,TUESDAY,0,0,20,63,29.5,1019.5,Fair
6/21/2022 22:00,481,1099,2315470,1006606,1580,3322076,TUESDAY,0,0,20,61,16.6,1019.4,Fair
6/21/2022 23:00,320,820,632666,679041,1140,1311707,TUESDAY,0,0,20,53,18.4,1019.7,Cloudy
6/22/2022 0:00,203,574,380892,494350,777,875242,WEDNESDAY,0,0,18.3,56,16.6,1020.1,Cloudy
6/22/2022 1:00,164,390,225359,316006,554,541365,WEDNESDAY,0,0,17.2,70,20.5,1020.7,Cloudy
6/22/2022 2:00,184,239,607406,205536,423,812942,WEDNESDAY,0,0,17.2,70,20.5,1020.7,Cloudy
6/22/2022 3:00,64,130,94483,97202,194,191685,WEDNESDAY,0,0,15,87,14.8,1020.6,Fair
6/22/2022 4:00,37,45,44051,29740,82,73791,WEDNESDAY,0,0,15,87,14.8,1020.6,Cloudy
6/22/2022 5:00,14,25,20330,29248,39,49578,WEDNESDAY,0,0,15,87,5.4,1020.1,Fair
6/22/2022 6:00,10,14,17702,13611,24,31313,WEDNESDAY,0,0,15,87,5.4,1020.1,Fair
6/22/2022 7:00,1,10,2743,9454,11,12197,WEDNESDAY,0,0,13.9,93,9.4,1019.8,Fair
6/22/2022 8:00,5,11,18882,14327,16,33209,WEDNESDAY,0,0,14.4,90,11.2,1019.8,Cloudy
6/22/2022 9:00,13,79,8646,50754,92,59400,WEDNESDAY,0,0,15,87,11.2,1019.8,Cloudy
6/22/2022 10:00,42,261,58005,179670,303,237675,WEDNESDAY,0,0,15,87,16.6,1020.2,Cloudy
6/22/2022 11:00,82,595,200802,503164,677,703966,WEDNESDAY,0,0,15,87,16.6,1020.2,Cloudy
6/22/2022 12:00,172,1120,222246,898172,1292,1120418,WEDNESDAY,0,0,17.2,75,22.3,1020,Cloudy
6/22/2022 13:00,104,681,182557,514380,785,696937,WEDNESDAY,0,0,17.8,75,18.4,1020.1,Cloudy
6/22/2022 14:00,99,432,195640,335601,531,531241,WEDNESDAY,0,0,18.3,73,20.5,1020,Cloudy
6/22/2022 15:00,163,369,572614,260431,532,833045,WEDNESDAY,0,0,18.3,73,20.5,1020,Cloudy
6/22/2022 16:00,132,411,275915,332287,543,608202,WEDNESDAY,0,0,18.9,70,33.5,1019.6,Cloudy
6/22/2022 17:00,175,403,304220,325938,578,630158,WEDNESDAY,0,0,19.4,68,33.5,1019.4,Cloudy
6/22/2022 18:00,197,431,641139,350211,628,991350,WEDNESDAY,0,0,19.4,68,31.7,1019,Cloudy
6/22/2022 19:00,186,481,382717,390116,667,772833,WEDNESDAY,0,0,18.9,70,33.5,1018.9,Cloudy
6/22/2022 20:00,290,783,663983,674477,1073,1338460,WEDNESDAY,0,0,18.9,70,31.7,1018.9,Cloudy
6/22/2022 21:00,460,1293,776752,1545314,1753,2322066,WEDNESDAY,0,0,17.8,78,27.7,1018.7,Cloudy
6/22/2022 22:00,432,1089,1233478,913589,1521,2147067,WEDNESDAY,0,0,16.7,84,27.7,1018.6,Fair
6/22/2022 23:00,330,759,623537,1024910,1089,1648447,WEDNESDAY,0,0,15.6,90,18.4,1018.4,Fair
6/23/2022 0:00,171,546,733545,475286,717,1208831,THURSDAY,0,0,15.6,90,16.6,1018.3,Fair
6/23/2022 1:00,136,381,274408,371912,517,646320,THURSDAY,0,0,15.6,90,16.6,1018.3,Fair
6/23/2022 2:00,186,276,350876,311442,462,662318,THURSDAY,0,0,15,96,9.4,1018.5,Fair
6/23/2022 3:00,72,147,166496,104701,219,271197,THURSDAY,0,0,15,96,9.4,1018.5,Fair
6/23/2022 4:00,43,50,112297,67413,93,179710,THURSDAY,0,0,15.6,93,9.4,1018.1,Fair
6/23/2022 5:00,22,21,24677,17827,43,42504,THURSDAY,0,0,15.6,93,9.4,1018.1,Cloudy
6/23/2022 6:00,7,13,30258,9703,20,39961,THURSDAY,0,0,15.6,93,5.4,1017.7,Cloudy
6/23/2022 7:00,3,7,3603,6565,10,10168,THURSDAY,0,0,15,93,0,1017.4,Cloudy
6/23/2022 8:00,6,12,6351,11988,18,18339,THURSDAY,0,0,15,93,0,1017.4,Cloudy
6/23/2022 9:00,15,73,14878,57216,88,72094,THURSDAY,0,0,15,96,9.4,1017.4,Cloudy
6/23/2022 10:00,33,218,31827,143902,251,175729,THURSDAY,0,0,15,100,11.2,1017.5,Cloudy
6/23/2022 11:00,88,573,147357,437708,661,585065,THURSDAY,0,0,15,100,11.2,1017.3,Cloudy
6/23/2022 12:00,165,1099,220591,883052,1264,1103643,THURSDAY,0,0,16.7,90,9.4,1017.4,Cloudy
6/23/2022 13:00,112,614,173207,461814,726,635021,THURSDAY,0,0,18.3,81,16.6,1017.4,Cloudy
6/23/2022 14:00,125,379,290163,299334,504,589497,THURSDAY,0,0,19.4,79,20.5,1017.3,Cloudy
6/23/2022 15:00,157,375,374895,295001,532,669896,THURSDAY,0,0,19.4,79,20.5,1017.3,Cloudy
6/23/2022 16:00,163,446,293657,355381,609,649038,THURSDAY,0,0,18.9,81,20.5,1017.6,Fair
6/23/2022 17:00,177,418,364948,302408,595,667356,THURSDAY,0,0,18.9,81,20.5,1016.8,Cloudy
6/23/2022 18:00,144,326,237303,293290,470,530593,THURSDAY,0,0,19.4,76,20.5,1016.2,Cloudy
6/23/2022 19:00,208,434,807803,363868,642,1171671,THURSDAY,0,0,20,73,31.7,1015.7,Cloudy
6/23/2022 20:00,257,745,615500,625677,1002,1241177,THURSDAY,0,0,20,73,31.7,1015.7,Cloudy
6/23/2022 21:00,396,1277,723475,1131823,1673,1855298,THURSDAY,0,0,20,68,33.5,1015.1,Cloudy
6/23/2022 22:00,524,1136,2221607,1033211,1660,3254818,THURSDAY,0,0,18.9,65,24.1,1015.6,Cloudy
6/23/2022 23:00,354,776,684711,674878,1130,1359589,THURSDAY,0,0,17.2,72,20.5,1016.1,Cloudy
6/24/2022 0:00,257,538,551615,451022,795,1002637,FRIDAY,0,0,17.2,72,20.5,1016.1,Cloudy
6/24/2022 1:00,183,386,520541,346971,569,867512,FRIDAY,0,0,16.7,80,16.6,1016.4,Cloudy
6/24/2022 2:00,149,252,1243668,1508394,401,2752062,FRIDAY,0,0,16.1,87,7.6,1016.2,Cloudy
6/24/2022 3:00,89,180,253596,173729,269,427325,FRIDAY,0,0,15.6,90,7.6,1016.3,Cloudy
6/24/2022 4:00,46,80,248242,61468,126,309710,FRIDAY,0,0,15.6,90,7.6,1015.9,Cloudy
6/24/2022 5:00,36,28,92423,27907,64,120330,FRIDAY,0,0,15.6,90,7.6,1015.9,Cloudy
6/24/2022 6:00,27,20,66520,15885,47,82405,FRIDAY,0,0,15.6,86,7.6,1015.7,Cloudy
6/24/2022 7:00,10,8,22018,6107,18,28125,FRIDAY,0,0,15.6,86,5.4,1015.3,Cloudy
6/24/2022 8:00,15,18,60085,24167,33,84252,FRIDAY,0,0,15.6,86,7.6,1015.5,Cloudy
6/24/2022 9:00,14,62,9908,39966,76,49874,FRIDAY,0,0,17.2,72,7.6,1015.5,Cloudy
6/24/2022 10:00,45,199,186723,136706,244,323429,FRIDAY,0,0,17.2,72,7.6,1015.5,Cloudy
6/24/2022 11:00,88,460,209541,354810,548,564351,FRIDAY,0,0,18.3,73,7.6,1015.8,Cloudy
6/24/2022 12:00,138,851,193893,665304,989,859197,FRIDAY,0,0,18.9,70,9.4,1015.9,Cloudy
6/24/2022 13:00,123,558,691341,377610,681,1068951,FRIDAY,0,0,19.4,71,7.6,1015.8,Cloudy
6/24/2022 14:00,181,413,432793,319900,594,752693,FRIDAY,0,0,19.4,71,7.6,1015.8,Cloudy
6/24/2022 15:00,189,388,2060403,601000,577,2661403,FRIDAY,0,0,21.7,63,11.2,1015.5,Cloudy
6/24/2022 16:00,255,492,2405573,371466,747,2777039,FRIDAY,0,0,21.7,63,13,1015.2,Cloudy
6/24/2022 17:00,284,494,511296,481453,778,992749,FRIDAY,0,0,25.6,56,13,1014.9,Cloudy
6/24/2022 18:00,332,476,701421,414746,808,1116167,FRIDAY,0,0,23.3,62,16.6,1015,Cloudy
6/24/2022 19:00,292,588,734320,488122,880,1222442,FRIDAY,0,0,23.9,55,16.6,1015,Cloudy
6/24/2022 20:00,342,805,609524,804887,1147,1414411,FRIDAY,0,0,23.9,55,25.9,1015,Cloudy
6/24/2022 21:00,535,1064,2507109,962926,1599,3470035,FRIDAY,0,0,23.3,60,20.5,1014.9,Cloudy
6/24/2022 22:00,480,974,839380,867759,1454,1707139,FRIDAY,0,0,22.8,61,20.5,1015,Cloudy
6/24/2022 23:00,406,779,731384,741746,1185,1473130,FRIDAY,0,0,22.8,61,20.5,1015,Cloudy
6/25/2022 0:00,340,515,702200,1253161,855,1955361,SATURDAY,1,0,21.1,71,14.8,1015.5,Cloudy
6/25/2022 1:00,246,359,515955,300150,605,816105,SATURDAY,1,0,22.2,76,14.8,1016,Cloudy
6/25/2022 2:00,208,277,379171,251101,485,630272,SATURDAY,1,0,22.2,76,14.8,1016.4,Fair
6/25/2022 3:00,177,247,3663977,219606,424,3883583,SATURDAY,1,0,21.1,78,5.4,1016.5,Fair
6/25/2022 4:00,166,173,494464,141308,339,635772,SATURDAY,1,0,20,87,9.4,1016.6,Fair
6/25/2022 5:00,238,155,873095,170607,393,1043702,SATURDAY,1,0,20,87,9.4,1016.6,Fair
6/25/2022 6:00,96,62,559879,81090,158,640969,SATURDAY,1,0,20.6,84,13,1016.4,Fair
6/25/2022 7:00,23,31,99164,30625,54,129789,SATURDAY,1,0,20.6,81,14.8,1016.4,Fair
6/25/2022 8:00,14,15,499270,10013,29,509283,SATURDAY,1,0,20,81,9.4,1017.1,Fair
6/25/2022 9:00,9,24,12217,25194,33,37411,SATURDAY,1,0,20,78,11.2,1017.9,Fair
6/25/2022 10:00,13,66,16736,83071,79,99807,SATURDAY,1,0,20,78,11.2,1017.9,Fair
6/25/2022 11:00,53,155,84966,140617,208,225583,SATURDAY,1,0,23.3,56,11.2,1018.7,Fair
6/25/2022 12:00,122,275,247011,248975,397,495986,SATURDAY,1,0,25.6,48,7.6,1018.8,Fair
6/25/2022 13:00,198,401,485675,379960,599,865635,SATURDAY,1,0,25.6,50,9.4,1018.7,Fair
6/25/2022 14:00,288,475,1122089,471881,763,1593970,SATURDAY,1,0,26.1,47,13,1018.8,Fair
6/25/2022 15:00,450,587,1684485,538416,1037,2222901,SATURDAY,1,0,26.1,47,13,1018.8,Fair
6/25/2022 16:00,380,595,859249,575792,975,1435041,SATURDAY,1,0,26.7,44,18.4,1019.2,Fair
6/25/2022 17:00,546,545,1403974,581635,1091,1985609,SATURDAY,1,0,26.7,44,18.4,1019.1,Fair
6/25/2022 18:00,516,579,1943181,598787,1095,2541968,SATURDAY,1,0,28.3,41,16.6,1018.8,Fair
6/25/2022 19:00,466,524,2901388,522117,990,3423505,SATURDAY,1,0,28.3,41,16.6,1018.8,Fair
6/25/2022 20:00,518,584,2500627,825723,1102,3326350,SATURDAY,1,0,28.9,38,16.6,1018.2,Fair
6/25/2022 21:00,521,619,2474165,569475,1140,3043640,SATURDAY,1,0,27.2,41,11.2,1018.4,Rain
6/25/2022 22:00,457,629,2046445,584642,1086,2631087,SATURDAY,1,0,25.6,45,11.2,1018.6,Fair
6/25/2022 23:00,474,527,1134888,507433,1001,1642321,SATURDAY,1,0,25.6,45,11.2,1018.5,Fair
6/26/2022 0:00,400,432,1094578,434065,832,1528643,SUNDAY,1,0,23.9,55,11.2,1018.5,Fair
6/26/2022 1:00,273,361,989775,344306,634,1334081,SUNDAY,1,0,23.3,62,7.6,1019.1,Fair
6/26/2022 2:00,276,260,3049280,394442,536,3443722,SUNDAY,1,0,23.3,62,11.2,1019.1,Fair
6/26/2022 3:00,273,244,2764677,273824,517,3038501,SUNDAY,1,0,22.8,64,7.6,1019.1,Fair
6/26/2022 4:00,212,167,614347,206603,379,820950,SUNDAY,1,0,22.8,66,13,1019,Fair
6/26/2022 5:00,174,106,585046,128419,280,713465,SUNDAY,1,0,22.8,66,13,1019,Fair
6/26/2022 6:00,107,72,309759,65283,179,375042,SUNDAY,1,0,22.2,73,13,1019.2,Fair
6/26/2022 7:00,27,28,162172,25115,55,187287,SUNDAY,1,0,20.6,81,11.2,1018.8,Fair
6/26/2022 8:00,9,15,8468,26388,24,34856,SUNDAY,1,0,20,84,9.4,1019.2,Fair
6/26/2022 9:00,22,29,44677,25400,51,70077,SUNDAY,1,0,20,84,7.6,1019.5,Fair
6/26/2022 10:00,45,72,70073,69203,117,139276,SUNDAY,1,0,20,84,7.6,1019.5,Fair
6/26/2022 11:00,71,164,212670,170372,235,383042,SUNDAY,1,0,23.9,69,0,1019.4,Fair
6/26/2022 12:00,111,207,371338,164985,318,536323,SUNDAY,1,0,28.3,48,7.6,1019.4,Fair
6/26/2022 13:00,169,329,361234,289393,498,650627,SUNDAY,1,0,27.8,53,9.4,1019.2,Fair
6/26/2022 14:00,275,436,577206,357786,711,934992,SUNDAY,1,0,27.8,53,9.4,1019.2,Fair
6/26/2022 15:00,352,448,781199,432967,800,1214166,SUNDAY,1,0,28.3,53,16.6,1018.5,Fair
6/26/2022 16:00,368,523,838534,442239,891,1280773,SUNDAY,1,0,28.9,51,22.3,1017.8,Fair
6/26/2022 17:00,400,529,2190233,489379,929,2679612,SUNDAY,1,0,29.4,50,25.9,1017.1,Fair
6/26/2022 18:00,427,529,1489905,520224,956,2010129,SUNDAY,1,0,29.4,50,29.5,1016.5,Cloudy
6/26/2022 19:00,376,530,997121,468470,906,1465591,SUNDAY,1,0,28.9,51,22.3,1015.9,Cloudy
6/26/2022 20:00,409,557,830312,1199178,966,2029490,SUNDAY,1,0,28.9,51,22.3,1015.9,Cloudy
6/26/2022 21:00,379,534,1023990,468313,913,1492303,SUNDAY,1,0,29.4,43,29.5,1015.4,Cloudy
6/26/2022 22:00,345,547,654139,492610,892,1146749,SUNDAY,1,0,27.8,49,24.1,1015.6,Cloudy
6/26/2022 23:00,381,512,1119650,493129,893,1612779,SUNDAY,1,0,27.8,49,24.1,1015.6,Cloudy
6/27/2022 0:00,265,440,1094541,429887,705,1524428,MONDAY,0,0,24.4,67,18.4,1016,Cloudy
6/27/2022 1:00,196,300,495366,276872,496,772238,MONDAY,0,0,23.3,71,18.4,1016.5,Cloudy
6/27/2022 2:00,108,206,898626,1467193,314,2365819,MONDAY,0,0,22.2,71,18.4,1016.4,Cloudy
6/27/2022 3:00,56,121,113198,92311,177,205509,MONDAY,0,0,21.7,66,16.6,1016.1,Fair
6/27/2022 4:00,38,55,48546,41250,93,89796,MONDAY,0,0,21.7,66,16.6,1016.1,Fair
6/27/2022 5:00,31,22,44212,19323,53,63535,MONDAY,0,0,21.7,59,20.5,1015.3,Fair
6/27/2022 6:00,11,14,44640,14302,25,58942,MONDAY,0,0,21.7,63,11.2,1015,Fair
6/27/2022 7:00,8,9,111507,5244,17,116751,MONDAY,0,0,21.7,66,20.5,1014,Fair
6/27/2022 8:00,8,12,23198,13374,20,36572,MONDAY,0,0,21.1,73,16.6,1013.6,Fair
6/27/2022 9:00,12,67,8962,93477,79,102439,MONDAY,0,0,21.7,73,18.4,1013.4,Cloudy
6/27/2022 10:00,29,195,51325,145954,224,197279,MONDAY,0,0,21.7,73,18.4,1013.4,Cloudy
6/27/2022 11:00,91,498,114634,408580,589,523214,MONDAY,0,0,23.3,69,24.1,1012.7,Cloudy
6/27/2022 12:00,111,933,141308,922376,1044,1063684,MONDAY,0,0,23.9,71,24.1,1012.5,Rain
6/27/2022 13:00,103,564,154676,408662,667,563338,MONDAY,0,0,23.9,71,33.5,1012.4,Rain
6/27/2022 14:00,96,357,493134,258577,453,751711,MONDAY,0,0,23.9,71,27.7,1012.4,Rain
6/27/2022 15:00,64,176,249805,129210,240,379015,MONDAY,0,0,23.3,85,24.1,1012.8,Rain
6/27/2022 16:00,29,97,37443,69187,126,106630,MONDAY,0,0,22.2,94,24.1,1012.8,Rain
6/27/2022 17:00,23,91,27176,57050,114,84226,MONDAY,0,0,22.2,94,24.1,1012.8,Rain
6/27/2022 18:00,30,95,36807,65895,125,102702,MONDAY,0,0,22.2,94,13,1012.9,Rain
6/27/2022 19:00,24,111,23063,75455,135,98518,MONDAY,0,0,21.7,96,16.6,1012.6,Cloudy
6/27/2022 20:00,81,428,101323,324332,509,425655,MONDAY,0,0,22.2,94,18.4,1012.1,Cloudy
6/27/2022 21:00,94,502,212499,355553,596,568052,MONDAY,0,0,22.2,94,18.4,1012.1,Rain
6/27/2022 22:00,49,309,124228,220056,358,344284,MONDAY,0,0,22.2,94,16.6,1012.5,Rain
6/27/2022 23:00,50,378,348517,280216,428,628733,MONDAY,0,0,21.7,94,18.4,1012.8,Rain
6/28/2022 0:00,80,322,120227,415501,402,535728,TUESDAY,0,0,21.1,90,20.5,1013.3,Rain
6/28/2022 1:00,60,269,93255,197109,329,290364,TUESDAY,0,0,21.1,90,20.5,1013.3,Rain
6/28/2022 2:00,62,150,167388,115226,212,282614,TUESDAY,0,0,21.7,68,18.4,1014.4,Rain
6/28/2022 3:00,46,88,56346,80954,134,137300,TUESDAY,0,0,20.6,68,16.6,1014.9,Rain
6/28/2022 4:00,15,50,111774,43765,65,155539,TUESDAY,0,0,20.6,68,16.6,1014.9,Cloudy
6/28/2022 5:00,15,26,20543,21402,41,41945,TUESDAY,0,0,19.4,59,16.6,1015.7,Cloudy
6/28/2022 6:00,6,13,5494,11526,19,17020,TUESDAY,0,0,18.3,63,16.6,1016.1,Cloudy
6/28/2022 7:00,4,15,7023,18989,19,26012,TUESDAY,0,0,17.8,60,16.6,1016.2,Fair
6/28/2022 8:00,9,19,26063,19268,28,45331,TUESDAY,0,0,17.2,63,14.8,1016.9,Fair
6/28/2022 9:00,17,69,28863,46601,86,75464,TUESDAY,0,0,17.2,63,14.8,1016.9,Fair
6/28/2022 10:00,52,252,81008,248489,304,329497,TUESDAY,0,0,17.8,63,14.8,1017.7,Rain
6/28/2022 11:00,93,607,139590,466936,700,606526,TUESDAY,0,0,19.4,57,18.4,1018.4,Fair
6/28/2022 12:00,140,1109,162198,930199,1249,1092397,TUESDAY,0,0,20.6,57,14.8,1018.6,Cloudy
6/28/2022 13:00,90,610,175756,524256,700,700012,TUESDAY,0,0,23.3,50,11.2,1018.7,Cloudy
6/28/2022 14:00,112,427,279815,444762,539,724577,TUESDAY,0,0,23.3,50,11.2,1018.7,Fair
6/28/2022 15:00,155,353,623838,270090,508,893928,TUESDAY,0,0,22.8,53,7.6,1019.2,Fair
6/28/2022 16:00,193,385,974044,293231,578,1267275,TUESDAY,0,0,23.9,50,16.6,1019.4,Fair
6/28/2022 17:00,139,395,361712,313605,534,675317,TUESDAY,0,0,23.9,50,20.5,1019.4,Fair
6/28/2022 18:00,209,401,2065320,328082,610,2393402,TUESDAY,0,0,23.3,56,20.5,1019.5,Fair
6/28/2022 19:00,223,515,484390,436823,738,921213,TUESDAY,0,0,23.3,56,20.5,1019.5,Fair
6/28/2022 20:00,286,827,603937,701812,1113,1305749,TUESDAY,0,0,23.3,53,20.5,1019.2,Fair
6/28/2022 21:00,398,1363,1388908,1740656,1761,3129564,TUESDAY,0,0,23.3,56,18.4,1019.3,Fair
6/28/2022 22:00,404,1151,1016727,1604486,1555,2621213,TUESDAY,0,0,21.7,63,13,1019.6,Fair
6/28/2022 23:00,356,834,1334476,925104,1190,2259580,TUESDAY,0,0,21.7,63,13,1019.6,Fair
6/29/2022 0:00,233,595,783937,547214,828,1331151,WEDNESDAY,0,0,19.4,79,7.6,1020.7,Fair
6/29/2022 1:00,193,377,249968,363589,570,613557,WEDNESDAY,0,0,18.9,81,7.6,1021.2,Fair
6/29/2022 2:00,121,263,146640,222254,384,368894,WEDNESDAY,0,0,19.4,76,5.4,1021.3,Fair
6/29/2022 3:00,85,128,309194,103571,213,412765,WEDNESDAY,0,0,19.4,79,7.6,1021.7,Fair
6/29/2022 4:00,31,71,152999,65817,102,218816,WEDNESDAY,0,0,19.4,79,7.6,1021.7,Fair
6/29/2022 5:00,22,28,70816,26656,50,97472,WEDNESDAY,0,0,17.2,90,7.6,1022.3,Fair
6/29/2022 6:00,7,15,9358,12960,22,22318,WEDNESDAY,0,0,17.2,90,7.6,1022.4,Fair
6/29/2022 7:00,9,6,21921,7075,15,28996,WEDNESDAY,0,0,18.3,87,5.4,1022.4,Fair
6/29/2022 8:00,3,15,3243,15850,18,19093,WEDNESDAY,0,0,18.3,87,5.4,1022.4,Fair
6/29/2022 9:00,19,76,42283,52877,95,95160,WEDNESDAY,0,0,17.8,87,5.4,1022.9,Fair
6/29/2022 10:00,46,278,49373,202335,324,251708,WEDNESDAY,0,0,18.9,81,0,1023.4,Cloudy
6/29/2022 11:00,87,578,88898,441583,665,530481,WEDNESDAY,0,0,21.1,71,0,1023.4,Cloudy
6/29/2022 12:00,173,1117,235701,841243,1290,1076944,WEDNESDAY,0,0,21.7,71,9.4,1023.4,Cloudy
6/29/2022 13:00,112,656,971934,494929,768,1466863,WEDNESDAY,0,0,22.2,64,11.2,1023.2,Cloudy
6/29/2022 14:00,112,376,190327,288233,488,478560,WEDNESDAY,0,0,22.2,64,11.2,1023.2,Cloudy
6/29/2022 15:00,148,405,1152858,293421,553,1446279,WEDNESDAY,0,0,23.9,58,14.8,1022.9,Cloudy
6/29/2022 16:00,185,416,449668,370568,601,820236,WEDNESDAY,0,0,24.4,56,14.8,1022.4,Fair
6/29/2022 17:00,186,353,359552,302222,539,661774,WEDNESDAY,0,0,25,58,20.5,1021.7,Cloudy
6/29/2022 18:00,173,395,408588,315613,568,724201,WEDNESDAY,0,0,25,58,18.4,1021.7,Cloudy
6/29/2022 19:00,205,543,440604,449727,748,890331,WEDNESDAY,0,0,25,56,14.8,1020.7,Cloudy
6/29/2022 20:00,291,840,576744,711370,1131,1288114,WEDNESDAY,0,0,27.8,34,11.2,1020.2,Cloudy
6/29/2022 21:00,401,1265,732374,1083860,1666,1816234,WEDNESDAY,0,0,27.8,35,14.8,1019.7,Rain
6/29/2022 22:00,418,1072,975847,960097,1490,1935944,WEDNESDAY,0,0,26.7,37,14.8,1019.7,Cloudy
6/29/2022 23:00,361,844,683566,792860,1205,1476426,WEDNESDAY,0,0,26.7,37,14.8,1019.7,Cloudy
6/30/2022 0:00,261,587,1061467,701315,848,1762782,THURSDAY,0,0,22.8,59,18.4,1020.2,Cloudy
6/30/2022 1:00,193,408,847605,341964,601,1189569,THURSDAY,0,0,22.8,51,20.5,1020.2,Cloudy
6/30/2022 2:00,152,309,222333,281280,461,503613,THURSDAY,0,0,22.8,51,20.5,1020.2,Cloudy
6/30/2022 3:00,70,165,170693,134397,235,305090,THURSDAY,0,0,22.8,53,18.4,1021.5,Cloudy
6/30/2022 4:00,38,62,120523,56513,100,177036,THURSDAY,0,0,20,65,5.4,1021,Cloudy
6/30/2022 5:00,20,30,63220,22440,50,85660,THURSDAY,0,0,21.7,61,16.6,1021,Cloudy
6/30/2022 6:00,12,23,13799,24334,35,38133,THURSDAY,0,0,20,73,16.6,1020.4,Fair
6/30/2022 7:00,5,14,4196,9965,19,14161,THURSDAY,0,0,20,68,9.4,1020.2,Fair
6/30/2022 8:00,1,17,616,13244,18,13860,THURSDAY,0,0,20,65,16.6,1020.6,Fair
6/30/2022 9:00,11,73,8078,61603,84,69681,THURSDAY,0,0,20,65,16.6,1020.6,Fair
6/30/2022 10:00,49,236,69758,169423,285,239181,THURSDAY,0,0,20,61,18.4,1021.4,Fair
6/30/2022 11:00,102,552,132294,471830,654,604124,THURSDAY,0,0,21.1,57,16.6,1021.7,Fair
6/30/2022 12:00,166,1029,292587,809307,1195,1101894,THURSDAY,0,0,21.7,51,16.6,1021.9,Fair
6/30/2022 13:00,137,613,243496,555369,750,798865,THURSDAY,0,0,21.7,51,25.9,1021.9,Fair
6/30/2022 14:00,140,439,246618,323848,579,570466,THURSDAY,0,0,23.9,37,25.9,1021.5,Fair
6/30/2022 15:00,155,387,773836,365886,542,1139722,THURSDAY,0,0,25,36,20.5,1021.5,Fair
6/30/2022 16:00,199,488,761453,353038,687,1114491,THURSDAY,0,0,26.1,34,22.3,1021.3,Fair
6/30/2022 17:00,224,420,459189,326642,644,785831,THURSDAY,0,0,26.7,30,18.4,1020.3,Fair
6/30/2022 18:00,229,400,460245,329682,629,789927,THURSDAY,0,0,26.7,30,18.4,1020.3,Fair
6/30/2022 19:00,254,499,1077826,419016,753,1496842,THURSDAY,0,0,27.2,28,13,1019.8,Fair
6/30/2022 20:00,318,850,1005149,817843,1168,1822992,THURSDAY,0,0,27.2,28,13,1019.8,Cloudy
6/30/2022 21:00,410,1217,698805,1053115,1627,1751920,THURSDAY,0,0,24.4,42,14.8,1019.3,Rain
6/30/2022 22:00,457,1069,2075772,925855,1526,3001627,THURSDAY,0,0,24.4,42,14.8,1019.3,Fair
6/30/2022 23:00,344,774,1152478,864056,1118,2016534,THURSDAY,0,0,22.8,48,16.6,1019.6,Cloudy
7/1/2022 0:00,296,590,1983896,526873,886,2510769,FRIDAY,0,0,21.7,55,14.8,1019.7,Cloudy
7/1/2022 1:00,284,419,2847185,2890512,703,5737697,FRIDAY,0,0,20.6,68,11.2,1020.2,Cloudy
7/1/2022 2:00,201,341,435034,264474,542,699508,FRIDAY,0,0,20,76,13,1019.9,Fair
7/1/2022 3:00,127,197,1797616,2105846,324,3903462,FRIDAY,0,0,20,70,7.6,1019.9,Fair
7/1/2022 4:00,78,106,123074,82109,184,205183,FRIDAY,0,0,20,70,7.6,1019.9,Fair
7/1/2022 5:00,66,66,560021,57516,132,617537,FRIDAY,0,0,20.6,70,11.2,1019,Fair
7/1/2022 6:00,29,36,90878,37198,65,128076,FRIDAY,0,0,20,73,7.6,1018.8,Fair
7/1/2022 7:00,4,6,3124,4395,10,7519,FRIDAY,0,0,20,73,9.4,1018.7,Fair
7/1/2022 8:00,6,15,9244,19594,21,28838,FRIDAY,0,0,20,73,9.4,1018.7,Fair
7/1/2022 9:00,19,70,38650,57446,89,96096,FRIDAY,0,0,20,73,11.2,1018.1,Fair
7/1/2022 10:00,44,174,40767,125381,218,166148,FRIDAY,0,0,20.6,75,7.6,1017.6,Fair
7/1/2022 11:00,52,395,64337,331009,447,395346,FRIDAY,0,0,22.2,68,13,1017.7,Cloudy
7/1/2022 12:00,109,658,171069,572697,767,743766,FRIDAY,0,0,25.6,58,20.5,1017.2,Cloudy
7/1/2022 13:00,111,546,208484,408762,657,617246,FRIDAY,0,0,25.6,58,20.5,1017.2,Cloudy
7/1/2022 14:00,148,450,3011911,363915,598,3375826,FRIDAY,0,0,29.4,42,27.7,1016.3,Cloudy
7/1/2022 15:00,201,393,2688594,311160,594,2999754,FRIDAY,0,0,31.7,35,27.7,1015.9,Cloudy
7/1/2022 16:00,211,478,685943,393919,689,1079862,FRIDAY,0,0,32.8,32,25.9,1014.9,Fair
7/1/2022 17:00,204,485,662838,383256,689,1046094,FRIDAY,0,0,32.8,36,27.7,1014.1,Cloudy
7/1/2022 18:00,229,484,481101,369638,713,850739,FRIDAY,0,0,32.8,36,27.7,1014.1,Cloudy
7/1/2022 19:00,281,577,881470,493054,858,1374524,FRIDAY,0,0,32.2,40,37.1,1012.9,Cloudy
7/1/2022 20:00,310,633,588300,557240,943,1145540,FRIDAY,0,0,32.2,40,31.7,1012.9,Cloudy
7/1/2022 21:00,318,798,5046363,677391,1116,5723754,FRIDAY,0,0,28.9,61,29.5,1011.9,Cloudy
7/1/2022 22:00,308,722,2566319,628045,1030,3194364,FRIDAY,0,0,28.9,61,29.5,1011.9,Cloudy
7/1/2022 23:00,349,583,2920813,508278,932,3429091,FRIDAY,0,0,27.8,67,22.3,1012,Cloudy
7/2/2022 0:00,253,436,561251,370009,689,931260,SATURDAY,1,0,27.8,67,27.7,1012,Cloudy
7/2/2022 1:00,207,298,1015270,605627,505,1620897,SATURDAY,1,0,27.2,69,20.5,1012.1,Cloudy
7/2/2022 2:00,192,250,680719,235534,442,916253,SATURDAY,1,0,25.6,76,18.4,1012.2,Cloudy
7/2/2022 3:00,123,200,297365,1072067,323,1369432,SATURDAY,1,0,25,79,20.5,1012.2,Cloudy
7/2/2022 4:00,113,148,141039,134755,261,275794,SATURDAY,1,0,25,79,18.4,1012,Cloudy
7/2/2022 5:00,149,109,2483773,146218,258,2629991,SATURDAY,1,0,24.4,77,18.4,1010.9,Cloudy
7/2/2022 6:00,97,59,288594,57748,156,346342,SATURDAY,1,0,24.4,77,18.4,1010.5,Rain
7/2/2022 7:00,19,26,70405,29930,45,100335,SATURDAY,1,0,24.4,77,18.4,1010.5,Rain
7/2/2022 8:00,8,10,2473558,12577,18,2486135,SATURDAY,1,0,23.9,79,14.8,1010.4,Rain
7/2/2022 9:00,5,12,16630,4831,17,21461,SATURDAY,1,0,22.2,94,14.8,1010.8,Rain
7/2/2022 10:00,10,49,7405,36813,59,44218,SATURDAY,1,0,21.7,90,13,1011.4,Rain
7/2/2022 11:00,14,77,11721,60210,91,71931,SATURDAY,1,0,22.2,91,16.6,1012.2,Rain
7/2/2022 12:00,58,189,130063,135009,247,265072,SATURDAY,1,0,23.3,85,18.4,1012.4,Rain
7/2/2022 13:00,109,267,190240,896957,376,1087197,SATURDAY,1,0,23.3,85,18.4,1012.4,Rain
7/2/2022 14:00,216,318,569491,273027,534,842518,SATURDAY,1,0,26.1,67,16.6,1011,Rain
7/2/2022 15:00,242,361,604557,299763,603,904320,SATURDAY,1,0,27.2,62,20.5,1011.4,Rain
7/2/2022 16:00,359,456,844300,412096,815,1256396,SATURDAY,1,0,27.2,57,27.7,1011.8,Rain
7/2/2022 17:00,358,428,797442,381862,786,1179304,SATURDAY,1,0,28.9,53,20.5,1011.5,Rain
7/2/2022 18:00,468,461,2137913,434184,929,2572097,SATURDAY,1,0,28.9,53,20.5,1011.5,Rain
7/2/2022 19:00,402,479,3530655,434625,881,3965280,SATURDAY,1,0,30,48,22.3,1010.7,Rain
7/2/2022 20:00,428,501,1021263,501915,929,1523178,SATURDAY,1,0,30,48,25.9,1010.7,Rain
7/2/2022 21:00,433,539,887591,476099,972,1363690,SATURDAY,1,0,29.4,50,22.3,1010.6,Cloudy
7/2/2022 22:00,161,325,526228,238405,486,764633,SATURDAY,1,0,28.3,51,20.5,1010.4,Cloudy
7/2/2022 23:00,94,172,152550,127226,266,279776,SATURDAY,1,0,24.4,74,18.4,1011.4,Cloudy
7/3/2022 0:00,148,228,1400221,211500,376,1611721,SUNDAY,1,0,22.8,81,16.6,1011.7,Cloudy
7/3/2022 1:00,188,229,1742100,184985,417,1927085,SUNDAY,1,0,22.8,79,16.6,1012.5,Cloudy
7/3/2022 2:00,152,202,246910,170765,354,417675,SUNDAY,1,0,21.7,87,20.5,1012.9,Cloudy
7/3/2022 3:00,106,126,3337755,117561,232,3455316,SUNDAY,1,0,21.7,87,20.5,1012.9,Cloudy
7/3/2022 4:00,98,103,226398,79315,201,305713,SUNDAY,1,0,22.8,76,11.2,1012.6,Cloudy
7/3/2022 5:00,118,80,236963,72774,198,309737,SUNDAY,1,0,22.2,73,13,1013,Fair
7/3/2022 6:00,56,38,173426,32612,94,206038,SUNDAY,1,0,22.2,68,9.4,1013.2,Fair
7/3/2022 7:00,38,13,166737,11559,51,178296,SUNDAY,1,0,22.2,64,11.2,1013.3,Fair
7/3/2022 8:00,10,7,8764,5950,17,14714,SUNDAY,1,0,22.2,64,11.2,1013.3,Cloudy
7/3/2022 9:00,13,28,125050,27926,41,152976,SUNDAY,1,0,21.7,61,7.6,1013.9,Cloudy
7/3/2022 10:00,18,57,36818,44364,75,81182,SUNDAY,1,0,21.7,61,13,1013.9,Rain
7/3/2022 11:00,44,88,64303,81009,132,145312,SUNDAY,1,0,22.8,55,14.8,1014.6,Cloudy
7/3/2022 12:00,79,150,207260,152277,229,359537,SUNDAY,1,0,22.8,55,14.8,1014.6,Cloudy
7/3/2022 13:00,139,276,311578,234248,415,545826,SUNDAY,1,0,24.4,45,16.6,1014.9,Cloudy
7/3/2022 14:00,257,339,604945,315395,596,920340,SUNDAY,1,0,25,47,13,1014.9,Cloudy
7/3/2022 15:00,342,376,3554312,360677,718,3914989,SUNDAY,1,0,26.1,47,16.6,1015.1,Cloudy
7/3/2022 16:00,434,422,1443046,437229,856,1880275,SUNDAY,1,0,27.8,34,11.2,1014.4,Cloudy
7/3/2022 17:00,459,445,1143484,422584,904,1566068,SUNDAY,1,0,27.8,34,11.2,1014.4,Fair
7/3/2022 18:00,460,437,1274258,489422,897,1763680,SUNDAY,1,0,29.4,20,24.1,1014,Fair
7/3/2022 19:00,484,445,5385970,450556,929,5836526,SUNDAY,1,0,29.4,24,14.8,1014,Fair
7/3/2022 20:00,486,458,1364766,457128,944,1821894,SUNDAY,1,0,29.4,26,13,1013.5,Fair
7/3/2022 21:00,413,505,2215096,487510,918,2702606,SUNDAY,1,0,29.4,22,14.8,1013.9,Rain
7/3/2022 22:00,394,456,1890660,488245,850,2378905,SUNDAY,1,0,29.4,22,14.8,1013.9,Fair
7/3/2022 23:00,386,496,1059283,503149,882,1562432,SUNDAY,1,0,27.8,27,14.8,1014.6,Fair
7/4/2022 0:00,359,384,1005784,358318,743,1364102,MONDAY,0,1,26.7,30,13,1015.2,Fair
7/4/2022 1:00,223,270,1119354,259720,493,1379074,MONDAY,0,1,25.6,33,9.4,1016,Fair
7/4/2022 2:00,208,200,595934,166308,408,762242,MONDAY,0,1,24.4,42,13,1016.4,Fair
7/4/2022 3:00,133,165,213222,138677,298,351899,MONDAY,0,1,24.4,42,13,1016.4,Fair
7/4/2022 4:00,80,96,658831,115721,176,774552,MONDAY,0,1,22.2,46,11.2,1017.5,Fair
7/4/2022 5:00,85,70,148590,73604,155,222194,MONDAY,0,1,21.7,46,14.8,1017.9,Fair
7/4/2022 6:00,55,32,82988,23262,87,106250,MONDAY,0,1,21.1,47,13,1018.1,Clear
7/4/2022 7:00,9,10,216842,7423,19,224265,MONDAY,0,1,20.6,51,11.2,1018.4,Clear
7/4/2022 8:00,3,4,4021,3735,7,7756,MONDAY,0,1,20.6,51,11.2,1018.4,Clear
7/4/2022 9:00,8,26,16577,28405,34,44982,MONDAY,0,1,19.4,57,14.8,1019.1,Clear
7/4/2022 10:00,14,51,43074,39370,65,82444,MONDAY,0,1,20.6,51,14.8,1019.3,Rain
7/4/2022 11:00,36,108,89692,110048,144,199740,MONDAY,0,1,22.2,48,13,1019.5,Fair
7/4/2022 12:00,86,179,190752,147785,265,338537,MONDAY,0,1,22.2,48,13,1019.5,Fair
7/4/2022 13:00,175,236,497741,370504,411,868245,MONDAY,0,1,25.6,37,9.4,1019.5,Fair
7/4/2022 14:00,334,337,941251,327261,671,1268512,MONDAY,0,1,26.7,33,14.8,1019.5,Fair
7/4/2022 15:00,408,436,2019992,443848,844,2463840,MONDAY,0,1,27.2,29,9.4,1019.1,Fair
7/4/2022 16:00,462,433,3072400,444640,895,3517040,MONDAY,0,1,27.8,31,13,1018.9,Fair
7/4/2022 17:00,446,497,1184050,567773,943,1751823,MONDAY,0,1,28.9,29,13,1018.5,Fair
7/4/2022 18:00,517,463,2505321,467763,980,2973084,MONDAY,0,1,27.2,30,14.8,1018,Fair
7/4/2022 19:00,482,435,2528919,458452,917,2987371,MONDAY,0,1,28.9,27,13,1017.9,Fair
7/4/2022 20:00,644,509,2559632,1755076,1153,4314708,MONDAY,0,1,28.9,27,13,1017.9,Cloudy
7/4/2022 21:00,531,520,3426193,524901,1051,3951094,MONDAY,0,1,27.2,30,14.8,1017.6,Cloudy
7/4/2022 22:00,534,510,1392955,500973,1044,1893928,MONDAY,0,1,27.2,30,14.8,1017.6,Cloudy
7/4/2022 23:00,612,490,1348774,476942,1102,1825716,MONDAY,0,1,27.2,32,14.8,1017.7,Cloudy
7/5/2022 0:00,592,459,2140650,472492,1051,2613142,TUESDAY,0,0,26.1,34,13,1017.9,Cloudy
7/5/2022 1:00,570,396,1953122,542165,966,2495287,TUESDAY,0,0,25,40,9.4,1018.8,Cloudy
7/5/2022 2:00,398,294,5802598,389269,692,6191867,TUESDAY,0,0,25,40,9.4,1018.8,Cloudy
7/5/2022 3:00,501,441,3351053,407390,942,3758443,TUESDAY,0,0,24.4,42,9.4,1019,Cloudy
7/5/2022 4:00,164,161,238606,122171,325,360777,TUESDAY,0,0,23.3,45,9.4,1018.7,Cloudy
7/5/2022 5:00,60,30,3233781,41738,90,3275519,TUESDAY,0,0,20.6,53,7.6,1018.5,Fair
7/5/2022 6:00,25,19,33601,19018,44,52619,TUESDAY,0,0,20.6,53,7.6,1018.5,Fair
7/5/2022 7:00,19,9,41450,8424,28,49874,TUESDAY,0,0,20,55,11.2,1018.5,Fair
7/5/2022 8:00,15,14,59491,13629,29,73120,TUESDAY,0,0,20,55,11.2,1018.5,Cloudy
7/5/2022 9:00,13,74,9622,53686,87,63308,TUESDAY,0,0,20.6,51,7.6,1018.7,Cloudy
7/5/2022 10:00,21,182,27175,128017,203,155192,TUESDAY,0,0,22.2,46,13,1018.6,Cloudy
7/5/2022 11:00,54,465,59932,381555,519,441487,TUESDAY,0,0,23.3,45,7.6,1018.6,Cloudy
7/5/2022 12:00,112,823,144988,676917,935,821905,TUESDAY,0,0,23.3,45,7.6,1018.6,Cloudy
7/5/2022 13:00,116,540,1791304,416337,656,2207641,TUESDAY,0,0,23.9,52,13,1017.8,Cloudy
7/5/2022 14:00,128,377,263762,287443,505,551205,TUESDAY,0,0,25,48,13,1017.3,Cloudy
7/5/2022 15:00,143,366,747320,277484,509,1024804,TUESDAY,0,0,25,48,13,1017.3,Cloudy
7/5/2022 16:00,202,431,448083,342905,633,790988,TUESDAY,0,0,23.9,60,16.6,1016.5,Cloudy
7/5/2022 17:00,150,317,270703,249712,467,520415,TUESDAY,0,0,23.9,60,16.6,1016.5,Cloudy
7/5/2022 18:00,157,303,398742,233017,460,631759,TUESDAY,0,0,22.8,71,13,1016.7,Cloudy
7/5/2022 19:00,253,481,570916,383507,734,954423,TUESDAY,0,0,22.2,76,7.6,1015.3,Cloudy
7/5/2022 20:00,230,673,3290114,700981,903,3991095,TUESDAY,0,0,22.2,76,7.6,1015.3,Cloudy
7/5/2022 21:00,300,1133,583861,922941,1433,1506802,TUESDAY,0,0,21.7,81,14.8,1014.7,Cloudy
7/5/2022 22:00,275,927,413793,722861,1202,1136654,TUESDAY,0,0,21.1,84,18.4,1013.7,Rain
7/5/2022 23:00,239,674,1150958,520970,913,1671928,TUESDAY,0,0,22.2,71,25.9,1012.2,Rain
7/6/2022 0:00,139,437,170031,336355,576,506386,WEDNESDAY,0,0,22.2,71,25.9,1012.2,Rain
7/6/2022 1:00,97,252,796442,203054,349,999496,WEDNESDAY,0,0,21.7,71,22.3,1011.7,Rain
7/6/2022 2:00,40,83,76748,60701,123,137449,WEDNESDAY,0,0,21.7,63,27.7,1011.7,Rain
7/6/2022 3:00,38,81,43018,60814,119,103832,WEDNESDAY,0,0,19.4,81,16.6,1010.9,Rain
7/6/2022 4:00,9,36,227351,22041,45,249392,WEDNESDAY,0,0,19.4,87,29.5,1007.8,Rain
7/6/2022 5:00,5,17,4062,11151,22,15213,WEDNESDAY,0,0,20,90,29.5,1007.1,Rain
7/6/2022 6:00,9,7,29467,6716,16,36183,WEDNESDAY,0,0,20.6,87,33.5,1006.8,Rain
7/6/2022 7:00,1,13,671,65438,14,66109,WEDNESDAY,0,0,20.6,87,25.9,1006.8,Rain
7/6/2022 8:00,5,13,5060,16262,18,21322,WEDNESDAY,0,0,21.1,90,18.4,1006.1,Cloudy
7/6/2022 9:00,18,85,18856,51533,103,70389,WEDNESDAY,0,0,21.7,90,20.5,1005.6,Cloudy
7/6/2022 10:00,46,258,1884965,190228,304,2075193,WEDNESDAY,0,0,22.8,87,24.1,1005.7,Cloudy
7/6/2022 11:00,95,599,103232,503151,694,606383,WEDNESDAY,0,0,24.4,79,24.1,1006.5,Cloudy
7/6/2022 12:00,144,1018,157629,872246,1162,1029875,WEDNESDAY,0,0,24.4,79,24.1,1006.5,Cloudy
7/6/2022 13:00,98,615,136997,452314,713,589311,WEDNESDAY,0,0,25.6,67,22.3,1007,Cloudy
7/6/2022 14:00,132,347,315749,508767,479,824516,WEDNESDAY,0,0,25.6,67,24.1,1007,Cloudy
7/6/2022 15:00,147,366,328520,279686,513,608206,WEDNESDAY,0,0,27.2,54,27.7,1008.5,Cloudy
7/6/2022 16:00,163,407,364227,282582,570,646809,WEDNESDAY,0,0,27.8,46,24.1,1008.6,Rain
7/6/2022 17:00,206,421,597209,322636,627,919845,WEDNESDAY,0,0,27.8,46,33.5,1008.6,Cloudy
7/6/2022 18:00,170,381,318540,302336,551,620876,WEDNESDAY,0,0,28.3,40,25.9,1009.3,Cloudy
7/6/2022 19:00,230,506,431901,415456,736,847357,WEDNESDAY,0,0,28.3,37,20.5,1010,Cloudy
7/6/2022 20:00,298,870,543244,697244,1168,1240488,WEDNESDAY,0,0,27.2,38,22.3,1010.6,Cloudy
7/6/2022 21:00,428,1323,713151,1168204,1751,1881355,WEDNESDAY,0,0,27.2,38,22.3,1011.3,Cloudy
7/6/2022 22:00,477,1171,1235237,995970,1648,2231207,WEDNESDAY,0,0,27.2,38,22.3,1011.3,Fair
7/6/2022 23:00,312,824,587608,692879,1136,1280487,WEDNESDAY,0,0,25,43,22.3,1012.3,Fair
7/7/2022 0:00,248,604,540118,516371,852,1056489,THURSDAY,0,0,25,43,11.2,1013.2,Fair
7/7/2022 1:00,169,408,391056,606670,577,997726,THURSDAY,0,0,20.6,66,9.4,1014.2,Fair
7/7/2022 2:00,214,265,664182,226194,479,890376,THURSDAY,0,0,19.4,73,9.4,1014.2,Fair
7/7/2022 3:00,84,143,645341,124284,227,769625,THURSDAY,0,0,21.7,59,0,1015,Fair
7/7/2022 4:00,40,63,702764,35890,103,738654,THURSDAY,0,0,21.7,59,0,1015,Fair
7/7/2022 5:00,16,27,20549,22425,43,42974,THURSDAY,0,0,19.4,73,9.4,1015.2,Fair
7/7/2022 6:00,9,12,9986,9043,21,19029,THURSDAY,0,0,18.9,75,7.6,1015.6,Fair
7/7/2022 7:00,7,12,156309,10594,19,166903,THURSDAY,0,0,18.9,75,7.6,1015.6,Fair
7/7/2022 8:00,4,17,3766,18907,21,22673,THURSDAY,0,0,19.4,71,5.4,1016.2,Fair
7/7/2022 9:00,8,85,6774,54568,93,61342,THURSDAY,0,0,18.9,73,7.6,1016.9,Cloudy
7/7/2022 10:00,43,257,42437,191853,300,234290,THURSDAY,0,0,20,68,7.6,1017.5,Rain
7/7/2022 11:00,95,613,125660,519279,708,644939,THURSDAY,0,0,20,68,7.6,1017.5,Fair
7/7/2022 12:00,130,1051,142299,821923,1181,964222,THURSDAY,0,0,21.7,59,11.2,1017.7,Fair
7/7/2022 13:00,123,660,161678,514825,783,676503,THURSDAY,0,0,22.2,53,13,1017.7,Fair
7/7/2022 14:00,156,365,301742,277549,521,579291,THURSDAY,0,0,22.8,55,13,1017.6,Fair
7/7/2022 15:00,161,370,357933,272776,531,630709,THURSDAY,0,0,23.3,53,20.5,1017.5,Fair
7/7/2022 16:00,210,446,748726,326037,656,1074763,THURSDAY,0,0,21.7,63,16.6,1017.1,Cloudy
7/7/2022 17:00,256,395,675818,322364,651,998182,THURSDAY,0,0,21.7,63,16.6,1017.1,Cloudy
7/7/2022 18:00,194,451,394711,376419,645,771130,THURSDAY,0,0,23.3,62,20.5,1015.9,Cloudy
7/7/2022 19:00,295,516,1917024,406984,811,2324008,THURSDAY,0,0,24.4,54,16.6,1015.6,Cloudy
7/7/2022 20:00,347,829,763633,675762,1176,1439395,THURSDAY,0,0,25,52,22.3,1015.4,Cloudy
7/7/2022 21:00,439,1286,1428192,1145068,1725,2573260,THURSDAY,0,0,25,52,22.3,1015.4,Cloudy
7/7/2022 22:00,424,1008,1868863,942304,1432,2811167,THURSDAY,0,0,25.6,47,24.1,1015.4,Cloudy
7/7/2022 23:00,324,812,767814,1081351,1136,1849165,THURSDAY,0,0,22.8,51,25.9,1015.8,Cloudy
7/8/2022 0:00,255,553,419463,475274,808,894737,FRIDAY,0,0,21.1,57,24.1,1016.1,Cloudy
7/8/2022 1:00,165,356,308865,305365,521,614230,FRIDAY,0,0,21.1,57,24.1,1016.1,Cloudy
7/8/2022 2:00,243,270,2040183,232828,513,2273011,FRIDAY,0,0,20.6,59,18.4,1016.5,Fair
7/8/2022 3:00,114,154,192713,130506,268,323219,FRIDAY,0,0,18.3,78,13,1016.5,Fair
7/8/2022 4:00,58,48,724513,34149,106,758662,FRIDAY,0,0,18.3,81,13,1016.3,Fair
7/8/2022 5:00,38,29,71780,23442,67,95222,FRIDAY,0,0,18.3,84,14.8,1016.2,Fair
7/8/2022 6:00,19,16,30467,16388,35,46855,FRIDAY,0,0,17.8,87,13,1016,Fair
7/8/2022 7:00,5,11,26069,9683,16,35752,FRIDAY,0,0,17.8,87,13,1016,Fair
7/8/2022 8:00,6,18,32506,25313,24,57819,FRIDAY,0,0,16.7,93,7.6,1015.6,Fair
7/8/2022 9:00,10,71,17641,53594,81,71235,FRIDAY,0,0,17.8,90,13,1015.7,Fair
7/8/2022 10:00,36,224,35401,165607,260,201008,FRIDAY,0,0,18.9,87,13,1015.8,Cloudy
7/8/2022 11:00,86,492,184681,420565,578,605246,FRIDAY,0,0,18.9,87,13,1015.8,Cloudy
7/8/2022 12:00,113,812,146762,647378,925,794140,FRIDAY,0,0,22.2,57,22.3,1015.5,Cloudy
7/8/2022 13:00,90,554,232049,415027,644,647076,FRIDAY,0,0,25,43,20.5,1015,Cloudy
7/8/2022 14:00,186,374,382228,318609,560,700837,FRIDAY,0,0,27.2,38,25.9,1015,Cloudy
7/8/2022 15:00,218,377,414141,291101,595,705242,FRIDAY,0,0,27.2,38,25.9,1015,Cloudy
7/8/2022 16:00,245,479,861484,368999,724,1230483,FRIDAY,0,0,27.8,44,20.5,1014,Cloudy
7/8/2022 17:00,283,479,1091761,372526,762,1464287,FRIDAY,0,0,27.8,44,20.5,1014,Cloudy
7/8/2022 18:00,261,461,1146083,378690,722,1524773,FRIDAY,0,0,28.9,48,18.4,1012.9,Cloudy
7/8/2022 19:00,308,588,692326,1240456,896,1932782,FRIDAY,0,0,28.9,43,18.4,1012.5,Cloudy
7/8/2022 20:00,361,803,2661918,645479,1164,3307397,FRIDAY,0,0,28.9,43,18.4,1012.5,Cloudy
7/8/2022 21:00,406,1007,2689702,902434,1413,3592136,FRIDAY,0,0,28.9,41,16.6,1012.5,Cloudy
7/8/2022 22:00,401,893,646281,772900,1294,1419181,FRIDAY,0,0,29.4,40,20.5,1012.5,Cloudy
7/8/2022 23:00,385,728,1899390,660324,1113,2559714,FRIDAY,0,0,25,62,18.4,1013,Cloudy
7/9/2022 0:00,282,562,613590,2277067,844,2890657,SATURDAY,1,0,25,62,18.4,1013,Cloudy
7/9/2022 1:00,257,416,654128,398672,673,1052800,SATURDAY,1,0,23.9,69,18.4,1013.4,Cloudy
7/9/2022 2:00,307,319,1646750,299709,626,1946459,SATURDAY,1,0,23.9,71,16.6,1013.9,Cloudy
7/9/2022 3:00,260,269,489434,365548,529,854982,SATURDAY,1,0,23.9,74,14.8,1014,Cloudy
7/9/2022 4:00,174,175,1610258,134085,349,1744343,SATURDAY,1,0,23.9,74,14.8,1014,Cloudy
7/9/2022 5:00,220,148,2364831,158493,368,2523324,SATURDAY,1,0,24.4,71,13,1014.3,Cloudy
7/9/2022 6:00,103,77,212081,69754,180,281835,SATURDAY,1,0,23.3,52,16.6,1015,Cloudy
7/9/2022 7:00,17,28,19981,27076,45,47057,SATURDAY,1,0,23.3,52,16.6,1015,Cloudy
7/9/2022 8:00,11,16,21617,47271,27,68888,SATURDAY,1,0,21.7,53,11.2,1015.6,Cloudy
7/9/2022 9:00,15,31,1618388,20149,46,1638537,SATURDAY,1,0,21.7,51,18.4,1015.9,Cloudy
7/9/2022 10:00,20,73,47748,59368,93,107116,SATURDAY,1,0,21.7,49,18.4,1016.6,Rain
7/9/2022 11:00,42,122,62305,116253,164,178558,SATURDAY,1,0,21.7,49,18.4,1016.6,Fair
7/9/2022 12:00,96,262,1168701,251239,358,1419940,SATURDAY,1,0,22.8,51,16.6,1017.4,Fair
7/9/2022 13:00,193,384,415515,355262,577,770777,SATURDAY,1,0,22.8,51,24.1,1017.8,Fair
7/9/2022 14:00,329,526,809234,482546,855,1291780,SATURDAY,1,0,23.3,45,20.5,1018.2,Fair
7/9/2022 15:00,464,594,1239547,549865,1058,1789412,SATURDAY,1,0,22.2,44,25.9,1018.1,Fair
7/9/2022 16:00,520,629,1307657,607718,1149,1915375,SATURDAY,1,0,22.2,44,25.9,1018.1,Fair
7/9/2022 17:00,572,632,1324073,594644,1204,1918717,SATURDAY,1,0,22.2,57,18.4,1017.5,Fair
7/9/2022 18:00,620,645,2868184,624010,1265,3492194,SATURDAY,1,0,21.7,51,20.5,1017.3,Fair
7/9/2022 19:00,583,628,1299892,630205,1211,1930097,SATURDAY,1,0,21.7,49,18.4,1017.1,Fair
7/9/2022 20:00,625,617,1884266,644326,1242,2528592,SATURDAY,1,0,21.7,49,18.4,1017.1,Fair
7/9/2022 21:00,626,729,1771257,737387,1355,2508644,SATURDAY,1,0,21.1,55,22.3,1016.8,Rain
7/9/2022 22:00,584,688,3351898,869434,1272,4221332,SATURDAY,1,0,20,68,13,1017.1,Fair
7/9/2022 23:00,466,587,1580022,2989471,1053,4569493,SATURDAY,1,0,20,68,13,1017.1,Fair
7/10/2022 0:00,375,509,2008202,510748,884,2518950,SUNDAY,1,0,18.9,78,11.2,1017.4,Fair
7/10/2022 1:00,268,362,2789241,315236,630,3104477,SUNDAY,1,0,18.3,81,5.4,1017.6,Fair
7/10/2022 2:00,248,289,2264779,268886,537,2533665,SUNDAY,1,0,18.9,68,5.4,1017.7,Fair
7/10/2022 3:00,343,249,716173,223320,592,939493,SUNDAY,1,0,19.4,66,5.4,1017.7,Fair
7/10/2022 4:00,233,186,1169390,208232,419,1377622,SUNDAY,1,0,19.4,66,5.4,1017.7,Fair
7/10/2022 5:00,260,130,900638,130338,390,1030976,SUNDAY,1,0,19.4,57,14.8,1018,Fair
7/10/2022 6:00,156,85,314391,382168,241,696559,SUNDAY,1,0,19.4,57,14.8,1018,Fair
7/10/2022 7:00,17,33,18613,28243,50,46856,SUNDAY,1,0,17.8,60,18.4,1018.2,Fair
7/10/2022 8:00,15,15,1025602,11219,30,1036821,SUNDAY,1,0,16.7,60,14.8,1018.6,Fair
7/10/2022 9:00,9,28,19538,21296,37,40834,SUNDAY,1,0,16.7,56,14.8,1018.8,Fair
7/10/2022 10:00,16,60,27406,59990,76,87396,SUNDAY,1,0,17.8,52,11.2,1019.2,Rain
7/10/2022 11:00,50,92,137349,75666,142,213015,SUNDAY,1,0,17.8,52,11.2,1019.2,Fair
7/10/2022 12:00,82,199,152868,160624,281,313492,SUNDAY,1,0,21.7,39,16.6,1019.3,Fair
7/10/2022 13:00,193,349,442578,285540,542,728118,SUNDAY,1,0,22.8,34,14.8,1019.5,Fair
7/10/2022 14:00,300,411,644331,383598,711,1027929,SUNDAY,1,0,22.8,35,16.6,1019.2,Fair
7/10/2022 15:00,419,518,979005,548118,937,1527123,SUNDAY,1,0,22.8,34,18.4,1019,Fair
7/10/2022 16:00,485,629,992996,601929,1114,1594925,SUNDAY,1,0,22.8,34,18.4,1019,Fair
7/10/2022 17:00,492,658,2801482,1109613,1150,3911095,SUNDAY,1,0,23.3,36,20.5,1018.3,Fair
7/10/2022 18:00,551,599,1832754,557006,1150,2389760,SUNDAY,1,0,23.9,32,20.5,1018.2,Fair
7/10/2022 19:00,623,683,1262781,688006,1306,1950787,SUNDAY,1,0,23.3,32,22.3,1017.6,Fair
7/10/2022 20:00,606,678,1486975,679572,1284,2166547,SUNDAY,1,0,23.3,32,22.3,1017.6,Fair
7/10/2022 21:00,540,708,2847400,1064598,1248,3911998,SUNDAY,1,0,22.8,34,22.3,1016.9,Rain
7/10/2022 22:00,479,742,3370346,812233,1221,4182579,SUNDAY,1,0,22.8,35,22.3,1016.3,Fair
7/10/2022 23:00,360,559,3221449,2331911,919,5553360,SUNDAY,1,0,21.7,44,20.5,1016.3,Fair
7/11/2022 0:00,260,433,1065835,534937,693,1600772,MONDAY,0,0,21.7,44,20.5,1016.3,Fair
7/11/2022 1:00,161,325,277950,298556,486,576506,MONDAY,0,0,20.6,55,14.8,1016.4,Fair
7/11/2022 2:00,184,224,254827,463351,408,718178,MONDAY,0,0,20.6,68,22.3,1016.5,Fair
7/11/2022 3:00,127,112,288667,133225,239,421892,MONDAY,0,0,19.4,76,14.8,1016,Fair
7/11/2022 4:00,41,54,165252,48881,95,214133,MONDAY,0,0,18.9,78,18.4,1015.7,Fair
7/11/2022 5:00,20,22,40932,16803,42,57735,MONDAY,0,0,18.3,76,20.5,1015.4,Fair
7/11/2022 6:00,6,9,6116,10052,15,16168,MONDAY,0,0,18.3,76,20.5,1015.4,Fair
7/11/2022 7:00,9,7,41872,9350,16,51222,MONDAY,0,0,17.8,75,22.3,1014.9,Fair
7/11/2022 8:00,3,12,3218,10946,15,14164,MONDAY,0,0,17.8,81,20.5,1015.1,Fair
7/11/2022 9:00,12,69,14355,48593,81,62948,MONDAY,0,0,17.8,81,18.4,1015.1,Fair
7/11/2022 10:00,39,231,45817,178480,270,224297,MONDAY,0,0,18.9,78,18.4,1015,Fair
7/11/2022 11:00,88,621,140529,1304762,709,1445291,MONDAY,0,0,18.9,78,18.4,1015,Fair
7/11/2022 12:00,149,982,182488,767020,1131,949508,MONDAY,0,0,23.9,54,24.1,1014.4,Fair
7/11/2022 13:00,110,571,740884,455587,681,1196471,MONDAY,0,0,25.6,48,20.5,1013.7,Fair
7/11/2022 14:00,123,352,297346,302980,475,600326,MONDAY,0,0,27.2,42,20.5,1013.5,Fair
7/11/2022 15:00,176,327,840149,233246,503,1073395,MONDAY,0,0,27.2,42,20.5,1013.5,Fair
7/11/2022 16:00,182,439,434659,330515,621,765174,MONDAY,0,0,28.3,37,20.5,1011.9,Fair
7/11/2022 17:00,200,411,413870,309521,611,723391,MONDAY,0,0,30.6,34,27.7,1011.4,Fair
7/11/2022 18:00,177,364,692018,313006,541,1005024,MONDAY,0,0,30,34,18.4,1010.7,Fair
7/11/2022 19:00,166,491,352511,370588,657,723099,MONDAY,0,0,29.4,37,18.4,1010.3,Fair
7/11/2022 20:00,260,785,489820,685049,1045,1174869,MONDAY,0,0,29.4,37,27.7,1010.3,Cloudy
7/11/2022 21:00,372,1258,1990759,1094343,1630,3085102,MONDAY,0,0,28.3,43,24.1,1009.8,Rain
7/11/2022 22:00,324,1137,1431410,977003,1461,2408413,MONDAY,0,0,27.2,47,33.5,1009.4,Fair
7/11/2022 23:00,294,800,569527,756570,1094,1326097,MONDAY,0,0,25.6,50,31.7,1009.3,Fair
7/12/2022 0:00,213,585,623023,518487,798,1141510,TUESDAY,0,0,23.3,57,24.1,1010,Fair
7/12/2022 1:00,143,330,244715,360491,473,605206,TUESDAY,0,0,22.2,64,25.9,1010.1,Fair
7/12/2022 2:00,99,225,164816,180967,324,345783,TUESDAY,0,0,20.6,70,22.3,1010.5,Fair
7/12/2022 3:00,58,131,553457,113720,189,667177,TUESDAY,0,0,20.6,70,22.3,1010.5,Fair
7/12/2022 4:00,31,59,905062,48377,90,953439,TUESDAY,0,0,20,73,20.5,1010,Fair
7/12/2022 5:00,12,22,53969,14901,34,68870,TUESDAY,0,0,20,73,22.3,1010,Fair
7/12/2022 6:00,6,14,8733,13542,20,22275,TUESDAY,0,0,20,73,22.3,1010,Fair
7/12/2022 7:00,5,6,3837,3206,11,7043,TUESDAY,0,0,19.4,79,20.5,1009.3,Fair
7/12/2022 8:00,7,19,30483,17694,26,48177,TUESDAY,0,0,19.4,79,20.5,1009,Fair
7/12/2022 9:00,16,89,25886,63278,105,89164,TUESDAY,0,0,19.4,81,20.5,1008.8,Fair
7/12/2022 10:00,46,270,50299,184971,316,235270,TUESDAY,0,0,19.4,81,20.5,1008.8,Fair
7/12/2022 11:00,110,709,129386,548487,819,677873,TUESDAY,0,0,22.8,66,22.3,1008.1,Fair
7/12/2022 12:00,184,1238,227344,979632,1422,1206976,TUESDAY,0,0,25.6,56,22.3,1007.5,Fair
7/12/2022 13:00,137,628,1069407,533642,765,1603049,TUESDAY,0,0,27.2,49,22.3,1006.5,Fair
7/12/2022 14:00,97,358,223672,295111,455,518783,TUESDAY,0,0,28.9,41,31.7,1006.2,Fair
7/12/2022 15:00,110,356,177861,289644,466,467505,TUESDAY,0,0,28.9,41,31.7,1006.2,Rain
7/12/2022 16:00,166,424,649752,312920,590,962672,TUESDAY,0,0,31.1,38,37.1,1005.3,Fair
7/12/2022 17:00,154,424,327135,393883,578,721018,TUESDAY,0,0,30.6,46,35.3,1004.7,Fair
7/12/2022 18:00,179,410,426231,338569,589,764800,TUESDAY,0,0,29.4,53,35.3,1004.6,Fair
7/12/2022 19:00,185,508,361284,407614,693,768898,TUESDAY,0,0,29.4,53,35.3,1004.1,Fair
7/12/2022 20:00,279,857,678646,743316,1136,1421962,TUESDAY,0,0,29.4,53,38.9,1004.1,Cloudy
7/12/2022 21:00,376,1394,903530,1297842,1770,2201372,TUESDAY,0,0,28.3,53,33.5,1003.2,Cloudy
7/12/2022 22:00,379,1165,992254,1008033,1544,2000287,TUESDAY,0,0,27.2,61,27.7,1004.5,Cloudy
7/12/2022 23:00,217,725,3300125,551492,942,3851617,TUESDAY,0,0,26.7,67,27.7,1004.6,Cloudy
7/13/2022 0:00,136,469,163042,386019,605,549061,WEDNESDAY,0,0,26.1,69,25.9,1005.4,Cloudy
7/13/2022 1:00,117,299,247606,246918,416,494524,WEDNESDAY,0,0,26.1,69,24.1,1005.4,Cloudy
7/13/2022 2:00,86,209,211195,159864,295,371059,WEDNESDAY,0,0,23.9,71,14.8,1006.9,Cloudy
7/13/2022 3:00,75,155,130645,201215,230,331860,WEDNESDAY,0,0,23.9,71,14.8,1006.9,Cloudy
7/13/2022 4:00,24,65,79827,57716,89,137543,WEDNESDAY,0,0,22.8,81,18.4,1006.9,Cloudy
7/13/2022 5:00,12,28,7666,22880,40,30546,WEDNESDAY,0,0,22.8,81,14.8,1007.4,Cloudy
7/13/2022 6:00,7,10,8548,6524,17,15072,WEDNESDAY,0,0,22.8,81,14.8,1007.4,Cloudy
7/13/2022 7:00,5,5,6550,3327,10,9877,WEDNESDAY,0,0,21.7,87,9.4,1008.1,Fair
7/13/2022 8:00,10,21,36334,832666,31,869000,WEDNESDAY,0,0,21.7,84,7.6,1008.5,Fair
7/13/2022 9:00,12,91,12316,59634,103,71950,WEDNESDAY,0,0,22.8,73,16.6,1008.8,Fair
7/13/2022 10:00,47,275,86319,189137,322,275456,WEDNESDAY,0,0,22.8,73,16.6,1008.8,Rain
7/13/2022 11:00,112,713,1039606,568209,825,1607815,WEDNESDAY,0,0,25,60,14.8,1010.2,Fair
7/13/2022 12:00,175,1145,323487,927459,1320,1250946,WEDNESDAY,0,0,26.1,54,13,1010.6,Fair
7/13/2022 13:00,108,628,288181,479060,736,767241,WEDNESDAY,0,0,27.8,47,11.2,1010.7,Fair
7/13/2022 14:00,123,394,248169,318334,517,566503,WEDNESDAY,0,0,28.9,45,11.2,1010.8,Fair
7/13/2022 15:00,114,362,1972530,267155,476,2239685,WEDNESDAY,0,0,28.9,45,11.2,1010.8,Fair
7/13/2022 16:00,145,440,708855,328335,585,1037190,WEDNESDAY,0,0,28.3,46,13,1010.8,Fair
7/13/2022 17:00,173,402,367268,313263,575,680531,WEDNESDAY,0,0,28.3,48,13,1010.5,Fair
7/13/2022 18:00,171,395,1083001,292027,566,1375028,WEDNESDAY,0,0,28.3,48,18.4,1010.9,Fair
7/13/2022 19:00,189,497,760477,416521,686,1176998,WEDNESDAY,0,0,24.4,67,20.5,1010.9,Fair
7/13/2022 20:00,266,890,374301,764376,1156,1138677,WEDNESDAY,0,0,26.1,56,22.3,1011.1,Fair
7/13/2022 21:00,364,1330,664817,1162186,1694,1827003,WEDNESDAY,0,0,24.4,62,18.4,1011.4,Rain
7/13/2022 22:00,422,1176,1349135,1089668,1598,2438803,WEDNESDAY,0,0,25.6,56,22.3,1011.2,Fair
7/13/2022 23:00,359,891,651269,765679,1250,1416948,WEDNESDAY,0,0,24.4,58,22.3,1011.6,Cloudy
7/14/2022 0:00,264,643,580929,580199,907,1161128,THURSDAY,0,0,22.2,66,20.5,1011.8,Fair
7/14/2022 1:00,198,432,2973466,372110,630,3345576,THURSDAY,0,0,20,78,9.4,1013.2,Fair
7/14/2022 2:00,112,289,350935,263420,401,614355,THURSDAY,0,0,20,78,9.4,1013.1,Fair
7/14/2022 3:00,78,171,230764,125377,249,356141,THURSDAY,0,0,20,78,0,1013.2,Fair
7/14/2022 4:00,46,81,142913,68914,127,211827,THURSDAY,0,0,19.4,84,0,1013.1,Fair
7/14/2022 5:00,21,31,96350,34701,52,131051,THURSDAY,0,0,19.4,84,0,1013.1,Cloudy
7/14/2022 6:00,5,7,5616,4570,12,10186,THURSDAY,0,0,20.6,90,16.6,1013.9,Cloudy
7/14/2022 7:00,3,4,1724,3332,7,5056,THURSDAY,0,0,20.6,90,22.3,1013.8,Cloudy
7/14/2022 8:00,2,14,1932,14526,16,16458,THURSDAY,0,0,19.4,93,9.4,1013.4,Cloudy
7/14/2022 9:00,16,66,19699,47448,82,67147,THURSDAY,0,0,19.4,91,11.2,1013.3,Cloudy
7/14/2022 10:00,25,205,1172321,128184,230,1300505,THURSDAY,0,0,19.4,91,11.2,1013.3,Cloudy
7/14/2022 11:00,96,570,85247,425548,666,510795,THURSDAY,0,0,20,84,5.4,1014.2,Cloudy
7/14/2022 12:00,156,1124,178206,1723992,1280,1902198,THURSDAY,0,0,21.7,79,5.4,1014.4,Cloudy
7/14/2022 13:00,98,660,142641,496650,758,639291,THURSDAY,0,0,22.8,76,9.4,1014.3,Cloudy
7/14/2022 14:00,124,406,213752,308809,530,522561,THURSDAY,0,0,24.4,69,11.2,1014.9,Cloudy
7/14/2022 15:00,128,395,278837,291700,523,570537,THURSDAY,0,0,24.4,69,11.2,1014.9,Cloudy
7/14/2022 16:00,166,469,1005242,361471,635,1366713,THURSDAY,0,0,24.4,67,16.6,1014.8,Fair
7/14/2022 17:00,174,437,534810,379879,611,914689,THURSDAY,0,0,24.4,67,16.6,1013.9,Cloudy
7/14/2022 18:00,169,397,296251,307577,566,603828,THURSDAY,0,0,24.4,67,20.5,1013.9,Cloudy
7/14/2022 19:00,234,466,747218,361502,700,1108720,THURSDAY,0,0,24.4,67,20.5,1013.9,Cloudy
7/14/2022 20:00,298,829,605377,1094740,1127,1700117,THURSDAY,0,0,24.4,69,7.6,1013.5,Cloudy
7/14/2022 21:00,381,1224,596452,1063708,1605,1660160,THURSDAY,0,0,23.3,74,16.6,1013.6,Cloudy
7/14/2022 22:00,408,1112,757701,994864,1520,1752565,THURSDAY,0,0,23.3,74,16.6,1014.4,Cloudy
7/14/2022 23:00,328,836,634392,966285,1164,1600677,THURSDAY,0,0,22.2,82,9.4,1015.1,Cloudy
7/15/2022 0:00,215,570,342257,501961,785,844218,FRIDAY,0,0,22.2,82,9.4,1015.1,Cloudy
7/15/2022 1:00,155,429,321873,348879,584,670752,FRIDAY,0,0,22.8,76,5.4,1016.6,Cloudy
7/15/2022 2:00,145,239,326107,186847,384,512954,FRIDAY,0,0,23.9,66,7.6,1016.6,Fair
7/15/2022 3:00,105,189,244181,157163,294,401344,FRIDAY,0,0,23.3,64,14.8,1017.1,Fair
7/15/2022 4:00,61,88,103481,65603,149,169084,FRIDAY,0,0,22.8,61,9.4,1017.8,Fair
7/15/2022 5:00,50,40,151387,40821,90,192208,FRIDAY,0,0,22.8,61,9.4,1017.8,Fair
7/15/2022 6:00,7,22,39077,27367,29,66444,FRIDAY,0,0,21.1,68,11.2,1018.4,Fair
7/15/2022 7:00,9,10,7195,13343,19,20538,FRIDAY,0,0,20,70,13,1018.3,Fair
7/15/2022 8:00,11,15,12934,14398,26,27332,FRIDAY,0,0,19.4,68,16.6,1018.9,Fair
7/15/2022 9:00,16,86,50356,62248,102,112604,FRIDAY,0,0,19.4,68,16.6,1018.9,Fair
7/15/2022 10:00,52,201,1058290,153169,253,1211459,FRIDAY,0,0,20.6,63,14.8,1019.4,Fair
7/15/2022 11:00,83,491,119694,383112,574,502806,FRIDAY,0,0,21.7,57,14.8,1019.8,Fair
7/15/2022 12:00,143,908,193388,1242647,1051,1436035,FRIDAY,0,0,23.3,50,11.2,1020.2,Fair
7/15/2022 13:00,126,560,889954,390923,686,1280877,FRIDAY,0,0,24.4,47,5.4,1020.4,Fair
7/15/2022 14:00,147,463,269871,337105,610,606976,FRIDAY,0,0,24.4,48,14.8,1020.5,Fair
7/15/2022 15:00,182,445,407199,334145,627,741344,FRIDAY,0,0,24.4,48,14.8,1020.5,Fair
7/15/2022 16:00,207,517,1361805,398688,724,1760493,FRIDAY,0,0,25,42,20.5,1020.1,Fair
7/15/2022 17:00,258,520,495827,472321,778,968148,FRIDAY,0,0,26.1,35,22.3,1020.1,Fair
7/15/2022 18:00,273,496,654286,384472,769,1038758,FRIDAY,0,0,26.1,32,22.3,1019.7,Fair
7/15/2022 19:00,332,635,864079,1702362,967,2566441,FRIDAY,0,0,26.1,32,25.9,1019.7,Fair
7/15/2022 20:00,348,852,1225917,737840,1200,1963757,FRIDAY,0,0,25,33,25.9,1019.5,Fair
7/15/2022 21:00,465,1151,888699,1065030,1616,1953729,FRIDAY,0,0,24.4,35,22.3,1019.3,Rain
7/15/2022 22:00,448,936,903774,1161984,1384,2065758,FRIDAY,0,0,23.3,48,18.4,1019.6,Fair
7/15/2022 23:00,435,742,1035347,713786,1177,1749133,FRIDAY,0,0,23.3,48,18.4,1019.6,Fair
7/16/2022 0:00,342,614,1178240,664134,956,1842374,SATURDAY,1,0,22.2,57,13,1020,Fair
7/16/2022 1:00,273,437,1865885,471484,710,2337369,SATURDAY,1,0,21.7,66,14.8,1020.2,Fair
7/16/2022 2:00,265,394,645922,394863,659,1040785,SATURDAY,1,0,21.7,68,18.4,1020.3,Fair
7/16/2022 3:00,308,289,817593,278413,597,1096006,SATURDAY,1,0,21.7,68,14.8,1020.7,Fair
7/16/2022 4:00,234,199,414695,178617,433,593312,SATURDAY,1,0,21.1,71,16.6,1020.6,Fair
7/16/2022 5:00,234,135,457111,132787,369,589898,SATURDAY,1,0,21.1,71,16.6,1020.6,Fair
7/16/2022 6:00,74,86,194623,94886,160,289509,SATURDAY,1,0,20,76,13,1020.8,Fair
7/16/2022 7:00,15,20,38638,16966,35,55604,SATURDAY,1,0,20,76,13,1020.8,Fair
7/16/2022 8:00,9,13,14349,12408,22,26757,SATURDAY,1,0,18.3,81,7.6,1020.6,Fair
7/16/2022 9:00,13,26,17044,24605,39,41649,SATURDAY,1,0,18.3,81,7.6,1020.6,Fair
7/16/2022 10:00,31,71,57491,61201,102,118692,SATURDAY,1,0,18.9,81,11.2,1021.1,Fair
7/16/2022 11:00,46,140,65682,133605,186,199287,SATURDAY,1,0,21.7,71,7.6,1020.8,Cloudy
7/16/2022 12:00,116,258,166389,207642,374,374031,SATURDAY,1,0,25.6,52,14.8,1020.3,Cloudy
7/16/2022 13:00,217,397,1058456,355230,614,1413686,SATURDAY,1,0,27.2,41,14.8,1020,Cloudy
7/16/2022 14:00,338,515,911337,511626,853,1422963,SATURDAY,1,0,27.2,41,14.8,1020,Cloudy
7/16/2022 15:00,432,551,943457,572088,983,1515545,SATURDAY,1,0,29.4,35,20.5,1019.6,Rain
7/16/2022 16:00,461,646,1167356,592063,1107,1759419,SATURDAY,1,0,28.9,36,20.5,1019.2,Cloudy
7/16/2022 17:00,485,612,1701844,577354,1097,2279198,SATURDAY,1,0,27.8,41,18.4,1019,Cloudy
7/16/2022 18:00,495,567,2795182,526790,1062,3321972,SATURDAY,1,0,28.3,43,20.5,1018.4,Cloudy
7/16/2022 19:00,533,568,1214227,544614,1101,1758841,SATURDAY,1,0,28.3,43,20.5,1018.4,Cloudy
7/16/2022 20:00,521,604,1362442,580923,1125,1943365,SATURDAY,1,0,28.3,38,18.4,1017.4,Cloudy
7/16/2022 21:00,557,657,1872310,618192,1214,2490502,SATURDAY,1,0,26.7,44,18.4,1017.1,Cloudy
7/16/2022 22:00,471,652,2208069,655894,1123,2863963,SATURDAY,1,0,26.1,47,18.4,1017,Cloudy
7/16/2022 23:00,454,586,1056080,651911,1040,1707991,SATURDAY,1,0,26.1,47,18.4,1017,Cloudy
7/17/2022 0:00,351,470,1575366,443432,821,2018798,SUNDAY,1,0,23.9,60,14.8,1017.5,Cloudy
7/17/2022 1:00,288,338,677210,289428,626,966638,SUNDAY,1,0,23.3,69,13,1017.7,Cloudy
7/17/2022 2:00,241,271,533580,250539,512,784119,SUNDAY,1,0,23.3,69,13,1017.7,Cloudy
7/17/2022 3:00,217,267,1244254,242179,484,1486433,SUNDAY,1,0,22.2,82,11.2,1017.3,Cloudy
7/17/2022 4:00,175,164,408623,125629,339,534252,SUNDAY,1,0,22.2,82,11.2,1017.3,Cloudy
7/17/2022 5:00,193,118,2085856,113380,311,2199236,SUNDAY,1,0,22.8,81,11.2,1016.9,Cloudy
7/17/2022 6:00,96,74,146342,108312,170,254654,SUNDAY,1,0,21.7,87,14.8,1016.5,Cloudy
7/17/2022 7:00,23,22,98389,22281,45,120670,SUNDAY,1,0,21.1,90,14.8,1016.2,Cloudy
7/17/2022 8:00,13,11,58319,13573,24,71892,SUNDAY,1,0,19.4,93,9.4,1016.1,Cloudy
7/17/2022 9:00,15,20,43006,17111,35,60117,SUNDAY,1,0,19.4,93,9.4,1016.1,Cloudy
7/17/2022 10:00,25,65,44328,45337,90,89665,SUNDAY,1,0,21.1,90,11.2,1016.4,Cloudy
7/17/2022 11:00,44,94,73521,89526,138,163047,SUNDAY,1,0,22.8,79,7.6,1016.5,Cloudy
7/17/2022 12:00,104,225,176577,212439,329,389016,SUNDAY,1,0,24.4,74,9.4,1016.6,Cloudy
7/17/2022 13:00,189,342,387623,304013,531,691636,SUNDAY,1,0,26.7,62,9.4,1016.5,Cloudy
7/17/2022 14:00,327,472,1654633,413293,799,2067926,SUNDAY,1,0,26.7,62,9.4,1016.5,Fair
7/17/2022 15:00,363,501,1981377,439152,864,2420529,SUNDAY,1,0,27.8,56,16.6,1016,Fair
7/17/2022 16:00,483,620,2870157,595658,1103,3465815,SUNDAY,1,0,28.3,53,22.3,1015.8,Fair
7/17/2022 17:00,492,609,1032776,1585023,1101,2617799,SUNDAY,1,0,27.8,55,22.3,1015.4,Fair
7/17/2022 18:00,495,618,1328890,877957,1113,2206847,SUNDAY,1,0,27.8,55,29.5,1015.4,Cloudy
7/17/2022 19:00,516,625,1083537,629373,1141,1712910,SUNDAY,1,0,28.3,49,16.6,1015.3,Cloudy
7/17/2022 20:00,436,627,719770,620528,1063,1340298,SUNDAY,1,0,28.3,49,16.6,1015.3,Cloudy
7/17/2022 21:00,424,697,907299,670141,1121,1577440,SUNDAY,1,0,28.9,53,25.9,1014.7,Cloudy
7/17/2022 22:00,395,691,810784,686576,1086,1497360,SUNDAY,1,0,28.3,53,24.1,1014.8,Cloudy
7/17/2022 23:00,376,589,1967962,574703,965,2542665,SUNDAY,1,0,28.3,53,24.1,1014.8,Cloudy
7/18/2022 0:00,254,492,508909,422589,746,931498,MONDAY,0,0,25.6,58,16.6,1016,Cloudy
7/18/2022 1:00,221,354,1070992,284556,575,1355548,MONDAY,0,0,25,62,18.4,1016.4,Cloudy
7/18/2022 2:00,148,237,3616592,210049,385,3826641,MONDAY,0,0,23.3,71,13,1016.3,Fair
7/18/2022 3:00,61,132,101913,132550,193,234463,MONDAY,0,0,23.3,71,13,1016.3,Fair
7/18/2022 4:00,45,77,108031,60400,122,168431,MONDAY,0,0,22.8,81,14.8,1016.4,Cloudy
7/18/2022 5:00,14,33,48711,37936,47,86647,MONDAY,0,0,21.1,90,13,1016.2,Cloudy
7/18/2022 6:00,12,21,15401,15199,33,30600,MONDAY,0,0,21.7,94,14.8,1016.2,Cloudy
7/18/2022 7:00,10,5,116492,3364,15,119856,MONDAY,0,0,21.7,94,14.8,1016.2,Fair
7/18/2022 8:00,5,23,4897,20204,28,25101,MONDAY,0,0,21.7,94,11.2,1015.8,Cloudy
7/18/2022 9:00,15,71,10529,50479,86,61008,MONDAY,0,0,21.7,94,11.2,1015.8,Cloudy
7/18/2022 10:00,38,258,44722,186226,296,230948,MONDAY,0,0,21.7,94,13,1015.7,Cloudy
7/18/2022 11:00,82,589,120054,463894,671,583948,MONDAY,0,0,22.8,87,16.6,1015.5,Cloudy
7/18/2022 12:00,149,1026,327403,800185,1175,1127588,MONDAY,0,0,25,77,14.8,1015.5,Cloudy
7/18/2022 13:00,119,604,242333,435863,723,678196,MONDAY,0,0,25,77,14.8,1015.5,Cloudy
7/18/2022 14:00,117,359,256966,379365,476,636331,MONDAY,0,0,27.2,69,14.8,1014.6,Cloudy
7/18/2022 15:00,148,316,322606,255453,464,578059,MONDAY,0,0,27.2,69,18.4,1014.2,Cloudy
7/18/2022 16:00,128,403,393847,298348,531,692195,MONDAY,0,0,26.7,76,18.4,1013.7,Cloudy
7/18/2022 17:00,113,270,179110,183379,383,362489,MONDAY,0,0,26.7,76,18.4,1013.7,Rain
7/18/2022 18:00,133,316,392585,208964,449,601549,MONDAY,0,0,26.7,74,16.6,1012.2,Rain
7/18/2022 19:00,139,377,225360,292468,516,517828,MONDAY,0,0,26.7,74,16.6,1012.2,Rain
7/18/2022 20:00,63,321,75217,251352,384,326569,MONDAY,0,0,24.4,97,16.6,1011.1,Cloudy
7/18/2022 21:00,118,734,170201,548585,852,718786,MONDAY,0,0,24.4,97,16.6,1011.1,Rain
7/18/2022 22:00,201,853,467467,717392,1054,1184859,MONDAY,0,0,23.3,97,18.4,1009.9,Rain
7/18/2022 23:00,162,745,248812,590165,907,838977,MONDAY,0,0,23.9,94,14.8,1009.2,Rain
7/19/2022 0:00,126,511,152946,627419,637,780365,TUESDAY,0,0,23.9,94,24.1,1007.6,Rain
7/19/2022 1:00,119,319,231012,253837,438,484849,TUESDAY,0,0,23.9,90,22.3,1006.6,Rain
7/19/2022 2:00,80,185,177491,130226,265,307717,TUESDAY,0,0,23.9,90,22.3,1006.6,Rain
7/19/2022 3:00,41,105,78099,78420,146,156519,TUESDAY,0,0,23.9,88,29.5,1006.2,Rain
7/19/2022 4:00,27,40,72821,30810,67,103631,TUESDAY,0,0,23.9,88,18.4,1004.9,Cloudy
7/19/2022 5:00,5,12,5119,10060,17,15179,TUESDAY,0,0,23.3,94,20.5,1004,Cloudy
7/19/2022 6:00,6,12,7230,9123,18,16353,TUESDAY,0,0,23.9,90,18.4,1002.7,Cloudy
7/19/2022 7:00,3,9,3438,7028,12,10466,TUESDAY,0,0,23.9,88,22.3,1001.9,Cloudy
7/19/2022 8:00,6,20,5816,16083,26,21899,TUESDAY,0,0,23.9,88,22.3,1001.9,Cloudy
7/19/2022 9:00,19,94,43263,70736,113,113999,TUESDAY,0,0,23.3,85,20.5,1002,Cloudy
7/19/2022 10:00,51,296,94593,224803,347,319396,TUESDAY,0,0,23.9,76,27.7,1002.1,Rain
7/19/2022 11:00,127,723,219907,565229,850,785136,TUESDAY,0,0,25,69,27.7,1002.8,Cloudy
7/19/2022 12:00,178,1173,1185087,1095379,1351,2280466,TUESDAY,0,0,26.7,62,27.7,1003.5,Cloudy
7/19/2022 13:00,125,648,181579,508822,773,690401,TUESDAY,0,0,26.7,62,27.7,1003.5,Cloudy
7/19/2022 14:00,89,395,187873,298326,484,486199,TUESDAY,0,0,29.4,50,22.3,1004.3,Fair
7/19/2022 15:00,168,370,334172,322172,538,656344,TUESDAY,0,0,31.1,45,22.3,1004.2,Fair
7/19/2022 16:00,160,442,680217,343859,602,1024076,TUESDAY,0,0,32.2,41,33.5,1004.3,Fair
7/19/2022 17:00,154,402,279674,337914,556,617588,TUESDAY,0,0,32.2,41,29.5,1004.3,Fair
7/19/2022 18:00,165,389,311002,288460,554,599462,TUESDAY,0,0,33.3,40,25.9,1003.8,Fair
7/19/2022 19:00,180,469,2050931,373492,649,2424423,TUESDAY,0,0,33.3,38,29.5,1003.6,Fair
7/19/2022 20:00,248,710,2091189,590987,958,2682176,TUESDAY,0,0,32.8,38,25.9,1003.5,Fair
7/19/2022 21:00,354,1318,558527,1551933,1672,2110460,TUESDAY,0,0,31.7,41,27.7,1003.7,Fair
7/19/2022 22:00,397,1178,2229129,1205515,1575,3434644,TUESDAY,0,0,31.1,43,20.5,1003.9,Fair
7/19/2022 23:00,334,904,668638,739140,1238,1407778,TUESDAY,0,0,31.1,43,20.5,1003.9,Fair
7/20/2022 0:00,239,661,1887928,555057,900,2442985,WEDNESDAY,0,0,29.4,51,18.4,1004.8,Cloudy
7/20/2022 1:00,175,389,260922,323676,564,584598,WEDNESDAY,0,0,28.9,53,14.8,1005.4,Cloudy
7/20/2022 2:00,143,244,276801,215477,387,492278,WEDNESDAY,0,0,28.3,55,20.5,1005.9,Fair
7/20/2022 3:00,61,135,83966,118262,196,202228,WEDNESDAY,0,0,28.3,55,20.5,1005.9,Fair
7/20/2022 4:00,30,72,54201,60404,102,114605,WEDNESDAY,0,0,27.2,58,18.4,1006.4,Fair
7/20/2022 5:00,24,34,23690,32533,58,56223,WEDNESDAY,0,0,26.7,60,13,1006,Fair
7/20/2022 6:00,18,14,15588,10909,32,26497,WEDNESDAY,0,0,26.1,62,16.6,1006,Fair
7/20/2022 7:00,2,16,3391,14788,18,18179,WEDNESDAY,0,0,26.1,65,16.6,1006,Fair
7/20/2022 8:00,3,26,8322,20913,29,29235,WEDNESDAY,0,0,26.1,65,16.6,1006,Fair
7/20/2022 9:00,20,98,72282,75771,118,148053,WEDNESDAY,0,0,26.1,67,13,1006.3,Fair
7/20/2022 10:00,48,287,56475,204996,335,261471,WEDNESDAY,0,0,26.1,67,13,1006.5,Fair
7/20/2022 11:00,112,658,421202,484557,770,905759,WEDNESDAY,0,0,28.3,61,13,1006.6,Fair
7/20/2022 12:00,159,1101,187745,834087,1260,1021832,WEDNESDAY,0,0,30,57,16.6,1006.7,Fair
7/20/2022 13:00,108,639,173279,564738,747,738017,WEDNESDAY,0,0,30,57,16.6,1006.7,Fair
7/20/2022 14:00,120,396,348681,292329,516,641010,WEDNESDAY,0,0,31.7,50,7.6,1006.7,Fair
7/20/2022 15:00,151,343,272127,264246,494,536373,WEDNESDAY,0,0,31.7,52,7.6,1006.6,Fair
7/20/2022 16:00,142,420,417479,325773,562,743252,WEDNESDAY,0,0,32.8,49,14.8,1006.3,Fair
7/20/2022 17:00,156,372,305667,290674,528,596341,WEDNESDAY,0,0,32.8,49,20.5,1006.3,Fair
7/20/2022 18:00,154,408,314106,314888,562,628994,WEDNESDAY,0,0,30.6,53,25.9,1005.8,Fair
7/20/2022 19:00,201,462,1764519,1473168,663,3237687,WEDNESDAY,0,0,29.4,59,16.6,1005.5,Cloudy
7/20/2022 20:00,245,733,502790,579593,978,1082383,WEDNESDAY,0,0,30,55,18.4,1005.1,Cloudy
7/20/2022 21:00,416,1268,1805571,1829352,1684,3634923,WEDNESDAY,0,0,30,55,18.4,1005.1,Cloudy
7/20/2022 22:00,358,1083,2191358,925282,1441,3116640,WEDNESDAY,0,0,30,55,9.4,1005,Fair
7/20/2022 23:00,299,850,620966,671953,1149,1292919,WEDNESDAY,0,0,28.3,59,9.4,1005,Fair
7/21/2022 0:00,240,690,581322,593207,930,1174529,THURSDAY,0,0,30,59,13,1005.7,Fair
7/21/2022 1:00,196,482,277584,449388,678,726972,THURSDAY,0,0,28.9,65,13,1006.2,Fair
7/21/2022 2:00,107,276,170482,234798,383,405280,THURSDAY,0,0,27.2,72,11.2,1006.6,Fair
7/21/2022 3:00,72,151,255272,119029,223,374301,THURSDAY,0,0,25.6,76,16.6,1006,Fair
7/21/2022 4:00,27,66,30679,111687,93,142366,THURSDAY,0,0,25,82,11.2,1005.7,Fair
7/21/2022 5:00,30,20,37949,19375,50,57324,THURSDAY,0,0,25,82,11.2,1005.7,Fair
7/21/2022 6:00,14,11,21810,8057,25,29867,THURSDAY,0,0,23.3,85,13,1005.3,Fair
7/21/2022 7:00,1,9,1509,7194,10,8703,THURSDAY,0,0,23.3,82,11.2,1005.4,Fair
7/21/2022 8:00,5,27,25427,23545,32,48972,THURSDAY,0,0,22.2,87,7.6,1005.3,Fair
7/21/2022 9:00,17,86,13649,57817,103,71466,THURSDAY,0,0,22.8,87,9.4,1005.3,Fair
7/21/2022 10:00,54,305,75945,219333,359,295278,THURSDAY,0,0,23.9,84,13,1005.2,Fair
7/21/2022 11:00,111,613,1058822,467309,724,1526131,THURSDAY,0,0,23.9,84,13,1005.2,Fair
7/21/2022 12:00,187,1085,224142,806298,1272,1030440,THURSDAY,0,0,27.2,72,16.6,1005.4,Fair
7/21/2022 13:00,136,597,218280,428236,733,646516,THURSDAY,0,0,30,61,20.5,1005.3,Fair
7/21/2022 14:00,142,348,255374,249982,490,505356,THURSDAY,0,0,31.7,52,20.5,1005,Cloudy
7/21/2022 15:00,133,332,1667758,260991,465,1928749,THURSDAY,0,0,31.7,52,33.5,1005,Cloudy
7/21/2022 16:00,183,400,490377,247998,583,738375,THURSDAY,0,0,33.3,51,29.5,1004,Fair
7/21/2022 17:00,140,343,255200,243015,483,498215,THURSDAY,0,0,34.4,48,31.7,1003.1,Fair
7/21/2022 18:00,183,393,347734,939887,576,1287621,THURSDAY,0,0,34.4,48,31.7,1002.7,Cloudy
7/21/2022 19:00,196,455,330752,349936,651,680688,THURSDAY,0,0,33.3,51,31.7,1002.4,Cloudy
7/21/2022 20:00,231,700,1432307,529818,931,1962125,THURSDAY,0,0,33.3,51,38.9,1002.4,Cloudy
7/21/2022 21:00,385,1168,1924580,917334,1553,2841914,THURSDAY,0,0,30.6,63,22.3,1002.5,Cloudy
7/21/2022 22:00,322,987,428084,796741,1309,1224825,THURSDAY,0,0,29.4,68,25.9,1002.8,Cloudy
7/21/2022 23:00,287,762,726099,671719,1049,1397818,THURSDAY,0,0,27.2,77,20.5,1003.2,Cloudy
7/22/2022 0:00,255,570,489683,1440489,825,1930172,FRIDAY,0,0,27.2,77,20.5,1003.2,Cloudy
7/22/2022 1:00,195,442,472858,425326,637,898184,FRIDAY,0,0,26.7,82,14.8,1004.9,Fair
7/22/2022 2:00,138,300,232417,251590,438,484007,FRIDAY,0,0,26.7,79,20.5,1004.8,Fair
7/22/2022 3:00,102,181,162801,203593,283,366394,FRIDAY,0,0,26.7,79,11.2,1005.2,Fair
7/22/2022 4:00,56,83,85385,66088,139,151473,FRIDAY,0,0,27.2,69,13,1005.4,Fair
7/22/2022 5:00,37,62,42496,53423,99,95919,FRIDAY,0,0,27.2,69,13,1005.4,Fair
7/22/2022 6:00,24,33,31489,81588,57,113077,FRIDAY,0,0,26.7,62,9.4,1006.5,Fair
7/22/2022 7:00,4,18,3754,20448,22,24202,FRIDAY,0,0,26.1,65,13,1007,Fair
7/22/2022 8:00,8,24,8508,18957,32,27465,FRIDAY,0,0,25.6,64,11.2,1007.7,Fair
7/22/2022 9:00,23,79,25606,55382,102,80988,FRIDAY,0,0,23.9,74,9.4,1008.5,Fair
7/22/2022 10:00,34,244,44890,193160,278,238050,FRIDAY,0,0,23.9,74,9.4,1008.5,Fair
7/22/2022 11:00,87,482,129088,358518,569,487606,FRIDAY,0,0,27.8,56,18.4,1009.7,Fair
7/22/2022 12:00,123,791,202572,583300,914,785872,FRIDAY,0,0,28.9,51,14.8,1010,Fair
7/22/2022 13:00,132,537,241119,378987,669,620106,FRIDAY,0,0,30.6,42,11.2,1010.3,Fair
7/22/2022 14:00,153,374,307162,271369,527,578531,FRIDAY,0,0,31.7,38,9.4,1010.9,Fair
7/22/2022 15:00,163,394,336754,293907,557,630661,FRIDAY,0,0,31.7,38,9.4,1010.9,Fair
7/22/2022 16:00,184,418,393611,301357,602,694968,FRIDAY,0,0,31.7,36,13,1010.5,Fair
7/22/2022 17:00,229,449,402504,352697,678,755201,FRIDAY,0,0,32.2,35,13,1010.4,Fair
7/22/2022 18:00,230,410,2269076,325032,640,2594108,FRIDAY,0,0,31.7,37,16.6,1010.1,Fair
7/22/2022 19:00,244,541,1495859,404934,785,1900793,FRIDAY,0,0,31.7,37,16.6,1010.1,Fair
7/22/2022 20:00,291,674,668390,495211,965,1163601,FRIDAY,0,0,30,40,22.3,1010,Fair
7/22/2022 21:00,378,866,685292,1046238,1244,1731530,FRIDAY,0,0,33.9,27,22.3,1009.8,Fair
7/22/2022 22:00,331,818,1248691,694753,1149,1943444,FRIDAY,0,0,32.8,31,18.4,1010.2,Fair
7/22/2022 23:00,252,687,449140,576611,939,1025751,FRIDAY,0,0,32.2,33,18.4,1010.9,Fair
7/23/2022 0:00,217,483,2399342,446528,700,2845870,SATURDAY,1,0,32.2,33,18.4,1010.9,Fair
7/23/2022 1:00,235,444,1931925,374232,679,2306157,SATURDAY,1,0,30.6,40,22.3,1011.4,Fair
7/23/2022 2:00,240,369,483774,342499,609,826273,SATURDAY,1,0,28.3,55,16.6,1012.6,Fair
7/23/2022 3:00,274,255,949927,229065,529,1178992,SATURDAY,1,0,26.7,60,13,1012.7,Fair
7/23/2022 4:00,147,188,255321,153600,335,408921,SATURDAY,1,0,26.1,65,14.8,1012.8,Fair
7/23/2022 5:00,195,142,2331663,214955,337,2546618,SATURDAY,1,0,26.1,65,14.8,1012.8,Fair
7/23/2022 6:00,104,85,1155352,83932,189,1239284,SATURDAY,1,0,25,69,11.2,1012.9,Fair
7/23/2022 7:00,19,30,23359,42602,49,65961,SATURDAY,1,0,25,69,13,1013.2,Fair
7/23/2022 8:00,16,24,18900,19536,40,38436,SATURDAY,1,0,25,69,13,1013.5,Fair
7/23/2022 9:00,17,36,34382,38601,53,72983,SATURDAY,1,0,25,69,11.2,1014.1,Fair
7/23/2022 10:00,28,80,71773,67096,108,138869,SATURDAY,1,0,25,69,11.2,1014.1,Fair
7/23/2022 11:00,53,165,88112,162895,218,251007,SATURDAY,1,0,27.2,61,14.8,1014.6,Fair
7/23/2022 12:00,97,283,291612,233335,380,524947,SATURDAY,1,0,28.9,51,9.4,1014.5,Fair
7/23/2022 13:00,187,383,755713,323496,570,1079209,SATURDAY,1,0,30,46,11.2,1014.8,Fair
7/23/2022 14:00,273,427,558819,447179,700,1005998,SATURDAY,1,0,31.7,39,9.4,1014.5,Fair
7/23/2022 15:00,361,535,2336439,420109,896,2756548,SATURDAY,1,0,31.7,39,9.4,1014.5,Fair
7/23/2022 16:00,407,509,937656,404278,916,1341934,SATURDAY,1,0,32.8,36,9.4,1014.4,Fair
7/23/2022 17:00,376,496,1402748,404557,872,1807305,SATURDAY,1,0,32.8,36,9.4,1014.4,Fair
7/23/2022 18:00,417,466,804844,393585,883,1198429,SATURDAY,1,0,30.6,45,20.5,1014.1,Fair
7/23/2022 19:00,388,495,1092879,420455,883,1513334,SATURDAY,1,0,30.6,45,16.6,1014.1,Fair
7/23/2022 20:00,313,492,524222,455189,805,979411,SATURDAY,1,0,31.7,37,16.6,1013.6,Fair
7/23/2022 21:00,306,495,650901,432739,801,1083640,SATURDAY,1,0,31.7,37,20.5,1013.6,Rain
7/23/2022 22:00,330,529,912294,464102,859,1376396,SATURDAY,1,0,30,48,13,1013.1,Fair
7/23/2022 23:00,449,534,1331598,461157,983,1792755,SATURDAY,1,0,32.8,32,16.6,1014.3,Cloudy
7/24/2022 0:00,342,498,575552,537897,840,1113449,SUNDAY,1,0,32.8,32,16.6,1014.3,Cloudy
7/24/2022 1:00,269,336,569432,270511,605,839943,SUNDAY,1,0,28.3,46,13,1015.2,Fair
7/24/2022 2:00,238,283,563771,248284,521,812055,SUNDAY,1,0,28.3,46,13,1015.2,Fair
7/24/2022 3:00,195,251,598501,205896,446,804397,SUNDAY,1,0,28.9,48,16.6,1015.4,Fair
7/24/2022 4:00,198,156,692517,142663,354,835180,SUNDAY,1,0,28.3,49,13,1015.3,Fair
7/24/2022 5:00,231,138,1903924,168645,369,2072569,SUNDAY,1,0,26.1,56,9.4,1015.4,Fair
7/24/2022 6:00,99,88,1289621,92047,187,1381668,SUNDAY,1,0,23.9,66,7.6,1014.9,Fair
7/24/2022 7:00,20,25,85694,26657,45,112351,SUNDAY,1,0,22.8,73,0,1015.3,Fair
7/24/2022 8:00,9,17,22141,18629,26,40770,SUNDAY,1,0,22.8,73,0,1015.3,Fair
7/24/2022 9:00,33,26,100364,27738,59,128102,SUNDAY,1,0,24.4,69,11.2,1014.8,Fair
7/24/2022 10:00,24,77,64027,94466,101,158493,SUNDAY,1,0,24.4,69,11.2,1014.8,Cloudy
7/24/2022 11:00,48,141,130246,138614,189,268860,SUNDAY,1,0,27.8,63,13,1014.7,Cloudy
7/24/2022 12:00,130,240,269314,188992,370,458306,SUNDAY,1,0,30.6,51,16.6,1015,Cloudy
7/24/2022 13:00,180,313,533600,283560,493,817160,SUNDAY,1,0,31.7,50,16.6,1015.3,Cloudy
7/24/2022 14:00,265,343,904108,324436,608,1228544,SUNDAY,1,0,31.7,50,16.6,1015.3,Cloudy
7/24/2022 15:00,304,463,707398,414164,767,1121562,SUNDAY,1,0,35.6,35,22.3,1013.7,Cloudy
7/24/2022 16:00,281,444,590962,374059,725,965021,SUNDAY,1,0,36.7,29,22.3,1012.9,Fair
7/24/2022 17:00,322,433,927697,376677,755,1304374,SUNDAY,1,0,37.2,27,37.1,1012.1,Cloudy
7/24/2022 18:00,262,399,497191,314307,661,811498,SUNDAY,1,0,36.7,25,35.3,1011.5,Cloudy
7/24/2022 19:00,271,495,556869,415604,766,972473,SUNDAY,1,0,36.7,25,35.3,1011.5,Cloudy
7/24/2022 20:00,278,493,556022,474916,771,1030938,SUNDAY,1,0,36.1,31,25.9,1010.7,Cloudy
7/24/2022 21:00,345,480,679344,422828,825,1102172,SUNDAY,1,0,36.1,31,33.5,1010.7,Rain
7/24/2022 22:00,298,569,482650,518827,867,1001477,SUNDAY,1,0,35,32,35.3,1010.8,Cloudy
7/24/2022 23:00,262,489,508870,450278,751,959148,SUNDAY,1,0,33.9,36,31.7,1011.1,Cloudy
7/25/2022 0:00,248,424,438086,380917,672,819003,MONDAY,0,0,31.7,47,27.7,1011.5,Cloudy
7/25/2022 1:00,171,309,1440043,252961,480,1693004,MONDAY,0,0,30.6,50,22.3,1011.9,Cloudy
7/25/2022 2:00,159,218,1168402,176278,377,1344680,MONDAY,0,0,27.8,65,20.5,1012.4,Cloudy
7/25/2022 3:00,65,155,85562,133702,220,219264,MONDAY,0,0,28.3,63,22.3,1012.1,Cloudy
7/25/2022 4:00,31,56,38119,52404,87,90523,MONDAY,0,0,28.3,65,24.1,1011.5,Cloudy
7/25/2022 5:00,9,33,12220,28625,42,40845,MONDAY,0,0,27.2,72,20.5,1010.9,Fair
7/25/2022 6:00,13,10,20221,8798,23,29019,MONDAY,0,0,27.2,72,22.3,1010.9,Fair
7/25/2022 7:00,10,11,9776,11062,21,20838,MONDAY,0,0,26.1,79,18.4,1010.9,Cloudy
7/25/2022 8:00,6,19,5652,21227,25,26879,MONDAY,0,0,26.1,82,13,1010.6,Cloudy
7/25/2022 9:00,13,75,16617,53519,88,70136,MONDAY,0,0,26.1,82,13,1010.6,Cloudy
7/25/2022 10:00,41,233,80748,161819,274,242567,MONDAY,0,0,26.1,85,24.1,1009.8,Cloudy
7/25/2022 11:00,72,591,74552,502681,663,577233,MONDAY,0,0,26.1,85,24.1,1009.8,Cloudy
7/25/2022 12:00,129,950,144653,1672605,1079,1817258,MONDAY,0,0,28.9,72,20.5,1009.9,Cloudy
7/25/2022 13:00,90,549,115461,368161,639,483622,MONDAY,0,0,30.6,63,24.1,1009.7,Cloudy
7/25/2022 14:00,106,348,251194,243989,454,495183,MONDAY,0,0,30.6,63,24.1,1009.7,Cloudy
7/25/2022 15:00,135,315,270748,208947,450,479695,MONDAY,0,0,31.7,57,24.1,1009.5,Cloudy
7/25/2022 16:00,125,412,178550,268194,537,446744,MONDAY,0,0,31.1,61,25.9,1008.9,Rain
7/25/2022 17:00,125,352,211467,231008,477,442475,MONDAY,0,0,31.1,61,27.7,1008.5,Rain
7/25/2022 18:00,123,355,511722,1399968,478,1911690,MONDAY,0,0,30,65,18.4,1008.3,Rain
7/25/2022 19:00,166,428,307344,328870,594,636214,MONDAY,0,0,30,65,18.4,1008.3,Rain
7/25/2022 20:00,178,661,1490522,520513,839,2011035,MONDAY,0,0,31.7,56,31.7,1008,Rain
7/25/2022 21:00,298,1123,483641,1663436,1421,2147077,MONDAY,0,0,31.7,54,31.7,1008,Rain
7/25/2022 22:00,264,965,1078446,745183,1229,1823629,MONDAY,0,0,30.6,57,33.5,1008.3,Rain
7/25/2022 23:00,235,727,362644,587928,962,950572,MONDAY,0,0,30.6,57,27.7,1008.3,Rain
7/26/2022 0:00,118,393,166952,326838,511,493790,TUESDAY,0,0,29.4,63,22.3,1008.6,Rain
7/26/2022 1:00,90,328,489918,251556,418,741474,TUESDAY,0,0,27.2,61,13,1010,Rain
7/26/2022 2:00,110,221,141403,181980,331,323383,TUESDAY,0,0,26.7,56,18.4,1011.9,Cloudy
7/26/2022 3:00,95,125,151792,102947,220,254739,TUESDAY,0,0,26.1,52,18.4,1012.2,Cloudy
7/26/2022 4:00,41,58,85524,56786,99,142310,TUESDAY,0,0,26.1,52,18.4,1012.2,Fair
7/26/2022 5:00,27,26,45258,30977,53,76235,TUESDAY,0,0,25,48,16.6,1012.5,Fair
7/26/2022 6:00,19,16,46553,22729,35,69282,TUESDAY,0,0,23.9,48,14.8,1012.9,Fair
7/26/2022 7:00,3,9,5337,10408,12,15745,TUESDAY,0,0,23.3,48,16.6,1012.9,Fair
7/26/2022 8:00,8,19,29957,21359,27,51316,TUESDAY,0,0,22.8,50,13,1013.7,Fair
7/26/2022 9:00,23,102,748325,81815,125,830140,TUESDAY,0,0,22.8,50,13,1013.7,Fair
7/26/2022 10:00,42,296,52529,208811,338,261340,TUESDAY,0,0,22.8,50,13,1014.6,Rain
7/26/2022 11:00,127,712,1210665,552066,839,1762731,TUESDAY,0,0,23.3,50,13,1014.9,Fair
7/26/2022 12:00,162,1134,211065,843289,1296,1054354,TUESDAY,0,0,24.4,47,11.2,1014.7,Fair
7/26/2022 13:00,131,659,164352,1523002,790,1687354,TUESDAY,0,0,25.6,43,9.4,1014.5,Fair
7/26/2022 14:00,130,367,291848,446892,497,738740,TUESDAY,0,0,25.6,43,9.4,1014.5,Fair
7/26/2022 15:00,131,399,268748,302139,530,570887,TUESDAY,0,0,25.6,45,11.2,1014.4,Fair
7/26/2022 16:00,151,440,261208,1384405,591,1645613,TUESDAY,0,0,26.7,42,16.6,1014.2,Cloudy
7/26/2022 17:00,202,438,385035,322361,640,707396,TUESDAY,0,0,28.3,33,16.6,1013.7,Cloudy
7/26/2022 18:00,166,437,433176,358290,603,791466,TUESDAY,0,0,28.3,33,16.6,1013.7,Cloudy
7/26/2022 19:00,259,563,504515,438199,822,942714,TUESDAY,0,0,26.7,41,13,1013.3,Cloudy
7/26/2022 20:00,254,794,552940,642104,1048,1195044,TUESDAY,0,0,26.7,41,13,1013.3,Cloudy
7/26/2022 21:00,453,1376,770758,1234186,1829,2004944,TUESDAY,0,0,26.1,42,20.5,1013.2,Rain
7/26/2022 22:00,453,1208,743138,1051333,1661,1794471,TUESDAY,0,0,25.6,43,18.4,1013.3,Cloudy
7/26/2022 23:00,282,849,1091890,720144,1131,1812034,TUESDAY,0,0,25.6,43,18.4,1013.3,Cloudy
7/27/2022 0:00,232,634,484089,570385,866,1054474,WEDNESDAY,0,0,25,45,20.5,1013.4,Cloudy
7/27/2022 1:00,199,439,270830,359384,638,630214,WEDNESDAY,0,0,23.9,46,14.8,1014,Cloudy
7/27/2022 2:00,222,305,386396,249578,527,635974,WEDNESDAY,0,0,23.9,46,14.8,1014,Fair
7/27/2022 3:00,90,151,111138,127315,241,238453,WEDNESDAY,0,0,22.8,51,14.8,1013.9,Fair
7/27/2022 4:00,38,81,173658,69570,119,243228,WEDNESDAY,0,0,22.8,51,14.8,1013.9,Fair
7/27/2022 5:00,22,25,35987,22745,47,58732,WEDNESDAY,0,0,21.1,59,14.8,1013.9,Fair
7/27/2022 6:00,11,12,9139,11449,23,20588,WEDNESDAY,0,0,21.1,59,14.8,1013.9,Fair
7/27/2022 7:00,5,18,24903,15760,23,40663,WEDNESDAY,0,0,20,65,14.8,1013.7,Fair
7/27/2022 8:00,3,21,1739,21388,24,23127,WEDNESDAY,0,0,20,63,11.2,1013.5,Fair
7/27/2022 9:00,19,96,22723,75317,115,98040,WEDNESDAY,0,0,20,63,11.2,1013.5,Fair
7/27/2022 10:00,55,268,70003,196771,323,266774,WEDNESDAY,0,0,21.1,59,11.2,1013.8,Rain
7/27/2022 11:00,119,709,140598,559727,828,700325,WEDNESDAY,0,0,22.2,55,13,1013.8,Fair
7/27/2022 12:00,143,1125,137826,846872,1268,984698,WEDNESDAY,0,0,24.4,43,16.6,1013.6,Fair
7/27/2022 13:00,107,665,180113,476029,772,656142,WEDNESDAY,0,0,24.4,43,16.6,1013.6,Fair
7/27/2022 14:00,131,412,257437,302497,543,559934,WEDNESDAY,0,0,26.1,36,9.4,1013,Fair
7/27/2022 15:00,157,417,284593,309903,574,594496,WEDNESDAY,0,0,25.6,40,14.8,1013.1,Fair
7/27/2022 16:00,148,457,271907,341923,605,613830,WEDNESDAY,0,0,27.8,34,9.4,1012.8,Cloudy
7/27/2022 17:00,186,409,335461,311677,595,647138,WEDNESDAY,0,0,27.8,37,9.4,1011.8,Cloudy
7/27/2022 18:00,194,422,316082,327771,616,643853,WEDNESDAY,0,0,27.8,37,20.5,1011.8,Cloudy
7/27/2022 19:00,202,597,1322105,465478,799,1787583,WEDNESDAY,0,0,24.4,50,25.9,1012.2,Cloudy
7/27/2022 20:00,300,871,484808,780289,1171,1265097,WEDNESDAY,0,0,24.4,50,20.5,1012.2,Cloudy
7/27/2022 21:00,483,1414,832252,1167642,1897,1999894,WEDNESDAY,0,0,22.2,64,16.6,1011.9,Rain
7/27/2022 22:00,463,1220,945767,1092700,1683,2038467,WEDNESDAY,0,0,22.2,64,16.6,1011.9,Cloudy
7/27/2022 23:00,329,906,655940,785977,1235,1441917,WEDNESDAY,0,0,21.1,71,14.8,1012,Cloudy
7/28/2022 0:00,229,623,495970,539735,852,1035705,THURSDAY,0,0,20,73,7.6,1012,Cloudy
7/28/2022 1:00,225,472,580428,489884,697,1070312,THURSDAY,0,0,19.4,76,9.4,1012.1,Cloudy
7/28/2022 2:00,226,339,320393,298679,565,619072,THURSDAY,0,0,20,78,5.4,1012.1,Cloudy
7/28/2022 3:00,99,177,152520,171173,276,323693,THURSDAY,0,0,20,78,5.4,1012.1,Cloudy
7/28/2022 4:00,44,96,36874,78377,140,115251,THURSDAY,0,0,20,76,5.4,1012.2,Fair
7/28/2022 5:00,17,63,72931,49478,80,122409,THURSDAY,0,0,21.1,71,7.6,1011.7,Fair
7/28/2022 6:00,20,17,24886,16266,37,41152,THURSDAY,0,0,22.2,66,7.6,1011.8,Fair
7/28/2022 7:00,5,10,9422,13017,15,22439,THURSDAY,0,0,20,76,9.4,1011.7,Fair
7/28/2022 8:00,6,22,26268,21791,28,48059,THURSDAY,0,0,20,76,9.4,1011.7,Fair
7/28/2022 9:00,18,87,64615,91106,105,155721,THURSDAY,0,0,20,78,11.2,1011.5,Fair
7/28/2022 10:00,47,254,57641,180547,301,238188,THURSDAY,0,0,21.1,76,13,1011.7,Fair
7/28/2022 11:00,87,640,139087,516958,727,656045,THURSDAY,0,0,23.9,71,9.4,1011.8,Fair
7/28/2022 12:00,157,1071,172807,812595,1228,985402,THURSDAY,0,0,23.9,71,9.4,1011.8,Fair
7/28/2022 13:00,112,682,144314,451123,794,595437,THURSDAY,0,0,25,71,11.2,1011.6,Fair
7/28/2022 14:00,152,414,1053938,312373,566,1366311,THURSDAY,0,0,25.6,71,11.2,1011.3,Fair
7/28/2022 15:00,189,365,988473,255410,554,1243883,THURSDAY,0,0,28.9,63,14.8,1010.6,Fair
7/28/2022 16:00,206,419,406974,288923,625,695897,THURSDAY,0,0,30,55,20.5,1010.4,Fair
7/28/2022 17:00,176,400,310505,319257,576,629762,THURSDAY,0,0,30,55,20.5,1010.4,Fair
7/28/2022 18:00,179,382,408426,298423,561,706849,THURSDAY,0,0,30.6,55,25.9,1009.2,Fair
7/28/2022 19:00,236,552,384096,455101,788,839197,THURSDAY,0,0,30.6,55,29.5,1008.7,Cloudy
7/28/2022 20:00,299,809,516984,635832,1108,1152816,THURSDAY,0,0,30,57,27.7,1008.2,Cloudy
7/28/2022 21:00,459,1229,786530,1054931,1688,1841461,THURSDAY,0,0,28.9,61,27.7,1007.6,Cloudy
7/28/2022 22:00,406,1081,1943259,940572,1487,2883831,THURSDAY,0,0,27.2,69,25.9,1007.5,Cloudy
7/28/2022 23:00,275,769,749982,630373,1044,1380355,THURSDAY,0,0,27.2,69,25.9,1007.5,Cloudy
7/29/2022 0:00,187,520,816461,440394,707,1256855,FRIDAY,0,0,25.6,79,18.4,1008.6,Cloudy
7/29/2022 1:00,142,389,257143,331306,531,588449,FRIDAY,0,0,25,88,14.8,1009.2,Cloudy
7/29/2022 2:00,103,163,1346256,134821,266,1481077,FRIDAY,0,0,25,90,13,1009.2,Cloudy
7/29/2022 3:00,66,129,170319,101564,195,271883,FRIDAY,0,0,25,90,13,1009.2,Cloudy
7/29/2022 4:00,69,117,86136,87745,186,173881,FRIDAY,0,0,23.9,90,16.6,1008.4,Cloudy
7/29/2022 5:00,36,35,84872,27378,71,112250,FRIDAY,0,0,23.3,91,13,1008.3,Cloudy
7/29/2022 6:00,18,34,75064,35345,52,110409,FRIDAY,0,0,23.9,84,7.6,1008.2,Cloudy
7/29/2022 7:00,9,15,8268,17134,24,25402,FRIDAY,0,0,23.9,79,7.6,1008.4,Cloudy
7/29/2022 8:00,15,28,638428,23670,43,662098,FRIDAY,0,0,23.9,79,7.6,1008.4,Cloudy
7/29/2022 9:00,15,95,15378,61349,110,76727,FRIDAY,0,0,23.9,76,13,1009.6,Cloudy
7/29/2022 10:00,44,243,48101,178130,287,226231,FRIDAY,0,0,24.4,69,11.2,1010.3,Fair
7/29/2022 11:00,84,511,84885,391532,595,476417,FRIDAY,0,0,24.4,69,11.2,1010.3,Cloudy
7/29/2022 12:00,130,831,155404,628037,961,783441,FRIDAY,0,0,26.7,56,11.2,1010.4,Cloudy
7/29/2022 13:00,149,629,285377,424471,778,709848,FRIDAY,0,0,28.9,48,14.8,1010.8,Cloudy
7/29/2022 14:00,195,379,407777,350785,574,758562,FRIDAY,0,0,28.9,48,14.8,1010.8,Cloudy
7/29/2022 15:00,210,371,482515,294786,581,777301,FRIDAY,0,0,31.1,36,22.3,1010.5,Rain
7/29/2022 16:00,238,461,538714,354900,699,893614,FRIDAY,0,0,31.7,34,18.4,1010.5,Fair
7/29/2022 17:00,253,459,457614,318962,712,776576,FRIDAY,0,0,31.7,34,18.4,1010.5,Cloudy
7/29/2022 18:00,325,482,857302,403248,807,1260550,FRIDAY,0,0,32.2,29,20.5,1010.1,Cloudy
7/29/2022 19:00,277,561,511343,459393,838,970736,FRIDAY,0,0,32.8,26,24.1,1010.1,Cloudy
7/29/2022 20:00,287,814,499751,698975,1101,1198726,FRIDAY,0,0,31.7,30,11.2,1010,Cloudy
7/29/2022 21:00,391,967,621953,830926,1358,1452879,FRIDAY,0,0,32.2,34,20.5,1009.9,Rain
7/29/2022 22:00,403,860,864650,756663,1263,1621313,FRIDAY,0,0,32.2,34,20.5,1009.9,Cloudy
7/29/2022 23:00,335,759,593897,650575,1094,1244472,FRIDAY,0,0,29.4,46,24.1,1010.7,Cloudy
7/30/2022 0:00,276,578,514633,530830,854,1045463,SATURDAY,1,0,28.9,45,25.9,1010.8,Cloudy
7/30/2022 1:00,246,402,604903,354324,648,959227,SATURDAY,1,0,28.3,49,18.4,1011.5,Cloudy
7/30/2022 2:00,240,322,595546,439661,562,1035207,SATURDAY,1,0,27.8,53,22.3,1011.8,Cloudy
7/30/2022 3:00,207,216,1127088,180932,423,1308020,SATURDAY,1,0,27.8,53,22.3,1011.8,Cloudy
7/30/2022 4:00,180,174,665409,168550,354,833959,SATURDAY,1,0,26.1,62,20.5,1011.9,Cloudy
7/30/2022 5:00,185,153,416158,147286,338,563444,SATURDAY,1,0,25.6,67,11.2,1011.7,Cloudy
7/30/2022 6:00,105,89,303744,88861,194,392605,SATURDAY,1,0,23.3,76,5.4,1011.7,Cloudy
7/30/2022 7:00,45,28,136403,30443,73,166846,SATURDAY,1,0,23.3,76,5.4,1011.7,Cloudy
7/30/2022 8:00,10,18,17767,21596,28,39363,SATURDAY,1,0,25.6,79,0,1011.4,Cloudy
7/30/2022 9:00,7,28,17373,23653,35,41026,SATURDAY,1,0,24.4,52,11.2,1012,Cloudy
7/30/2022 10:00,29,72,64867,68191,101,133058,SATURDAY,1,0,24.4,48,13,1012.7,Cloudy
7/30/2022 11:00,50,145,386331,135239,195,521570,SATURDAY,1,0,25,43,16.6,1013.1,Cloudy
7/30/2022 12:00,114,266,240807,203716,380,444523,SATURDAY,1,0,25,43,16.6,1013.1,Cloudy
7/30/2022 13:00,217,384,448391,333333,601,781724,SATURDAY,1,0,27.8,37,24.1,1013.4,Cloudy
7/30/2022 14:00,324,517,768322,459863,841,1228185,SATURDAY,1,0,28.3,32,24.1,1013.4,Fair
7/30/2022 15:00,374,593,993673,511437,967,1505110,SATURDAY,1,0,29.4,30,22.3,1013.6,Fair
7/30/2022 16:00,507,526,1605911,699678,1033,2305589,SATURDAY,1,0,30.6,31,27.7,1013.8,Rain
7/30/2022 17:00,439,557,1074920,499155,996,1574075,SATURDAY,1,0,30.6,31,27.7,1013.8,Fair
7/30/2022 18:00,494,566,1283768,503234,1060,1787002,SATURDAY,1,0,30.6,31,22.3,1014.2,Fair
7/30/2022 19:00,499,585,1869067,553032,1084,2422099,SATURDAY,1,0,29.4,32,24.1,1014.5,Fair
7/30/2022 20:00,486,586,1560442,565113,1072,2125555,SATURDAY,1,0,30.6,30,18.4,1015,Fair
7/30/2022 21:00,486,610,1679936,533432,1096,2213368,SATURDAY,1,0,29.4,32,20.5,1015.2,Rain
7/30/2022 22:00,417,637,765393,571870,1054,1337263,SATURDAY,1,0,29.4,32,20.5,1015.2,Fair
7/30/2022 23:00,447,562,860005,547393,1009,1407398,SATURDAY,1,0,27.2,39,16.6,1016.7,Fair
7/31/2022 0:00,363,514,778541,436547,877,1215088,SUNDAY,1,0,26.7,41,16.6,1017.9,Fair
7/31/2022 1:00,293,319,1149166,282908,612,1432074,SUNDAY,1,0,25.6,45,11.2,1018.8,Fair
7/31/2022 2:00,235,247,431726,217930,482,649656,SUNDAY,1,0,25,47,11.2,1019.4,Fair
7/31/2022 3:00,209,206,501659,164760,415,666419,SUNDAY,1,0,25,47,11.2,1019.4,Fair
7/31/2022 4:00,141,162,392825,130562,303,523387,SUNDAY,1,0,23.3,56,9.4,1020.1,Fair
7/31/2022 5:00,213,119,382166,132297,332,514463,SUNDAY,1,0,22.8,57,9.4,1020.2,Fair
7/31/2022 6:00,117,82,235471,85055,199,320526,SUNDAY,1,0,22.2,59,13,1020.3,Clear
7/31/2022 7:00,20,35,43120,32111,55,75231,SUNDAY,1,0,22.2,57,13,1020.5,Clear
7/31/2022 8:00,12,18,45991,14177,30,60168,SUNDAY,1,0,22.2,57,13,1020.5,Clear
7/31/2022 9:00,14,27,44128,24389,41,68517,SUNDAY,1,0,21.1,61,13,1021.1,Clear
7/31/2022 10:00,28,69,86492,70862,97,157354,SUNDAY,1,0,21.7,61,13,1021.3,Rain
7/31/2022 11:00,52,100,100663,89841,152,190504,SUNDAY,1,0,23.9,54,14.8,1021.5,Fair
7/31/2022 12:00,109,230,226554,218030,339,444584,SUNDAY,1,0,23.9,54,14.8,1021.5,Fair
7/31/2022 13:00,165,402,329221,340260,567,669481,SUNDAY,1,0,27.2,41,11.2,1021.2,Fair
7/31/2022 14:00,287,469,811330,412695,756,1224025,SUNDAY,1,0,27.8,40,11.2,1020.8,Fair
7/31/2022 15:00,370,494,883715,449418,864,1333133,SUNDAY,1,0,26.7,44,5.4,1020.4,Fair
7/31/2022 16:00,466,575,1533063,901522,1041,2434585,SUNDAY,1,0,28.3,38,13,1019.8,Fair
7/31/2022 17:00,461,528,1077825,506404,989,1584229,SUNDAY,1,0,28.3,38,13,1019.8,Fair
7/31/2022 18:00,468,521,1039812,496067,989,1535879,SUNDAY,1,0,26.1,45,20.5,1018.7,Fair
7/31/2022 19:00,450,533,1670260,502446,983,2172706,SUNDAY,1,0,26.1,45,29.5,1018.3,Cloudy
7/31/2022 20:00,570,593,1291716,537460,1163,1829176,SUNDAY,1,0,26.1,52,11.2,1018,Cloudy
7/31/2022 21:00,432,642,1014878,570211,1074,1585089,SUNDAY,1,0,26.1,52,11.2,1018,Rain
7/31/2022 22:00,472,634,914720,581232,1106,1495952,SUNDAY,1,0,28.9,43,0,1017.5,Cloudy
7/31/2022 23:00,355,575,1793413,511688,930,2305101,SUNDAY,1,0,27.8,52,16.6,1017.8,Cloudy
8/1/2022 0:00,286,426,2414468,363983,712,2778451,MONDAY,0,0,27.2,41,13,1018.1,Cloudy
8/1/2022 1:00,161,269,339352,247058,430,586410,MONDAY,0,0,24.4,54,14.8,1018.1,Cloudy
8/1/2022 2:00,101,200,421132,199731,301,620863,MONDAY,0,0,23.9,64,13,1017.9,Cloudy
8/1/2022 3:00,88,133,187971,113105,221,301076,MONDAY,0,0,23.9,64,13,1017.9,Cloudy
8/1/2022 4:00,16,53,26732,50722,69,77454,MONDAY,0,0,24.4,60,16.6,1017.3,Cloudy
8/1/2022 5:00,30,21,42054,16187,51,58241,MONDAY,0,0,24.4,60,9.4,1016.7,Cloudy
8/1/2022 6:00,12,13,2431637,15037,25,2446674,MONDAY,0,0,22.8,69,9.4,1016.9,Cloudy
8/1/2022 7:00,14,12,22741,12560,26,35301,MONDAY,0,0,22.8,69,9.4,1016.9,Cloudy
8/1/2022 8:00,14,15,18266,13794,29,32060,MONDAY,0,0,23.9,60,14.8,1016.7,Cloudy
8/1/2022 9:00,11,49,7747,32559,60,40306,MONDAY,0,0,21.7,81,20.5,1017.1,Cloudy
8/1/2022 10:00,39,192,35276,144799,231,180075,MONDAY,0,0,22.2,79,16.6,1016.5,Cloudy
8/1/2022 11:00,87,578,94896,429919,665,524815,MONDAY,0,0,23.3,79,14.8,1016.5,Cloudy
8/1/2022 12:00,144,955,189241,1089530,1099,1278771,MONDAY,0,0,23.3,79,14.8,1016.5,Cloudy
8/1/2022 13:00,140,606,516680,428437,746,945117,MONDAY,0,0,24.4,64,13,1015.5,Cloudy
8/1/2022 14:00,135,363,425912,286627,498,712539,MONDAY,0,0,24.4,64,16.6,1014.9,Cloudy
8/1/2022 15:00,172,335,385083,284621,507,669704,MONDAY,0,0,28.3,48,16.6,1014.2,Cloudy
8/1/2022 16:00,211,437,414822,313017,648,727839,MONDAY,0,0,28.3,46,16.6,1013.5,Fair
8/1/2022 17:00,249,421,805989,295468,670,1101457,MONDAY,0,0,28.3,46,16.6,1013.5,Cloudy
8/1/2022 18:00,259,410,2153300,324365,669,2477665,MONDAY,0,0,26.1,56,14.8,1012.4,Cloudy
8/1/2022 19:00,270,527,1970152,408806,797,2378958,MONDAY,0,0,26.7,58,14.8,1011.8,Cloudy
8/1/2022 20:00,259,775,1431773,649396,1034,2081169,MONDAY,0,0,25,66,25.9,1011.7,Cloudy
8/1/2022 21:00,389,1191,2675465,1005772,1580,3681237,MONDAY,0,0,25,66,25.9,1011.7,Cloudy
8/1/2022 22:00,385,1100,719424,1494039,1485,2213463,MONDAY,0,0,23.3,74,16.6,1010.8,Cloudy
8/1/2022 23:00,342,793,564485,755438,1135,1319923,MONDAY,0,0,23.3,74,16.6,1010.8,Cloudy
8/2/2022 0:00,273,582,3798540,484640,855,4283180,TUESDAY,0,0,22.2,82,13,1010.7,Cloudy
8/2/2022 1:00,193,346,306104,284296,539,590400,TUESDAY,0,0,21.7,84,13,1010.7,Cloudy
8/2/2022 2:00,108,218,265223,173426,326,438649,TUESDAY,0,0,21.7,84,13,1010.7,Fair
8/2/2022 3:00,40,112,117870,102609,152,220479,TUESDAY,0,0,20.6,90,9.4,1010,Fair
8/2/2022 4:00,26,57,25762,82792,83,108554,TUESDAY,0,0,20.6,90,9.4,1010,Fair
8/2/2022 5:00,18,19,136120,13605,37,149725,TUESDAY,0,0,21.1,87,14.8,1009.5,Fair
8/2/2022 6:00,8,14,22948,10808,22,33756,TUESDAY,0,0,20.6,90,18.4,1009.5,Fair
8/2/2022 7:00,4,12,6041,14197,16,20238,TUESDAY,0,0,20.6,93,18.4,1009.4,Fair
8/2/2022 8:00,9,14,91219,10428,23,101647,TUESDAY,0,0,21.1,87,14.8,1009,Fair
8/2/2022 9:00,20,93,22930,67774,113,90704,TUESDAY,0,0,20.6,90,16.6,1009.2,Fair
8/2/2022 10:00,55,304,75915,229805,359,305720,TUESDAY,0,0,21.7,84,18.4,1009.2,Fair
8/2/2022 11:00,110,710,106127,566287,820,672414,TUESDAY,0,0,22.2,82,16.6,1009.4,Fair
8/2/2022 12:00,160,1164,225973,892182,1324,1118155,TUESDAY,0,0,22.2,82,16.6,1009.4,Fair
8/2/2022 13:00,141,680,283056,566602,821,849658,TUESDAY,0,0,26.1,65,14.8,1009,Fair
8/2/2022 14:00,132,377,269194,297130,509,566324,TUESDAY,0,0,28.3,59,11.2,1008.6,Fair
8/2/2022 15:00,152,357,2648476,261336,509,2909812,TUESDAY,0,0,29.4,51,11.2,1007.8,Rain
8/2/2022 16:00,150,408,308268,758025,558,1066293,TUESDAY,0,0,32.2,44,20.5,1007.6,Fair
8/2/2022 17:00,156,367,271154,534522,523,805676,TUESDAY,0,0,32.2,44,20.5,1007.6,Fair
8/2/2022 18:00,147,400,300608,406259,547,706867,TUESDAY,0,0,32.2,44,18.4,1006.9,Fair
8/2/2022 19:00,166,503,313245,417533,669,730778,TUESDAY,0,0,33.3,40,18.4,1006.5,Fair
8/2/2022 20:00,267,837,608199,695524,1104,1303723,TUESDAY,0,0,33.3,40,16.6,1006.3,Fair
8/2/2022 21:00,389,1327,586276,1145552,1716,1731828,TUESDAY,0,0,33.3,40,16.6,1006.3,Cloudy
8/2/2022 22:00,365,1160,880928,1034792,1525,1915720,TUESDAY,0,0,28.3,65,22.3,1007.5,Cloudy
8/2/2022 23:00,310,838,575319,708711,1148,1284030,TUESDAY,0,0,28.9,63,18.4,1008,Cloudy
8/3/2022 0:00,198,594,382462,574174,792,956636,WEDNESDAY,0,0,28.3,65,14.8,1008.8,Cloudy
8/3/2022 1:00,140,377,179739,325221,517,504960,WEDNESDAY,0,0,28.3,63,16.6,1009.4,Fair
8/3/2022 2:00,135,267,695371,216812,402,912183,WEDNESDAY,0,0,28.3,63,16.6,1009.4,Fair
8/3/2022 3:00,62,137,289971,114264,199,404235,WEDNESDAY,0,0,27.8,56,14.8,1010.3,Fair
8/3/2022 4:00,36,68,132897,62825,104,195722,WEDNESDAY,0,0,27.8,56,14.8,1010.3,Fair
8/3/2022 5:00,27,25,39708,19806,52,59514,WEDNESDAY,0,0,25.6,56,14.8,1011.1,Fair
8/3/2022 6:00,13,14,25045,10158,27,35203,WEDNESDAY,0,0,24.4,62,18.4,1011.7,Fair
8/3/2022 7:00,3,8,2728,4820,11,7548,WEDNESDAY,0,0,24.4,62,18.4,1011.7,Fair
8/3/2022 8:00,7,17,14939,12716,24,27655,WEDNESDAY,0,0,23.3,67,14.8,1013.2,Fair
8/3/2022 9:00,17,94,30891,78093,111,108984,WEDNESDAY,0,0,22.8,66,14.8,1014.2,Fair
8/3/2022 10:00,54,284,70282,225370,338,295652,WEDNESDAY,0,0,22.8,64,11.2,1014.6,Rain
8/3/2022 11:00,120,677,1075400,545456,797,1620856,WEDNESDAY,0,0,22.8,64,11.2,1014.6,Fair
8/3/2022 12:00,156,1173,147612,883314,1329,1030926,WEDNESDAY,0,0,26.1,54,16.6,1014.9,Fair
8/3/2022 13:00,127,673,671239,467611,800,1138850,WEDNESDAY,0,0,25.6,56,16.6,1015.3,Fair
8/3/2022 14:00,103,386,159335,274690,489,434025,WEDNESDAY,0,0,25.6,56,16.6,1015.3,Fair
8/3/2022 15:00,120,400,653410,317847,520,971257,WEDNESDAY,0,0,26.1,56,16.6,1016.2,Fair
8/3/2022 16:00,198,438,431830,311833,636,743663,WEDNESDAY,0,0,25.6,56,20.5,1016,Fair
8/3/2022 17:00,164,398,325438,2694865,562,3020303,WEDNESDAY,0,0,25.6,56,20.5,1016,Fair
8/3/2022 18:00,194,404,474695,325316,598,800011,WEDNESDAY,0,0,25.6,58,24.1,1015,Fair
8/3/2022 19:00,221,479,395753,364855,700,760608,WEDNESDAY,0,0,25.6,60,22.3,1014.5,Fair
8/3/2022 20:00,264,894,2263970,742858,1158,3006828,WEDNESDAY,0,0,23.9,74,24.1,1014.6,Fair
8/3/2022 21:00,404,1372,2785263,1165707,1776,3950970,WEDNESDAY,0,0,23.9,74,24.1,1014.6,Rain
8/3/2022 22:00,427,1180,3062029,984625,1607,4046654,WEDNESDAY,0,0,22.2,82,27.7,1014.6,Fair
8/3/2022 23:00,370,882,4035166,768350,1252,4803516,WEDNESDAY,0,0,20.6,90,14.8,1015.1,Fair
8/4/2022 0:00,248,600,503404,573696,848,1077100,THURSDAY,0,0,20.6,90,11.2,1015,Fair
8/4/2022 1:00,153,444,353503,352691,597,706194,THURSDAY,0,0,23.9,71,11.2,1015.7,Fair
8/4/2022 2:00,154,289,313901,247967,443,561868,THURSDAY,0,0,23.9,71,20.5,1015.7,Fair
8/4/2022 3:00,102,168,145531,126674,270,272205,THURSDAY,0,0,23.9,76,13,1016.9,Fair
8/4/2022 4:00,55,66,164264,49148,121,213412,THURSDAY,0,0,23.3,79,7.6,1016.8,Fair
8/4/2022 5:00,31,33,62249,55684,64,117933,THURSDAY,0,0,21.7,84,7.6,1016.5,Fair
8/4/2022 6:00,20,20,45640,13053,40,58693,THURSDAY,0,0,22.2,82,11.2,1016.6,Clear
8/4/2022 7:00,3,7,1640,6512,10,8152,THURSDAY,0,0,22.2,82,11.2,1016.6,Clear
8/4/2022 8:00,3,18,1852969,20906,21,1873875,THURSDAY,0,0,21.7,79,5.4,1016.5,Fair
8/4/2022 9:00,21,84,253275,51710,105,304985,THURSDAY,0,0,21.1,84,11.2,1016.8,Fair
8/4/2022 10:00,48,249,71485,197439,297,268924,THURSDAY,0,0,22.8,79,13,1017.4,Fair
8/4/2022 11:00,106,636,112742,462194,742,574936,THURSDAY,0,0,22.8,79,13,1017.4,Fair
8/4/2022 12:00,145,1072,190619,759879,1217,950498,THURSDAY,0,0,28.3,55,16.6,1017.3,Fair
8/4/2022 13:00,104,645,2036435,447502,749,2483937,THURSDAY,0,0,28.3,55,16.6,1017.3,Fair
8/4/2022 14:00,142,386,234397,274619,528,509016,THURSDAY,0,0,32.8,42,25.9,1016.7,Fair
8/4/2022 15:00,106,335,226769,2083427,441,2310196,THURSDAY,0,0,33.9,39,18.4,1016.1,Fair
8/4/2022 16:00,130,376,279321,399765,506,679086,THURSDAY,0,0,33.9,39,18.4,1016.1,Fair
8/4/2022 17:00,139,311,355997,1383401,450,1739398,THURSDAY,0,0,35.6,31,18.4,1015.5,Fair
8/4/2022 18:00,145,312,426386,225823,457,652209,THURSDAY,0,0,36.1,32,22.3,1015.2,Fair
8/4/2022 19:00,186,414,370830,312656,600,683486,THURSDAY,0,0,36.1,32,18.4,1014.8,Fair
8/4/2022 20:00,232,654,1629887,511728,886,2141615,THURSDAY,0,0,33.3,46,24.1,1014.6,Fair
8/4/2022 21:00,347,1097,1623599,878581,1444,2502180,THURSDAY,0,0,33.3,46,24.1,1014.6,Fair
8/4/2022 22:00,280,939,486460,820649,1219,1307109,THURSDAY,0,0,31.1,52,24.1,1015.2,Fair
8/4/2022 23:00,264,768,1966329,667507,1032,2633836,THURSDAY,0,0,28.9,59,24.1,1015.7,Fair
8/5/2022 0:00,197,581,373237,2281392,778,2654629,FRIDAY,0,0,27.8,65,22.3,1016.6,Fair
8/5/2022 1:00,195,394,334790,345756,589,680546,FRIDAY,0,0,27.8,65,22.3,1016.6,Fair
8/5/2022 2:00,142,283,409185,255078,425,664263,FRIDAY,0,0,27.2,69,18.4,1017.1,Fair
8/5/2022 3:00,78,195,196805,162967,273,359772,FRIDAY,0,0,25.6,76,11.2,1017.3,Fair
8/5/2022 4:00,59,91,1122544,71472,150,1194016,FRIDAY,0,0,25.6,74,11.2,1017.4,Fair
8/5/2022 5:00,47,56,112219,47364,103,159583,FRIDAY,0,0,23.9,84,7.6,1016.8,Fair
8/5/2022 6:00,27,19,42517,16958,46,59475,FRIDAY,0,0,23.9,84,7.6,1016.8,Fair
8/5/2022 7:00,14,5,17509,4758,19,22267,FRIDAY,0,0,25,79,11.2,1016.8,Fair
8/5/2022 8:00,5,26,4146,20685,31,24831,FRIDAY,0,0,24.4,82,14.8,1017.2,Fair
8/5/2022 9:00,19,84,559198,62135,103,621333,FRIDAY,0,0,24.4,82,14.8,1017.2,Fair
8/5/2022 10:00,33,241,39813,185005,274,224818,FRIDAY,0,0,25.6,76,11.2,1017.9,Fair
8/5/2022 11:00,97,478,214717,362673,575,577390,FRIDAY,0,0,25.6,76,11.2,1017.9,Cloudy
8/5/2022 12:00,139,817,220732,601681,956,822413,FRIDAY,0,0,28.3,63,11.2,1018.7,Cloudy
8/5/2022 13:00,124,580,177652,427815,704,605467,FRIDAY,0,0,31.1,54,7.6,1018.5,Cloudy
8/5/2022 14:00,148,401,263438,301739,549,565177,FRIDAY,0,0,31.7,48,9.4,1018.9,Cloudy
8/5/2022 15:00,174,394,337017,308426,568,645443,FRIDAY,0,0,32.2,45,0,1018.9,Cloudy
8/5/2022 16:00,167,512,661322,356159,679,1017481,FRIDAY,0,0,32.2,45,0,1018.9,Cloudy
8/5/2022 17:00,206,443,2272346,317468,649,2589814,FRIDAY,0,0,32.8,47,11.2,1018.6,Cloudy
8/5/2022 18:00,223,451,361216,1403572,674,1764788,FRIDAY,0,0,32.2,47,14.8,1018.1,Cloudy
8/5/2022 19:00,216,572,680602,421405,788,1102007,FRIDAY,0,0,32.2,47,14.8,1018.1,Cloudy
8/5/2022 20:00,106,385,268523,364630,491,633153,FRIDAY,0,0,31.1,52,29.5,1018.2,Cloudy
8/5/2022 21:00,132,485,742644,389669,617,1132313,FRIDAY,0,0,22.8,90,14.8,1020.1,Cloudy
8/5/2022 22:00,226,628,1748590,519011,854,2267601,FRIDAY,0,0,22.8,90,14.8,1020.1,Cloudy
8/5/2022 23:00,261,658,754712,580534,919,1335246,FRIDAY,0,0,25,85,7.6,1019.8,Cloudy
8/6/2022 0:00,229,548,599705,449893,777,1049598,SATURDAY,1,0,26.7,71,11.2,1020.4,Cloudy
8/6/2022 1:00,220,332,440808,2131177,552,2571985,SATURDAY,1,0,26.7,71,11.2,1020.4,Cloudy
8/6/2022 2:00,214,299,565754,250247,513,816001,SATURDAY,1,0,25.6,76,11.2,1020.9,Cloudy
8/6/2022 3:00,200,201,1396294,180823,401,1577117,SATURDAY,1,0,23.3,88,5.4,1021.1,Cloudy
8/6/2022 4:00,168,177,302084,169342,345,471426,SATURDAY,1,0,23.9,84,5.4,1021.1,Fair
8/6/2022 5:00,179,134,3641362,161958,313,3803320,SATURDAY,1,0,23.9,88,7.6,1021.1,Fair
8/6/2022 6:00,102,78,2099743,68100,180,2167843,SATURDAY,1,0,23.9,88,7.6,1021.1,Fair
8/6/2022 7:00,40,27,106597,21294,67,127891,SATURDAY,1,0,24.4,85,11.2,1021.7,Fair
8/6/2022 8:00,14,14,24348,13599,28,37947,SATURDAY,1,0,24.4,85,11.2,1021.8,Fair
8/6/2022 9:00,21,26,78217,21884,47,100101,SATURDAY,1,0,23.3,91,7.6,1022.2,Fair
8/6/2022 10:00,25,88,75394,67960,113,143354,SATURDAY,1,0,25,82,5.4,1022.6,Fair
8/6/2022 11:00,47,156,83474,140184,203,223658,SATURDAY,1,0,25,82,5.4,1022.6,Fair
8/6/2022 12:00,127,292,296575,247489,419,544064,SATURDAY,1,0,28.3,72,7.6,1022.7,Fair
8/6/2022 13:00,195,424,2142135,381954,619,2524089,SATURDAY,1,0,28.9,67,13,1022.4,Fair
8/6/2022 14:00,287,471,588724,603986,758,1192710,SATURDAY,1,0,30.6,63,13,1022.2,Fair
8/6/2022 15:00,352,552,806943,544374,904,1351317,SATURDAY,1,0,31.7,56,11.2,1021.6,Fair
8/6/2022 16:00,385,554,1339919,433557,939,1773476,SATURDAY,1,0,32.8,50,13,1021.2,Cloudy
8/6/2022 17:00,383,502,1415184,459916,885,1875100,SATURDAY,1,0,32.8,50,13,1021.2,Cloudy
8/6/2022 18:00,387,525,1112776,433516,912,1546292,SATURDAY,1,0,33.9,44,18.4,1020.2,Cloudy
8/6/2022 19:00,390,549,765797,533956,939,1299753,SATURDAY,1,0,32.8,49,20.5,1019.6,Cloudy
8/6/2022 20:00,378,552,3965514,470478,930,4435992,SATURDAY,1,0,32.8,49,20.5,1019.6,Cloudy
8/6/2022 21:00,354,511,1796058,425932,865,2221990,SATURDAY,1,0,33.9,44,27.7,1019,Cloudy
8/6/2022 22:00,243,519,2809535,438401,762,3247936,SATURDAY,1,0,31.1,52,25.9,1019.3,Fair
8/6/2022 23:00,319,539,1003741,490245,858,1493986,SATURDAY,1,0,28.9,57,25.9,1019.9,Fair
8/7/2022 0:00,289,455,3024308,406553,744,3430861,SUNDAY,1,0,27.2,67,16.6,1020.3,Fair
8/7/2022 1:00,215,335,373157,290165,550,663322,SUNDAY,1,0,27.2,67,16.6,1020.3,Fair
8/7/2022 2:00,277,298,687377,318539,575,1005916,SUNDAY,1,0,27.2,72,22.3,1020.9,Fair
8/7/2022 3:00,257,226,1044311,226272,483,1270583,SUNDAY,1,0,26.7,71,24.1,1020.9,Fair
8/7/2022 4:00,188,157,1243979,145450,345,1389429,SUNDAY,1,0,26.1,77,24.1,1020.7,Fair
8/7/2022 5:00,227,114,1548121,110070,341,1658191,SUNDAY,1,0,26.1,79,22.3,1020.3,Fair
8/7/2022 6:00,98,76,235599,69088,174,304687,SUNDAY,1,0,26.1,79,22.3,1020.3,Fair
8/7/2022 7:00,22,24,29228,22049,46,51277,SUNDAY,1,0,25.6,82,18.4,1020,Fair
8/7/2022 8:00,9,11,22613,12670,20,35283,SUNDAY,1,0,25,85,20.5,1020,Fair
8/7/2022 9:00,14,32,86105,28150,46,114255,SUNDAY,1,0,25,85,20.5,1020.1,Fair
8/7/2022 10:00,20,60,51874,43633,80,95507,SUNDAY,1,0,25,85,20.5,1020.1,Fair
8/7/2022 11:00,64,131,156031,121461,195,277492,SUNDAY,1,0,27.2,74,24.1,1020.1,Fair
8/7/2022 12:00,113,213,234518,194851,326,429369,SUNDAY,1,0,28.9,70,24.1,1020.2,Cloudy
8/7/2022 13:00,181,352,2941959,289061,533,3231020,SUNDAY,1,0,31.1,59,18.4,1019.8,Cloudy
8/7/2022 14:00,240,385,454942,317255,625,772197,SUNDAY,1,0,32.8,52,24.1,1019.7,Fair
8/7/2022 15:00,292,416,1294372,345419,708,1639791,SUNDAY,1,0,32.8,52,24.1,1019.7,Fair
8/7/2022 16:00,300,455,1242243,385351,755,1627594,SUNDAY,1,0,34.4,45,31.7,1017.6,Fair
8/7/2022 17:00,365,450,2722438,503507,815,3225945,SUNDAY,1,0,35.6,42,31.7,1016.9,Fair
8/7/2022 18:00,320,413,551746,357833,733,909579,SUNDAY,1,0,35,40,25.9,1016.2,Fair
8/7/2022 19:00,330,485,1243821,433731,815,1677552,SUNDAY,1,0,36.7,36,24.1,1015.7,Fair
8/7/2022 20:00,303,501,2722282,450714,804,3172996,SUNDAY,1,0,36.7,36,24.1,1015.7,Cloudy
8/7/2022 21:00,264,525,1377553,474421,789,1851974,SUNDAY,1,0,33.9,44,25.9,1015.2,Cloudy
8/7/2022 22:00,292,574,2032299,476941,866,2509240,SUNDAY,1,0,33.9,44,33.5,1015.2,Cloudy
8/7/2022 23:00,166,377,837259,292888,543,1130147,SUNDAY,1,0,32.8,52,33.5,1015.1,Cloudy
8/8/2022 0:00,63,182,758429,152897,245,911326,MONDAY,0,0,26.1,85,18.4,1016.7,Cloudy
8/8/2022 1:00,97,228,137944,191271,325,329215,MONDAY,0,0,26.1,85,18.4,1016.7,Fair
8/8/2022 2:00,62,158,95589,139155,220,234744,MONDAY,0,0,26.7,82,18.4,1016.3,Fair
8/8/2022 3:00,60,104,136012,130765,164,266777,MONDAY,0,0,26.7,79,20.5,1016.4,Fair
8/8/2022 4:00,51,47,753436,35859,98,789295,MONDAY,0,0,26.1,79,22.3,1016.1,Fair
8/8/2022 5:00,27,20,48290,19338,47,67628,MONDAY,0,0,26.1,79,20.5,1015.7,Fair
8/8/2022 6:00,14,10,18481,8133,24,26614,MONDAY,0,0,26.1,79,20.5,1015.7,Fair
8/8/2022 7:00,5,2,120123,3879,7,124002,MONDAY,0,0,25.6,82,20.5,1015.2,Fair
8/8/2022 8:00,6,17,11167,11701,23,22868,MONDAY,0,0,26.1,79,16.6,1015.1,Fair
8/8/2022 9:00,15,78,19461,54191,93,73652,MONDAY,0,0,26.1,77,20.5,1015.4,Cloudy
8/8/2022 10:00,30,247,23155,182889,277,206044,MONDAY,0,0,26.1,77,20.5,1015.4,Fair
8/8/2022 11:00,84,570,212871,460723,654,673594,MONDAY,0,0,27.2,72,20.5,1015.7,Cloudy
8/8/2022 12:00,136,911,156249,660942,1047,817191,MONDAY,0,0,29.4,65,16.6,1015.3,Cloudy
8/8/2022 13:00,133,569,247454,422093,702,669547,MONDAY,0,0,31.1,59,13,1014.8,Cloudy
8/8/2022 14:00,116,327,364727,215124,443,579851,MONDAY,0,0,32.8,52,18.4,1014.3,Cloudy
8/8/2022 15:00,101,336,256169,254664,437,510833,MONDAY,0,0,32.8,52,18.4,1014.3,Cloudy
8/8/2022 16:00,148,384,360564,251230,532,611794,MONDAY,0,0,36.1,39,20.5,1013.1,Cloudy
8/8/2022 17:00,156,329,411154,1607851,485,2019005,MONDAY,0,0,35,40,25.9,1012.3,Cloudy
8/8/2022 18:00,158,331,330729,234546,489,565275,MONDAY,0,0,36.1,39,25.9,1011.6,Cloudy
8/8/2022 19:00,228,384,382740,289054,612,671794,MONDAY,0,0,35.6,42,24.1,1011.2,Cloudy
8/8/2022 20:00,232,666,1546527,500059,898,2046586,MONDAY,0,0,35.6,42,24.1,1011.2,Cloudy
8/8/2022 21:00,325,1096,785800,865374,1421,1651174,MONDAY,0,0,33.3,49,35.3,1010.5,Cloudy
8/8/2022 22:00,315,890,866437,691295,1205,1557732,MONDAY,0,0,31.7,54,29.5,1010.6,Cloudy
8/8/2022 23:00,331,710,893679,1769405,1041,2663084,MONDAY,0,0,30,61,29.5,1010.9,Cloudy
8/9/2022 0:00,227,535,523863,473585,762,997448,TUESDAY,0,0,30,61,31.7,1010.9,Cloudy
8/9/2022 1:00,187,350,1449616,303482,537,1753098,TUESDAY,0,0,28.3,68,24.1,1010.8,Cloudy
8/9/2022 2:00,121,207,214691,175669,328,390360,TUESDAY,0,0,27.2,74,22.3,1011,Cloudy
8/9/2022 3:00,83,126,149836,98264,209,248100,TUESDAY,0,0,27.2,74,27.7,1011.1,Cloudy
8/9/2022 4:00,22,45,2265977,31673,67,2297650,TUESDAY,0,0,26.1,85,22.3,1010.7,Cloudy
8/9/2022 5:00,15,26,175171,22347,41,197518,TUESDAY,0,0,26.1,85,22.3,1010.7,Cloudy
8/9/2022 6:00,11,20,35341,19528,31,54869,TUESDAY,0,0,26.7,79,18.4,1010,Cloudy
8/9/2022 7:00,10,14,33430,37314,24,70744,TUESDAY,0,0,26.7,79,18.4,1009.9,Cloudy
8/9/2022 8:00,5,23,4538,20403,28,24941,TUESDAY,0,0,27.2,74,16.6,1010.1,Cloudy
8/9/2022 9:00,16,100,14232,68637,116,82869,TUESDAY,0,0,27.2,74,20.5,1010.1,Cloudy
8/9/2022 10:00,47,295,3419977,200703,342,3620680,TUESDAY,0,0,27.2,74,20.5,1010.1,Cloudy
8/9/2022 11:00,97,678,105782,528725,775,634507,TUESDAY,0,0,28.9,67,24.1,1010.7,Cloudy
8/9/2022 12:00,126,1070,151599,791779,1196,943378,TUESDAY,0,0,29.4,65,20.5,1010.8,Cloudy
8/9/2022 13:00,136,602,832724,871566,738,1704290,TUESDAY,0,0,30.6,61,24.1,1011,Cloudy
8/9/2022 14:00,125,332,278408,239589,457,517997,TUESDAY,0,0,30.6,61,20.5,1010.7,Cloudy
8/9/2022 15:00,128,311,224794,228116,439,452910,TUESDAY,0,0,33.9,51,20.5,1010.7,Cloudy
8/9/2022 16:00,154,384,288994,277178,538,566172,TUESDAY,0,0,35,45,14.8,1010,Cloudy
8/9/2022 17:00,135,374,1105120,269656,509,1374776,TUESDAY,0,0,36.1,41,22.3,1009.6,Cloudy
8/9/2022 18:00,92,289,1568817,210938,381,1779755,TUESDAY,0,0,36.1,41,22.3,1009.6,Cloudy
8/9/2022 19:00,134,406,181579,323234,540,504813,TUESDAY,0,0,26,89,13,1010.4,Cloudy
8/9/2022 20:00,216,708,1536642,540936,924,2077578,TUESDAY,0,0,30.6,68,13,1010.4,Cloudy
8/9/2022 21:00,340,1203,454305,960709,1543,1415014,TUESDAY,0,0,31.7,54,16.6,1010.7,Cloudy
8/9/2022 22:00,271,1000,3037320,820921,1271,3858241,TUESDAY,0,0,32.2,47,16.6,1011,Rain
8/9/2022 23:00,235,764,444443,665713,999,1110156,TUESDAY,0,0,26.1,88,18.4,1011.8,Cloudy
8/10/2022 0:00,172,555,454450,457101,727,911551,WEDNESDAY,0,0,27.2,77,5.4,1012.5,Cloudy
8/10/2022 1:00,159,366,206054,316445,525,522499,WEDNESDAY,0,0,20.6,93,22.3,1015.4,Cloudy
8/10/2022 2:00,100,212,370857,160181,312,531038,WEDNESDAY,0,0,20.6,93,22.3,1015.4,Cloudy
8/10/2022 3:00,131,174,3387793,603750,305,3991543,WEDNESDAY,0,0,20,93,20.5,1015.7,Cloudy
8/10/2022 4:00,53,66,105810,51031,119,156841,WEDNESDAY,0,0,19.4,93,18.4,1016.2,Cloudy
8/10/2022 5:00,27,26,48808,20314,53,69122,WEDNESDAY,0,0,19.4,93,16.6,1016.4,Cloudy
8/10/2022 6:00,6,12,7452,7272,18,14724,WEDNESDAY,0,0,19.4,93,16.6,1016.4,Cloudy
8/10/2022 7:00,6,15,10260,14703,21,24963,WEDNESDAY,0,0,19.4,91,14.8,1016.9,Cloudy
8/10/2022 8:00,10,25,7020,37310,35,44330,WEDNESDAY,0,0,19.4,87,18.4,1017,Cloudy
8/10/2022 9:00,18,101,21856,76575,119,98431,WEDNESDAY,0,0,18.9,90,16.6,1017.1,Cloudy
8/10/2022 10:00,40,258,33223,179869,298,213092,WEDNESDAY,0,0,18.9,90,14.8,1018.3,Cloudy
8/10/2022 11:00,88,708,100011,549941,796,649952,WEDNESDAY,0,0,18.9,90,11.2,1018.5,Cloudy
8/10/2022 12:00,185,1185,211855,932734,1370,1144589,WEDNESDAY,0,0,20,84,13,1018.7,Cloudy
8/10/2022 13:00,146,700,225309,523647,846,748956,WEDNESDAY,0,0,20.6,81,11.2,1018.6,Cloudy
8/10/2022 14:00,125,410,198968,282815,535,481783,WEDNESDAY,0,0,20.6,81,11.2,1018.6,Cloudy
8/10/2022 15:00,185,409,350498,317802,594,668300,WEDNESDAY,0,0,20.6,78,14.8,1018.6,Cloudy
8/10/2022 16:00,191,491,435317,352874,682,788191,WEDNESDAY,0,0,21.1,76,16.6,1018.4,Cloudy
8/10/2022 17:00,210,429,375158,339333,639,714491,WEDNESDAY,0,0,21.1,76,16.6,1018.4,Cloudy
8/10/2022 18:00,227,479,418691,403725,706,822416,WEDNESDAY,0,0,21.7,73,20.5,1017.6,Cloudy
8/10/2022 19:00,266,553,851508,456879,819,1308387,WEDNESDAY,0,0,21.7,73,20.5,1017.6,Cloudy
8/10/2022 20:00,349,914,3349346,752659,1263,4102005,WEDNESDAY,0,0,21.1,78,18.4,1016.6,Cloudy
8/10/2022 21:00,504,1353,725639,1165599,1857,1891238,WEDNESDAY,0,0,20.6,81,18.4,1016.1,Rain
8/10/2022 22:00,494,1155,772695,969651,1649,1742346,WEDNESDAY,0,0,19.4,87,14.8,1016,Cloudy
8/10/2022 23:00,408,858,1304580,747551,1266,2052131,WEDNESDAY,0,0,18.9,90,13,1016.2,Cloudy
8/11/2022 0:00,235,649,436070,588835,884,1024905,THURSDAY,0,0,18.9,90,13,1016.2,Cloudy
8/11/2022 1:00,210,409,408493,347010,619,755503,THURSDAY,0,0,18.9,90,9.4,1016.6,Cloudy
8/11/2022 2:00,265,326,489191,284482,591,773673,THURSDAY,0,0,18.9,90,9.4,1016.2,Cloudy
8/11/2022 3:00,130,212,228785,182694,342,411479,THURSDAY,0,0,19.4,91,7.6,1016,Cloudy
8/11/2022 4:00,40,81,77072,100892,121,177964,THURSDAY,0,0,19.4,91,7.6,1016,Cloudy
8/11/2022 5:00,21,40,45216,31323,61,76539,THURSDAY,0,0,19.4,91,5.4,1015.2,Cloudy
8/11/2022 6:00,21,24,152733,26549,45,179282,THURSDAY,0,0,18.9,93,7.6,1015,Cloudy
8/11/2022 7:00,4,15,11144,13698,19,24842,THURSDAY,0,0,18.9,93,5.4,1014.2,Cloudy
8/11/2022 8:00,10,24,11722,14498,34,26220,THURSDAY,0,0,18.9,93,5.4,1013.7,Cloudy
8/11/2022 9:00,15,93,22279,59710,108,81989,THURSDAY,0,0,18.9,93,5.4,1013.7,Cloudy
8/11/2022 10:00,43,286,46508,196259,329,242767,THURSDAY,0,0,20,93,0,1013.5,Cloudy
8/11/2022 11:00,101,607,128619,509168,708,637787,THURSDAY,0,0,20.6,90,9.4,1013.3,Cloudy
8/11/2022 12:00,156,1065,181453,809884,1221,991337,THURSDAY,0,0,20.6,90,9.4,1013.3,Cloudy
8/11/2022 13:00,113,659,160823,482849,772,643672,THURSDAY,0,0,23.9,74,13,1013,Cloudy
8/11/2022 14:00,143,437,321620,297085,580,618705,THURSDAY,0,0,22.2,82,11.2,1012.9,Cloudy
8/11/2022 15:00,153,361,439609,260650,514,700259,THURSDAY,0,0,22.2,82,11.2,1012.9,Cloudy
8/11/2022 16:00,191,432,750962,333916,623,1084878,THURSDAY,0,0,20.6,90,16.6,1012.6,Cloudy
8/11/2022 17:00,170,417,300168,306109,587,606277,THURSDAY,0,0,24.4,74,16.6,1011.6,Cloudy
8/11/2022 18:00,238,446,519780,342987,684,862767,THURSDAY,0,0,24.4,77,16.6,1011.2,Cloudy
8/11/2022 19:00,257,577,439292,458399,834,897691,THURSDAY,0,0,24.4,77,16.6,1011.2,Cloudy
8/11/2022 20:00,341,805,2269986,779877,1146,3049863,THURSDAY,0,0,22.8,81,16.6,1010.7,Cloudy
8/11/2022 21:00,432,1276,2514002,1077970,1708,3591972,THURSDAY,0,0,22.8,81,16.6,1010.7,Cloudy
8/11/2022 22:00,440,1091,820190,945118,1531,1765308,THURSDAY,0,0,22.8,84,14.8,1010.7,Cloudy
8/11/2022 23:00,294,751,594285,958558,1045,1552843,THURSDAY,0,0,22.8,84,14.8,1010.7,Cloudy
8/12/2022 0:00,225,551,462781,475882,776,938663,FRIDAY,0,0,22.2,87,20.5,1011.7,Cloudy
8/12/2022 1:00,176,442,622679,837235,618,1459914,FRIDAY,0,0,22.2,87,20.5,1011.7,Cloudy
8/12/2022 2:00,227,324,306286,268544,551,574830,FRIDAY,0,0,22.2,87,14.8,1012,Cloudy
8/12/2022 3:00,96,200,140608,225253,296,365861,FRIDAY,0,0,21.7,90,11.2,1011.8,Cloudy
8/12/2022 4:00,70,104,96425,80381,174,176806,FRIDAY,0,0,22.2,87,14.8,1012,Cloudy
8/12/2022 5:00,45,55,246743,41529,100,288272,FRIDAY,0,0,22.8,71,14.8,1012,Cloudy
8/12/2022 6:00,51,34,114950,28592,85,143542,FRIDAY,0,0,22.2,66,18.4,1012.2,Cloudy
8/12/2022 7:00,18,13,56428,12349,31,68777,FRIDAY,0,0,21.7,66,20.5,1012.3,Cloudy
8/12/2022 8:00,16,24,19953,22490,40,42443,FRIDAY,0,0,20.6,73,14.8,1012.8,Cloudy
8/12/2022 9:00,9,86,4824,58238,95,63062,FRIDAY,0,0,20.6,73,14.8,1012.8,Cloudy
8/12/2022 10:00,47,197,61236,435130,244,496366,FRIDAY,0,0,20,73,22.3,1013.8,Rain
8/12/2022 11:00,74,460,112849,386651,534,499500,FRIDAY,0,0,21.1,66,20.5,1014.1,Cloudy
8/12/2022 12:00,134,834,157584,621143,968,778727,FRIDAY,0,0,22.2,55,20.5,1014.6,Cloudy
8/12/2022 13:00,134,605,281620,448682,739,730302,FRIDAY,0,0,23.9,50,16.6,1014.7,Cloudy
8/12/2022 14:00,170,363,512904,256973,533,769877,FRIDAY,0,0,23.9,50,16.6,1014.7,Cloudy
8/12/2022 15:00,212,369,1589423,282079,581,1871502,FRIDAY,0,0,26.1,41,9.4,1014.4,Cloudy
8/12/2022 16:00,282,478,665573,347342,760,1012915,FRIDAY,0,0,24.4,54,9.4,1014.4,Cloudy
8/12/2022 17:00,292,515,1628586,751224,807,2379810,FRIDAY,0,0,25,48,22.3,1014.6,Cloudy
8/12/2022 18:00,349,542,594198,444712,891,1038910,FRIDAY,0,0,24.4,47,20.5,1014.6,Cloudy
8/12/2022 19:00,352,591,3913789,1628755,943,5542544,FRIDAY,0,0,23.9,45,20.5,1014.3,Cloudy
8/12/2022 20:00,443,861,789714,727967,1304,1517681,FRIDAY,0,0,23.9,45,20.5,1014.3,Cloudy
8/12/2022 21:00,529,1055,931871,938119,1584,1869990,FRIDAY,0,0,21.7,61,13,1015.1,Rain
8/12/2022 22:00,538,908,4126613,827584,1446,4954197,FRIDAY,0,0,21.1,64,11.2,1016,Cloudy
8/12/2022 23:00,456,765,3240464,698774,1221,3939238,FRIDAY,0,0,21.1,64,11.2,1016,Cloudy
8/13/2022 0:00,310,532,2505758,501204,842,3006962,SATURDAY,1,0,20,73,7.6,1016.5,Cloudy
8/13/2022 1:00,268,333,1039140,326161,601,1365301,SATURDAY,1,0,21.1,57,7.6,1017.1,Cloudy
8/13/2022 2:00,269,293,925595,316932,562,1242527,SATURDAY,1,0,20.6,49,13,1017.4,Cloudy
8/13/2022 3:00,262,222,534349,309371,484,843720,SATURDAY,1,0,20,51,20.5,1017.6,Cloudy
8/13/2022 4:00,186,161,328230,141935,347,470165,SATURDAY,1,0,20,51,20.5,1017.6,Cloudy
8/13/2022 5:00,163,119,318464,496589,282,815053,SATURDAY,1,0,19.4,55,14.8,1017.8,Cloudy
8/13/2022 6:00,62,63,141197,62030,125,203227,SATURDAY,1,0,18.9,59,14.8,1017.2,Fair
8/13/2022 7:00,25,29,32707,513853,54,546560,SATURDAY,1,0,18.3,61,11.2,1017.8,Fair
8/13/2022 8:00,5,14,7571,16037,19,23608,SATURDAY,1,0,17.8,63,13,1017.9,Fair
8/13/2022 9:00,10,21,11960,20164,31,32124,SATURDAY,1,0,17.8,63,13,1017.9,Fair
8/13/2022 10:00,34,68,50654,53708,102,104362,SATURDAY,1,0,17.2,65,13,1018.3,Rain
8/13/2022 11:00,47,147,74479,120366,194,194845,SATURDAY,1,0,17.8,63,16.6,1018.6,Cloudy
8/13/2022 12:00,98,244,316404,238623,342,555027,SATURDAY,1,0,18.9,59,16.6,1018.6,Cloudy
8/13/2022 13:00,184,377,575338,309660,561,884998,SATURDAY,1,0,20.6,55,14.8,1018.9,Cloudy
8/13/2022 14:00,360,448,892709,394156,808,1286865,SATURDAY,1,0,20.6,55,14.8,1018.9,Cloudy
8/13/2022 15:00,467,544,1557424,533836,1011,2091260,SATURDAY,1,0,21.7,53,18.4,1018.5,Cloudy
8/13/2022 16:00,537,551,1783966,519344,1088,2303310,SATURDAY,1,0,22.8,53,20.5,1018.4,Cloudy
8/13/2022 17:00,629,575,1524895,549974,1204,2074869,SATURDAY,1,0,22.8,57,18.4,1018.2,Cloudy
8/13/2022 18:00,587,607,1746905,600364,1194,2347269,SATURDAY,1,0,22.8,59,16.6,1017.8,Cloudy
8/13/2022 19:00,651,620,1515476,629374,1271,2144850,SATURDAY,1,0,22.8,59,16.6,1017.8,Cloudy
8/13/2022 20:00,668,566,1401463,577138,1234,1978601,SATURDAY,1,0,21.1,66,14.8,1017.6,Cloudy
8/13/2022 21:00,611,678,4136505,657100,1289,4793605,SATURDAY,1,0,20.6,70,13,1017.3,Rain
8/13/2022 22:00,537,647,2053140,711514,1184,2764654,SATURDAY,1,0,19.4,73,9.4,1017.4,Fair
8/13/2022 23:00,494,546,1064225,540310,1040,1604535,SATURDAY,1,0,18.9,75,9.4,1017.7,Fair
8/14/2022 0:00,260,383,926119,369611,643,1295730,SUNDAY,1,0,18.3,73,5.4,1017.9,Fair
8/14/2022 1:00,241,268,396451,223946,509,620397,SUNDAY,1,0,18.3,73,5.4,1017.9,Fair
8/14/2022 2:00,312,247,1263691,221008,559,1484699,SUNDAY,1,0,19.4,63,0,1018.1,Fair
8/14/2022 3:00,242,202,817504,163655,444,981159,SUNDAY,1,0,19.4,61,0,1017.9,Fair
8/14/2022 4:00,194,124,1447252,98372,318,1545624,SUNDAY,1,0,20,61,7.6,1017.8,Fair
8/14/2022 5:00,232,100,1869929,104856,332,1974785,SUNDAY,1,0,18.9,68,11.2,1017.5,Fair
8/14/2022 6:00,146,60,380896,54401,206,435297,SUNDAY,1,0,18.9,68,7.6,1017.2,Fair
8/14/2022 7:00,25,26,31016,25125,51,56141,SUNDAY,1,0,18.3,68,11.2,1017.2,Fair
8/14/2022 8:00,5,10,5940,13450,15,19390,SUNDAY,1,0,17.8,70,13,1017.4,Fair
8/14/2022 9:00,15,18,13723,21144,33,34867,SUNDAY,1,0,17.8,70,13,1017.4,Fair
8/14/2022 10:00,19,69,41958,48086,88,90044,SUNDAY,1,0,18.3,68,13,1017.8,Fair
8/14/2022 11:00,42,124,79693,95166,166,174859,SUNDAY,1,0,20,61,16.6,1017.8,Fair
8/14/2022 12:00,120,193,293531,152216,313,445747,SUNDAY,1,0,22.2,53,11.2,1017.9,Fair
8/14/2022 13:00,189,337,342105,317036,526,659141,SUNDAY,1,0,23.9,46,11.2,1017.8,Fair
8/14/2022 14:00,337,440,686197,370973,777,1057170,SUNDAY,1,0,23.9,46,11.2,1017.8,Fair
8/14/2022 15:00,455,523,1069152,497706,978,1566858,SUNDAY,1,0,25,43,11.2,1017,Fair
8/14/2022 16:00,554,585,1737190,565084,1139,2302274,SUNDAY,1,0,25.6,42,18.4,1016.7,Fair
8/14/2022 17:00,589,567,1649943,535383,1156,2185326,SUNDAY,1,0,26.1,39,16.6,1016.5,Fair
8/14/2022 18:00,616,610,1372065,575589,1226,1947654,SUNDAY,1,0,26.1,39,16.6,1016.5,Fair
8/14/2022 19:00,581,581,2518608,585594,1162,3104202,SUNDAY,1,0,23.9,50,27.7,1016.1,Fair
8/14/2022 20:00,598,630,1641153,608266,1228,2249419,SUNDAY,1,0,23.9,45,25.9,1016.3,Fair
8/14/2022 21:00,519,642,1057190,618969,1161,1676159,SUNDAY,1,0,22.8,55,18.4,1016.5,Cloudy
8/14/2022 22:00,440,602,1174026,612002,1042,1786028,SUNDAY,1,0,22.8,55,18.4,1016.5,Cloudy
8/14/2022 23:00,335,485,744231,663262,820,1407493,SUNDAY,1,0,22.8,59,16.6,1016.3,Cloudy
8/15/2022 0:00,243,418,465197,370246,661,835443,MONDAY,0,0,22.2,59,9.4,1017.2,Cloudy
8/15/2022 1:00,249,259,465133,239042,508,704175,MONDAY,0,0,22.2,55,16.6,1017,Cloudy
8/15/2022 2:00,199,179,739728,154116,378,893844,MONDAY,0,0,22.2,55,16.6,1017,Cloudy
8/15/2022 3:00,79,122,138286,89369,201,227655,MONDAY,0,0,22.2,55,18.4,1016.9,Cloudy
8/15/2022 4:00,34,61,201156,47178,95,248334,MONDAY,0,0,21.1,64,13,1017,Cloudy
8/15/2022 5:00,23,16,35394,10798,39,46192,MONDAY,0,0,21.1,57,11.2,1016.4,Cloudy
8/15/2022 6:00,20,15,1027206,14961,35,1042167,MONDAY,0,0,18.3,76,7.6,1016.6,Fair
8/15/2022 7:00,5,10,5567,10699,15,16266,MONDAY,0,0,19.4,66,7.6,1016.4,Fair
8/15/2022 8:00,8,17,10339,15478,25,25817,MONDAY,0,0,19.4,66,7.6,1016.4,Fair
8/15/2022 9:00,16,81,14822,55588,97,70410,MONDAY,0,0,17.2,75,0,1016.3,Fair
8/15/2022 10:00,29,219,31442,162096,248,193538,MONDAY,0,0,20,63,9.4,1016.6,Fair
8/15/2022 11:00,86,517,137581,421914,603,559495,MONDAY,0,0,20,63,9.4,1016.6,Cloudy
8/15/2022 12:00,145,867,224300,659178,1012,883478,MONDAY,0,0,21.7,55,7.6,1016.7,Cloudy
8/15/2022 13:00,160,580,952972,433799,740,1386771,MONDAY,0,0,22.8,53,13,1016.6,Cloudy
8/15/2022 14:00,171,341,403011,275403,512,678414,MONDAY,0,0,22.2,57,11.2,1016.7,Cloudy
8/15/2022 15:00,199,324,493619,249145,523,742764,MONDAY,0,0,22.8,53,13,1017,Cloudy
8/15/2022 16:00,287,374,1426228,270407,661,1696635,MONDAY,0,0,23.3,64,16.6,1016.5,Cloudy
8/15/2022 17:00,275,414,1044079,426953,689,1471032,MONDAY,0,0,23.3,62,18.4,1016.5,Cloudy
8/15/2022 18:00,278,373,501691,313541,651,815232,MONDAY,0,0,23.3,62,18.4,1016.5,Cloudy
8/15/2022 19:00,305,472,545875,375310,777,921185,MONDAY,0,0,23.3,64,20.5,1016.3,Cloudy
8/15/2022 20:00,383,788,630661,622187,1171,1252848,MONDAY,0,0,22.2,71,20.5,1016.2,Cloudy
8/15/2022 21:00,492,1221,1370525,987998,1713,2358523,MONDAY,0,0,22.2,71,20.5,1016.2,Rain
8/15/2022 22:00,418,1140,1194154,933536,1558,2127690,MONDAY,0,0,20.6,73,16.6,1016.4,Cloudy
8/15/2022 23:00,433,794,839570,666894,1227,1506464,MONDAY,0,0,20.6,73,16.6,1016.4,Cloudy
8/16/2022 0:00,274,505,463429,414846,779,878275,TUESDAY,0,0,20.6,73,13,1016.5,Cloudy
8/16/2022 1:00,186,332,315278,263632,518,578910,TUESDAY,0,0,20,78,9.4,1016.9,Cloudy
8/16/2022 2:00,95,236,136121,177898,331,314019,TUESDAY,0,0,19.4,84,7.6,1017.4,Cloudy
8/16/2022 3:00,69,131,162536,103044,200,265580,TUESDAY,0,0,19.4,84,5.4,1017.5,Cloudy
8/16/2022 4:00,36,50,72520,33717,86,106237,TUESDAY,0,0,19.4,84,5.4,1017.5,Cloudy
8/16/2022 5:00,14,25,34365,20467,39,54832,TUESDAY,0,0,18.9,87,5.4,1017.2,Cloudy
8/16/2022 6:00,1,20,1112,21113,21,22225,TUESDAY,0,0,18.9,87,9.4,1017,Fair
8/16/2022 7:00,11,10,15268,8128,21,23396,TUESDAY,0,0,18.9,84,7.6,1017,Fair
8/16/2022 8:00,10,16,20518,11752,26,32270,TUESDAY,0,0,18.9,84,7.6,1017,Fair
8/16/2022 9:00,13,107,13462,75455,120,88917,TUESDAY,0,0,17.8,84,9.4,1017.5,Fair
8/16/2022 10:00,52,279,66221,210015,331,276236,TUESDAY,0,0,18.9,75,11.2,1017.4,Fair
8/16/2022 11:00,103,649,97231,500612,752,597843,TUESDAY,0,0,21.7,59,14.8,1017.7,Fair
8/16/2022 12:00,163,1111,235794,839759,1274,1075553,TUESDAY,0,0,23.3,60,16.6,1017.7,Cloudy
8/16/2022 13:00,119,594,1879181,466221,713,2345402,TUESDAY,0,0,23.3,60,16.6,1017.7,Cloudy
8/16/2022 14:00,164,420,356792,331420,584,688212,TUESDAY,0,0,23.9,66,20.5,1018,Cloudy
8/16/2022 15:00,163,360,344843,276830,523,621673,TUESDAY,0,0,24.4,54,24.1,1018,Cloudy
8/16/2022 16:00,178,421,914508,778712,599,1693220,TUESDAY,0,0,24.4,60,20.5,1017.9,Cloudy
8/16/2022 17:00,257,418,489796,303246,675,793042,TUESDAY,0,0,24.4,60,20.5,1017.9,Cloudy
8/16/2022 18:00,224,412,416221,354684,636,770905,TUESDAY,0,0,24.4,56,16.6,1017.4,Cloudy
8/16/2022 19:00,288,535,494655,430829,823,925484,TUESDAY,0,0,23.9,60,18.4,1017.2,Cloudy
8/16/2022 20:00,314,855,605309,720630,1169,1325939,TUESDAY,0,0,22.8,66,20.5,1017.2,Cloudy
8/16/2022 21:00,466,1279,1599794,1152798,1745,2752592,TUESDAY,0,0,22.8,66,20.5,1017.2,Cloudy
8/16/2022 22:00,403,1189,707318,2761860,1592,3469178,TUESDAY,0,0,21.1,78,18.4,1017.1,Cloudy
8/16/2022 23:00,300,823,505239,689723,1123,1194962,TUESDAY,0,0,21.1,78,18.4,1017.1,Cloudy
8/17/2022 0:00,216,472,292747,401054,688,693801,WEDNESDAY,0,0,21.1,76,16.6,1017,Cloudy
8/17/2022 1:00,128,325,147496,290156,453,437652,WEDNESDAY,0,0,21.1,76,16.6,1017,Cloudy
8/17/2022 2:00,162,255,1088583,180819,417,1269402,WEDNESDAY,0,0,20.6,81,16.6,1017.4,Cloudy
8/17/2022 3:00,95,149,109689,121830,244,231519,WEDNESDAY,0,0,20.6,78,14.8,1017.3,Cloudy
8/17/2022 4:00,40,57,204560,51538,97,256098,WEDNESDAY,0,0,20.6,70,11.2,1016.6,Cloudy
8/17/2022 5:00,18,29,34231,16613,47,50844,WEDNESDAY,0,0,20.6,70,11.2,1016.6,Cloudy
8/17/2022 6:00,10,10,87462,10233,20,97695,WEDNESDAY,0,0,20,78,11.2,1015.8,Rain
8/17/2022 7:00,0,9,0,6291,9,6291,WEDNESDAY,0,0,18.9,84,9.4,1015.5,Rain
8/17/2022 8:00,4,13,4473,11056,17,15529,WEDNESDAY,0,0,18.9,84,9.4,1015.5,Rain
8/17/2022 9:00,11,78,12363,58459,89,70822,WEDNESDAY,0,0,18.9,84,13,1015.1,Rain
8/17/2022 10:00,25,259,23985,174598,284,198583,WEDNESDAY,0,0,19.4,79,14.8,1015.3,Rain
8/17/2022 11:00,82,539,67326,393630,621,460956,WEDNESDAY,0,0,20,76,20.5,1015.2,Rain
8/17/2022 12:00,142,1001,149882,722467,1143,872349,WEDNESDAY,0,0,21.7,66,20.5,1014.8,Cloudy
8/17/2022 13:00,98,630,143615,468556,728,612171,WEDNESDAY,0,0,21.7,66,25.9,1014.8,Rain
8/17/2022 14:00,111,401,578564,307622,512,886186,WEDNESDAY,0,0,25.6,45,22.3,1014.4,Rain
8/17/2022 15:00,138,376,313413,291310,514,604723,WEDNESDAY,0,0,25.6,45,29.5,1014.4,Rain
8/17/2022 16:00,157,462,226378,364924,619,591302,WEDNESDAY,0,0,25,47,29.5,1014.9,Rain
8/17/2022 17:00,152,426,1030067,357392,578,1387459,WEDNESDAY,0,0,22.2,55,16.6,1014.7,Rain
8/17/2022 18:00,150,352,366224,288501,502,654725,WEDNESDAY,0,0,22.2,55,16.6,1014.7,Rain
8/17/2022 19:00,214,465,1423237,371098,679,1794335,WEDNESDAY,0,0,22.2,48,27.7,1013.5,Rain
8/17/2022 20:00,261,743,460936,599081,1004,1060017,WEDNESDAY,0,0,21.7,51,25.9,1013,Cloudy
8/17/2022 21:00,351,1223,2033284,1003750,1574,3037034,WEDNESDAY,0,0,21.7,49,25.9,1012.7,Cloudy
8/17/2022 22:00,320,1033,543113,852068,1353,1395181,WEDNESDAY,0,0,21.7,49,24.1,1012.7,Cloudy
8/17/2022 23:00,261,725,475245,575379,986,1050624,WEDNESDAY,0,0,21.1,57,22.3,1012.3,Cloudy
8/18/2022 0:00,153,439,745311,374375,592,1119686,THURSDAY,0,0,21.1,55,14.8,1011.9,Rain
8/18/2022 1:00,112,311,126544,572804,423,699348,THURSDAY,0,0,20,63,13,1011.3,Cloudy
8/18/2022 2:00,114,218,2239829,183754,332,2423583,THURSDAY,0,0,21.7,55,20.5,1010,Cloudy
8/18/2022 3:00,77,142,261987,120784,219,382771,THURSDAY,0,0,21.7,55,20.5,1010,Cloudy
8/18/2022 4:00,30,52,46837,42387,82,89224,THURSDAY,0,0,20.6,61,18.4,1008.6,Cloudy
8/18/2022 5:00,16,27,18871,21338,43,40209,THURSDAY,0,0,20,63,24.1,1008.5,Cloudy
8/18/2022 6:00,20,13,25887,11079,33,36966,THURSDAY,0,0,19.4,68,18.4,1008.3,Cloudy
8/18/2022 7:00,8,10,9341,10934,18,20275,THURSDAY,0,0,19.4,63,18.4,1008.1,Cloudy
8/18/2022 8:00,8,17,10418,12769,25,23187,THURSDAY,0,0,19.4,63,27.7,1008.1,Cloudy
8/18/2022 9:00,13,83,13880,63441,96,77321,THURSDAY,0,0,19.4,66,27.7,1008.2,Cloudy
8/18/2022 10:00,35,223,41649,172604,258,214253,THURSDAY,0,0,19.4,66,27.7,1008.7,Cloudy
8/18/2022 11:00,87,622,91645,627440,709,719085,THURSDAY,0,0,20,63,33.5,1008.8,Cloudy
8/18/2022 12:00,168,1051,203605,771050,1219,974655,THURSDAY,0,0,21.1,57,33.5,1009,Cloudy
8/18/2022 13:00,105,640,186692,442623,745,629315,THURSDAY,0,0,21.1,57,33.5,1009,Cloudy
8/18/2022 14:00,121,423,203320,324033,544,527353,THURSDAY,0,0,23.3,50,27.7,1009,Cloudy
8/18/2022 15:00,222,391,504753,281063,613,785816,THURSDAY,0,0,25.6,40,33.5,1008.8,Cloudy
8/18/2022 16:00,212,474,353803,362521,686,716324,THURSDAY,0,0,27.2,37,24.1,1008.5,Cloudy
8/18/2022 17:00,230,437,511081,311021,667,822102,THURSDAY,0,0,26.1,39,22.3,1008.7,Cloudy
8/18/2022 18:00,250,460,1638576,379050,710,2017626,THURSDAY,0,0,26.1,39,22.3,1008.7,Cloudy
8/18/2022 19:00,265,512,585374,435917,777,1021291,THURSDAY,0,0,28.3,31,27.7,1008.5,Cloudy
8/18/2022 20:00,336,781,1845199,675202,1117,2520401,THURSDAY,0,0,28.3,30,24.1,1008.8,Cloudy
8/18/2022 21:00,481,1204,770302,1101231,1685,1871533,THURSDAY,0,0,28.3,30,20.5,1009.4,Cloudy
8/18/2022 22:00,502,1121,1448946,994052,1623,2442998,THURSDAY,0,0,28.3,30,20.5,1009.4,Cloudy
8/18/2022 23:00,398,824,686757,726057,1222,1412814,THURSDAY,0,0,26.1,35,11.2,1010.4,Cloudy
8/19/2022 0:00,236,478,333785,407650,714,741435,FRIDAY,0,0,25.6,43,18.4,1011.1,Cloudy
8/19/2022 1:00,251,331,443761,296534,582,740295,FRIDAY,0,0,24.4,50,20.5,1011.4,Fair
8/19/2022 2:00,207,311,1628302,269296,518,1897598,FRIDAY,0,0,24.4,50,20.5,1011.4,Fair
8/19/2022 3:00,165,187,227058,161155,352,388213,FRIDAY,0,0,22.8,55,18.4,1012.1,Fair
8/19/2022 4:00,76,108,2675357,251649,184,2927006,FRIDAY,0,0,22.8,55,20.5,1012.4,Fair
8/19/2022 5:00,33,70,1030769,139294,103,1170063,FRIDAY,0,0,21.7,59,18.4,1012.7,Fair
8/19/2022 6:00,40,56,58925,60306,96,119231,FRIDAY,0,0,21.1,61,18.4,1013,Fair
8/19/2022 7:00,10,20,13823,23462,30,37285,FRIDAY,0,0,21.1,61,18.4,1013,Fair
8/19/2022 8:00,6,23,29971,20787,29,50758,FRIDAY,0,0,20.6,63,14.8,1013.9,Fair
8/19/2022 9:00,8,76,7012,92475,84,99487,FRIDAY,0,0,20.6,63,14.8,1014.4,Fair
8/19/2022 10:00,32,225,34252,166151,257,200403,FRIDAY,0,0,21.1,64,20.5,1015,Clear
8/19/2022 11:00,62,443,71829,341936,505,413765,FRIDAY,0,0,22.8,59,14.8,1015.5,Fair
8/19/2022 12:00,107,805,178057,623237,912,801294,FRIDAY,0,0,22.8,59,14.8,1015.5,Fair
8/19/2022 13:00,133,646,289590,492281,779,781871,FRIDAY,0,0,27.8,43,14.8,1016,Fair
8/19/2022 14:00,163,514,346667,477627,677,824294,FRIDAY,0,0,30,32,16.6,1016.3,Fair
8/19/2022 15:00,193,503,437771,464715,696,902486,FRIDAY,0,0,30,32,16.6,1016.3,Fair
8/19/2022 16:00,211,582,390064,501303,793,891367,FRIDAY,0,0,32.2,25,22.3,1015.8,Fair
8/19/2022 17:00,238,636,406915,597628,874,1004543,FRIDAY,0,0,32.2,25,22.3,1015.8,Fair
8/19/2022 18:00,242,582,467201,500214,824,967415,FRIDAY,0,0,32.8,21,18.4,1015.3,Fair
8/19/2022 19:00,164,374,750882,309427,538,1060309,FRIDAY,0,0,33.3,21,18.4,1015.4,Fair
8/19/2022 20:00,214,550,387007,504664,764,891671,FRIDAY,0,0,33.3,21,20.5,1015.6,Fair
8/19/2022 21:00,291,1183,846008,1126596,1474,1972604,FRIDAY,0,0,33.3,21,20.5,1015.6,Fair
8/19/2022 22:00,340,1190,1380686,1347170,1530,2727856,FRIDAY,0,0,31.7,23,13,1015.9,Fair
8/19/2022 23:00,272,1074,590032,1199637,1346,1789669,FRIDAY,0,0,31.7,25,18.4,1016.2,Fair
8/20/2022 0:00,229,739,2227561,1547584,968,3775145,SATURDAY,1,0,30.6,28,13,1016.8,Fair
8/20/2022 1:00,206,619,439288,680179,825,1119467,SATURDAY,1,0,27.2,41,11.2,1018.2,Fair
8/20/2022 2:00,214,553,481179,1820154,767,2301333,SATURDAY,1,0,26.7,47,16.6,1018.7,Fair
8/20/2022 3:00,210,427,540376,1242245,637,1782621,SATURDAY,1,0,26.7,47,16.6,1018.7,Fair
8/20/2022 4:00,182,284,394229,335941,466,730170,SATURDAY,1,0,25.6,52,14.8,1019.4,Fair
8/20/2022 5:00,154,242,1657896,383374,396,2041270,SATURDAY,1,0,25.6,50,11.2,1019.7,Fair
8/20/2022 6:00,50,117,48577,144163,167,192740,SATURDAY,1,0,22.2,66,5.4,1020,Fair
8/20/2022 7:00,20,42,71386,56642,62,128028,SATURDAY,1,0,22.2,66,5.4,1020,Fair
8/20/2022 8:00,11,28,276579,27525,39,304104,SATURDAY,1,0,21.1,73,5.4,1020.1,Fair
8/20/2022 9:00,12,37,27988,40758,49,68746,SATURDAY,1,0,21.1,73,5.4,1020.1,Fair
8/20/2022 10:00,16,93,24955,86129,109,111084,SATURDAY,1,0,21.7,68,7.6,1020.8,Fair
8/20/2022 11:00,40,194,70361,197051,234,267412,SATURDAY,1,0,23.9,58,0,1021,Cloudy
8/20/2022 12:00,70,358,587177,364659,428,951836,SATURDAY,1,0,23.9,58,0,1021,Cloudy
8/20/2022 13:00,135,562,306243,537448,697,843691,SATURDAY,1,0,27.2,47,0,1021.3,Cloudy
8/20/2022 14:00,213,719,538744,1937942,932,2476686,SATURDAY,1,0,25.6,56,9.4,1021.8,Cloudy
8/20/2022 15:00,302,804,1677808,822892,1106,2500700,SATURDAY,1,0,28.3,44,11.2,1021.4,Fair
8/20/2022 16:00,270,872,571786,1513644,1142,2085430,SATURDAY,1,0,28.3,49,11.2,1020.9,Fair
8/20/2022 17:00,325,925,692371,1753634,1250,2446005,SATURDAY,1,0,28.3,49,20.5,1020.9,Cloudy
8/20/2022 18:00,358,989,837157,2123049,1347,2960206,SATURDAY,1,0,27.8,60,22.3,1020,Cloudy
8/20/2022 19:00,362,950,1263663,1059392,1312,2323055,SATURDAY,1,0,30,51,18.4,1019.6,Cloudy
8/20/2022 20:00,388,1120,2950931,2763182,1508,5714113,SATURDAY,1,0,28.3,53,13,1019.3,Cloudy
8/20/2022 21:00,324,1091,969137,1321073,1415,2290210,SATURDAY,1,0,28.3,53,13,1019.3,Rain
8/20/2022 22:00,327,1060,974770,2807850,1387,3782620,SATURDAY,1,0,27.8,51,20.5,1019.9,Fair
8/20/2022 23:00,249,984,848335,1194834,1233,2043169,SATURDAY,1,0,27.8,51,20.5,1019.9,Fair
8/21/2022 0:00,181,739,873189,900205,920,1773394,SUNDAY,1,0,26.7,58,18.4,1020.8,Fair
8/21/2022 1:00,166,541,643773,646177,707,1289950,SUNDAY,1,0,25,66,16.6,1020.7,Fair
8/21/2022 2:00,191,562,421241,776667,753,1197908,SUNDAY,1,0,25,69,16.6,1020.9,Fair
8/21/2022 3:00,149,383,313730,404469,532,718199,SUNDAY,1,0,25,69,16.6,1020.9,Fair
8/21/2022 4:00,132,306,3785260,367186,438,4152446,SUNDAY,1,0,23.3,79,13,1020.8,Fair
8/21/2022 5:00,134,236,305118,269333,370,574451,SUNDAY,1,0,22.8,84,7.6,1020.6,Fair
8/21/2022 6:00,91,125,246180,171153,216,417333,SUNDAY,1,0,23.3,82,14.8,1020.6,Fair
8/21/2022 7:00,8,42,211707,51901,50,263608,SUNDAY,1,0,23.3,82,14.8,1020.6,Fair
8/21/2022 8:00,12,25,18052,17424,37,35476,SUNDAY,1,0,22.2,87,13,1021,Fair
8/21/2022 9:00,5,33,9041,53389,38,62430,SUNDAY,1,0,22.2,87,13,1021,Fair
8/21/2022 10:00,12,88,17112,70119,100,87231,SUNDAY,1,0,21.1,93,9.4,1021.5,Fair
8/21/2022 11:00,29,151,107055,148316,180,255371,SUNDAY,1,0,22.2,84,7.6,1021.6,Fair
8/21/2022 12:00,68,335,162082,1217113,403,1379195,SUNDAY,1,0,22.2,84,7.6,1021.6,Cloudy
8/21/2022 13:00,116,492,631849,596826,608,1228675,SUNDAY,1,0,25.6,67,14.8,1021.5,Fair
8/21/2022 14:00,198,704,389384,817148,902,1206532,SUNDAY,1,0,27.2,54,14.8,1021.3,Cloudy
8/21/2022 15:00,225,870,1062426,933885,1095,1996311,SUNDAY,1,0,27.2,54,14.8,1021.3,Cloudy
8/21/2022 16:00,304,1028,607188,2152661,1332,2759849,SUNDAY,1,0,28.3,49,14.8,1020.7,Cloudy
8/21/2022 17:00,317,1017,685841,1509761,1334,2195602,SUNDAY,1,0,31.1,36,20.5,1020.2,Cloudy
8/21/2022 18:00,325,988,642707,1185808,1313,1828515,SUNDAY,1,0,30.6,42,24.1,1019.8,Cloudy
8/21/2022 19:00,291,1070,1908142,1465371,1361,3373513,SUNDAY,1,0,30,40,22.3,1019.1,Cloudy
8/21/2022 20:00,349,1184,959414,1353244,1533,2312658,SUNDAY,1,0,28.3,41,20.5,1019.1,Cloudy
8/21/2022 21:00,287,1127,1505280,1300939,1414,2806219,SUNDAY,1,0,28.3,41,20.5,1019.1,Rain
8/21/2022 22:00,318,1161,1993066,2396441,1479,4389507,SUNDAY,1,0,27.8,41,18.4,1018.7,Cloudy
8/21/2022 23:00,256,1011,605350,2609504,1267,3214854,SUNDAY,1,0,26.1,45,18.4,1018.4,Cloudy
8/22/2022 0:00,190,687,3548501,715544,877,4264045,MONDAY,0,0,23.3,69,9.4,1018.5,Cloudy
8/22/2022 1:00,128,533,215926,553441,661,769367,MONDAY,0,0,23.3,69,9.4,1018.5,Cloudy
8/22/2022 2:00,230,485,1566953,590022,715,2156975,MONDAY,0,0,21.7,68,11.2,1018.8,Cloudy
8/22/2022 3:00,80,259,728845,407170,339,1136015,MONDAY,0,0,21.7,68,11.2,1018.8,Cloudy
8/22/2022 4:00,22,113,58697,209173,135,267870,MONDAY,0,0,20,84,9.4,1018.6,Cloudy
8/22/2022 5:00,17,54,1568076,90469,71,1658545,MONDAY,0,0,20,90,7.6,1018.2,Cloudy
8/22/2022 6:00,15,45,27919,51218,60,79137,MONDAY,0,0,20,90,7.6,1018.2,Cloudy
8/22/2022 7:00,5,15,7563,22896,20,30459,MONDAY,0,0,20,93,5.4,1017.5,Cloudy
8/22/2022 8:00,5,28,12988,131208,33,144196,MONDAY,0,0,20,93,5.4,1017.5,Cloudy
8/22/2022 9:00,5,109,5228,82366,114,87594,MONDAY,0,0,20,93,7.6,1017.1,Cloudy
8/22/2022 10:00,34,285,45201,1107910,319,1153111,MONDAY,0,0,20,93,7.6,1017.1,Cloudy
8/22/2022 11:00,47,737,57969,1081914,784,1139883,MONDAY,0,0,20,96,11.2,1016.9,Cloudy
8/22/2022 12:00,86,1061,106112,1055132,1147,1161244,MONDAY,0,0,20,96,11.2,1016.9,Cloudy
8/22/2022 13:00,69,729,497843,591010,798,1088853,MONDAY,0,0,22.2,84,14.8,1016.4,Cloudy
8/22/2022 14:00,88,493,205278,425626,581,630904,MONDAY,0,0,21.7,90,14.8,1015.8,Cloudy
8/22/2022 15:00,68,355,1583008,430953,423,2013961,MONDAY,0,0,21.7,90,14.8,1015.8,Cloudy
8/22/2022 16:00,16,136,41061,179608,152,220669,MONDAY,0,0,20.6,100,16.6,1015.6,Rain
8/22/2022 17:00,20,113,31607,95533,133,127140,MONDAY,0,0,21.1,97,14.8,1014.1,Rain
8/22/2022 18:00,22,161,24790,215838,183,240628,MONDAY,0,0,21.1,97,14.8,1013.2,Rain
8/22/2022 19:00,39,323,70572,284218,362,354790,MONDAY,0,0,21.1,97,14.8,1013.2,Rain
8/22/2022 20:00,77,731,87498,607227,808,694725,MONDAY,0,0,21.7,96,14.8,1012.6,Cloudy
8/22/2022 21:00,101,1173,144036,1099059,1274,1243095,MONDAY,0,0,21.1,100,13,1011.9,Cloudy
8/22/2022 22:00,108,973,427596,946047,1081,1373643,MONDAY,0,0,21.1,100,11.2,1011.3,Cloudy
8/22/2022 23:00,44,514,51433,947157,558,998590,MONDAY,0,0,21.1,100,11.2,1011.3,Rain
8/23/2022 0:00,41,361,48785,524475,402,573260,TUESDAY,0,0,21.1,100,9.4,1011.1,Rain
8/23/2022 1:00,47,398,65335,356562,445,421897,TUESDAY,0,0,21.1,97,7.6,1011.4,Rain
8/23/2022 2:00,40,248,91459,276820,288,368279,TUESDAY,0,0,21.1,97,7.6,1011.4,Cloudy
8/23/2022 3:00,37,140,50087,127919,177,178006,TUESDAY,0,0,21.1,93,7.6,1011.2,Cloudy
8/23/2022 4:00,13,88,61364,84462,101,145826,TUESDAY,0,0,21.1,93,7.6,1011.2,Cloudy
8/23/2022 5:00,9,50,9933,45514,59,55447,TUESDAY,0,0,20.6,96,9.4,1010.8,Cloudy
8/23/2022 6:00,2,26,4559,40721,28,45280,TUESDAY,0,0,20.6,96,9.4,1010.8,Cloudy
8/23/2022 7:00,1,14,2320,13148,15,15468,TUESDAY,0,0,20.6,93,7.6,1010.1,Cloudy
8/23/2022 8:00,3,23,2355,18791,26,21146,TUESDAY,0,0,20.6,93,7.6,1010.4,Cloudy
8/23/2022 9:00,11,129,11269,115261,140,126530,TUESDAY,0,0,21.1,87,7.6,1010.4,Cloudy
8/23/2022 10:00,45,330,267452,310782,375,578234,TUESDAY,0,0,20.6,93,7.6,1010.8,Cloudy
8/23/2022 11:00,55,862,58327,685338,917,743665,TUESDAY,0,0,20.6,93,7.6,1010.8,Cloudy
8/23/2022 12:00,96,1330,460211,1160390,1426,1620601,TUESDAY,0,0,20.6,93,11.2,1011.2,Cloudy
8/23/2022 13:00,68,775,110140,722726,843,832866,TUESDAY,0,0,21.1,90,11.2,1010.8,Cloudy
8/23/2022 14:00,67,600,147678,528760,667,676438,TUESDAY,0,0,21.7,87,11.2,1010.9,Cloudy
8/23/2022 15:00,124,567,359789,551696,691,911485,TUESDAY,0,0,21.7,84,11.2,1011.1,Cloudy
8/23/2022 16:00,125,655,236965,669995,780,906960,TUESDAY,0,0,21.7,84,11.2,1011.1,Cloudy
8/23/2022 17:00,111,732,384515,1699495,843,2084010,TUESDAY,0,0,22.2,84,14.8,1010.6,Cloudy
8/23/2022 18:00,125,635,2490753,2754378,760,5245131,TUESDAY,0,0,22.2,84,11.2,1010.5,Cloudy
8/23/2022 19:00,134,756,262568,2223979,890,2486547,TUESDAY,0,0,22.2,87,16.6,1009.9,Cloudy
8/23/2022 20:00,166,1158,224473,1000870,1324,1225343,TUESDAY,0,0,22.2,87,16.6,1009.9,Cloudy
8/23/2022 21:00,148,1312,234391,2522745,1460,2757136,TUESDAY,0,0,21.1,90,11.2,1010.3,Cloudy
8/23/2022 22:00,182,1391,275666,1452051,1573,1727717,TUESDAY,0,0,20.6,96,18.4,1010.3,Cloudy
8/23/2022 23:00,103,919,301723,941982,1022,1243705,TUESDAY,0,0,20.6,96,18.4,1010.3,Cloudy
8/24/2022 0:00,90,668,153898,672518,758,826416,WEDNESDAY,0,0,20.6,96,5.4,1010.3,Cloudy
8/24/2022 1:00,86,500,122850,548837,586,671687,WEDNESDAY,0,0,20.6,96,5.4,1010.3,Cloudy
8/24/2022 2:00,71,391,1369361,420817,462,1790178,WEDNESDAY,0,0,20,96,5.4,1010.5,Cloudy
8/24/2022 3:00,65,223,1261280,234685,288,1495965,WEDNESDAY,0,0,21.1,93,5.4,1010.5,Cloudy
8/24/2022 4:00,36,110,64246,108859,146,173105,WEDNESDAY,0,0,20,96,7.6,1010.6,Cloudy
8/24/2022 5:00,17,67,31225,65711,84,96936,WEDNESDAY,0,0,20,96,0,1010.7,Cloudy
8/24/2022 6:00,15,27,1284175,58779,42,1342954,WEDNESDAY,0,0,20,96,0,1010.7,Cloudy
8/24/2022 7:00,1,17,319,14385,18,14704,WEDNESDAY,0,0,20,96,7.6,1010.8,Cloudy
8/24/2022 8:00,4,30,3352,22258,34,25610,WEDNESDAY,0,0,20,93,5.4,1011,Cloudy
8/24/2022 9:00,8,129,5848,1154824,137,1160672,WEDNESDAY,0,0,20,93,5.4,1011,Cloudy
8/24/2022 10:00,32,375,28691,303546,407,332237,WEDNESDAY,0,0,20.6,93,11.2,1011.3,Cloudy
8/24/2022 11:00,58,929,62677,1589550,987,1652227,WEDNESDAY,0,0,21.1,90,11.2,1011.7,Cloudy
8/24/2022 12:00,101,1420,102902,2017678,1521,2120580,WEDNESDAY,0,0,22.8,81,0,1012.4,Cloudy
8/24/2022 13:00,74,852,107095,1675713,926,1782808,WEDNESDAY,0,0,22.8,81,7.6,1012.8,Cloudy
8/24/2022 14:00,88,519,158040,506110,607,664150,WEDNESDAY,0,0,22.8,81,9.4,1013.1,Cloudy
8/24/2022 15:00,103,632,614685,616804,735,1231489,WEDNESDAY,0,0,24.4,74,9.4,1012.7,Cloudy
8/24/2022 16:00,118,689,208617,988667,807,1197284,WEDNESDAY,0,0,24.4,74,9.4,1012.7,Cloudy
8/24/2022 17:00,153,737,1651881,736700,890,2388581,WEDNESDAY,0,0,26.1,69,16.6,1012.6,Cloudy
8/24/2022 18:00,188,789,355676,847240,977,1202916,WEDNESDAY,0,0,27.2,62,16.6,1012.3,Cloudy
8/24/2022 19:00,182,907,309201,1289273,1089,1598474,WEDNESDAY,0,0,24.4,77,16.6,1012.3,Cloudy
8/24/2022 20:00,247,1305,1275995,1300205,1552,2576200,WEDNESDAY,0,0,24.4,77,16.6,1012.2,Cloudy
8/24/2022 21:00,287,2070,526530,2190285,2357,2716815,WEDNESDAY,0,0,24.4,77,20.5,1012.2,Cloudy
8/24/2022 22:00,340,1958,658129,2009229,2298,2667358,WEDNESDAY,0,0,23.3,85,18.4,1013.1,Fair
8/24/2022 23:00,199,1396,314051,1487846,1595,1801897,WEDNESDAY,0,0,22.2,87,9.4,1013.6,Fair
8/25/2022 0:00,123,928,179775,1086904,1051,1266679,THURSDAY,0,0,22.2,87,9.4,1013.6,Fair
8/25/2022 1:00,103,698,129862,771991,801,901853,THURSDAY,0,0,22.2,87,5.4,1014.1,Fair
8/25/2022 2:00,113,565,274372,1134997,678,1409369,THURSDAY,0,0,21.7,87,0,1014.7,Fair
8/25/2022 3:00,78,299,270715,364008,377,634723,THURSDAY,0,0,23.9,79,5.4,1014.8,Fair
8/25/2022 4:00,38,134,117779,117975,172,235754,THURSDAY,0,0,23.3,82,0,1015.2,Fair
8/25/2022 5:00,18,55,153825,55290,73,209115,THURSDAY,0,0,22.2,91,7.6,1015.2,Fair
8/25/2022 6:00,13,31,41754,46161,44,87915,THURSDAY,0,0,22.2,91,7.6,1015.2,Fair
8/25/2022 7:00,5,18,8405,19497,23,27902,THURSDAY,0,0,22.8,76,11.2,1015,Fair
8/25/2022 8:00,5,29,5232,30431,34,35663,THURSDAY,0,0,22.8,76,0,1014.9,Fair
8/25/2022 9:00,10,112,11584,83817,122,95401,THURSDAY,0,0,22.2,79,9.4,1015.2,Fair
8/25/2022 10:00,15,343,7038,1515698,358,1522736,THURSDAY,0,0,22.8,76,11.2,1015.8,Fair
8/25/2022 11:00,68,879,91684,764336,947,856020,THURSDAY,0,0,22.8,76,11.2,1015.8,Fair
8/25/2022 12:00,93,1316,132205,1077903,1409,1210108,THURSDAY,0,0,26.7,58,7.6,1016.2,Fair
8/25/2022 13:00,87,846,104497,766390,933,870887,THURSDAY,0,0,26.7,58,7.6,1016.2,Fair
8/25/2022 14:00,82,582,137395,1155164,664,1292559,THURSDAY,0,0,26.7,56,5.4,1016.7,Fair
8/25/2022 15:00,165,665,465908,621106,830,1087014,THURSDAY,0,0,26.7,56,16.6,1016.7,Fair
8/25/2022 16:00,133,726,480570,1876450,859,2357020,THURSDAY,0,0,28.3,49,18.4,1016.2,Fair
8/25/2022 17:00,197,707,421705,767198,904,1188903,THURSDAY,0,0,27.8,51,18.4,1016.1,Fair
8/25/2022 18:00,170,698,575641,696890,868,1272531,THURSDAY,0,0,27.2,58,25.9,1015.7,Fair
8/25/2022 19:00,180,993,343713,1538396,1173,1882109,THURSDAY,0,0,26.7,60,24.1,1015.6,Fair
8/25/2022 20:00,226,1386,647702,1408446,1612,2056148,THURSDAY,0,0,26.7,60,24.1,1015.6,Fair
8/25/2022 21:00,319,1987,551508,2536821,2306,3088329,THURSDAY,0,0,26.1,67,18.4,1015.2,Rain
8/25/2022 22:00,325,1801,906762,2168143,2126,3074905,THURSDAY,0,0,26.1,67,18.4,1015.2,Fair
8/25/2022 23:00,249,1515,787648,1666905,1764,2454553,THURSDAY,0,0,25.6,71,11.2,1015.1,Fair
8/26/2022 0:00,155,968,516083,1085457,1123,1601540,FRIDAY,0,0,26.1,67,13,1015.3,Fair
8/26/2022 1:00,110,728,1104645,890283,838,1994928,FRIDAY,0,0,24.4,67,13,1016.2,Fair
8/26/2022 2:00,137,566,328450,684949,703,1013399,FRIDAY,0,0,24.4,67,13,1016.2,Fair
8/26/2022 3:00,87,411,635397,510858,498,1146255,FRIDAY,0,0,23.9,64,0,1016.1,Fair
8/26/2022 4:00,44,241,63864,271379,285,335243,FRIDAY,0,0,23.9,62,11.2,1015.8,Fair
8/26/2022 5:00,33,107,283030,110040,140,393070,FRIDAY,0,0,22.8,66,11.2,1015.6,Fair
8/26/2022 6:00,12,58,19069,89160,70,108229,FRIDAY,0,0,22.8,66,11.2,1015.6,Fair
8/26/2022 7:00,10,25,16393,65605,35,81998,FRIDAY,0,0,21.7,73,13,1015.1,Fair
8/26/2022 8:00,2,34,2711,529715,36,532426,FRIDAY,0,0,22.2,71,7.6,1015,Fair
8/26/2022 9:00,14,98,11757,71695,112,83452,FRIDAY,0,0,21.1,82,7.6,1015,Cloudy
8/26/2022 10:00,22,265,13132,238786,287,251918,FRIDAY,0,0,21.1,82,7.6,1015,Rain
8/26/2022 11:00,43,676,46914,632304,719,679218,FRIDAY,0,0,22.8,76,11.2,1014.8,Cloudy
8/26/2022 12:00,74,1050,166497,2011808,1124,2178305,FRIDAY,0,0,25,66,11.2,1014.6,Cloudy
8/26/2022 13:00,64,804,82632,780678,868,863310,FRIDAY,0,0,27.2,58,14.8,1014.4,Cloudy
8/26/2022 14:00,141,661,541121,617279,802,1158400,FRIDAY,0,0,27.2,58,14.8,1014.4,Fair
8/26/2022 15:00,134,723,279696,623606,857,903302,FRIDAY,0,0,28.9,53,14.8,1014,Fair
8/26/2022 16:00,178,831,339480,895145,1009,1234625,FRIDAY,0,0,31.7,44,25.9,1012.4,Fair
8/26/2022 17:00,176,912,298037,859933,1088,1157970,FRIDAY,0,0,31.7,42,25.9,1011.2,Cloudy
8/26/2022 18:00,182,931,313558,1031053,1113,1344611,FRIDAY,0,0,32.2,41,31.7,1010.4,Cloudy
8/26/2022 19:00,180,1103,255118,2737280,1283,2992398,FRIDAY,0,0,32.2,41,29.5,1010.4,Cloudy
8/26/2022 20:00,27,367,25611,984967,394,1010578,FRIDAY,0,0,28.9,51,27.7,1012,Cloudy
8/26/2022 21:00,49,498,52365,404786,547,457151,FRIDAY,0,0,21.1,90,16.6,1012.1,Cloudy
8/26/2022 22:00,72,589,109861,762276,661,872137,FRIDAY,0,0,21.1,90,16.6,1012.1,Cloudy
8/26/2022 23:00,113,845,144017,1542609,958,1686626,FRIDAY,0,0,22.2,91,14.8,1011.9,Cloudy
8/27/2022 0:00,86,708,103419,657443,794,760862,SATURDAY,1,0,22.2,91,14.8,1011.9,Cloudy
8/27/2022 1:00,106,567,169294,677457,673,846751,SATURDAY,1,0,22.2,87,11.2,1012.4,Cloudy
8/27/2022 2:00,139,552,179289,582048,691,761337,SATURDAY,1,0,22.2,84,14.8,1012.8,Cloudy
8/27/2022 3:00,131,444,544787,489643,575,1034430,SATURDAY,1,0,22.2,84,14.8,1012.8,Cloudy
8/27/2022 4:00,105,302,483901,353538,407,837439,SATURDAY,1,0,22.2,87,11.2,1012.8,Fair
8/27/2022 5:00,111,266,180418,903822,377,1084240,SATURDAY,1,0,22.2,87,11.2,1012.8,Fair
8/27/2022 6:00,51,146,365725,191937,197,557662,SATURDAY,1,0,21.7,90,9.4,1012.8,Fair
8/27/2022 7:00,14,37,16058,41678,51,57736,SATURDAY,1,0,21.7,90,7.6,1012.6,Fair
8/27/2022 8:00,5,21,25949,15350,26,41299,SATURDAY,1,0,21.7,90,7.6,1012.6,Fair
8/27/2022 9:00,6,46,1121143,36798,52,1157941,SATURDAY,1,0,21.1,93,7.6,1013.2,Fair
8/27/2022 10:00,21,117,31437,113523,138,144960,SATURDAY,1,0,20.6,90,9.4,1013.5,Fair
8/27/2022 11:00,34,250,49041,535883,284,584924,SATURDAY,1,0,21.7,84,16.6,1014.9,Fair
8/27/2022 12:00,62,493,106833,491468,555,598301,SATURDAY,1,0,23.3,74,16.6,1015.4,Fair
8/27/2022 13:00,160,768,285443,778922,928,1064365,SATURDAY,1,0,24.4,69,13,1015.9,Fair
8/27/2022 14:00,187,880,369104,955559,1067,1324663,SATURDAY,1,0,25,69,16.6,1016.5,Fair
8/27/2022 15:00,247,1130,558544,2313358,1377,2871902,SATURDAY,1,0,25,69,16.6,1016.5,Fair
8/27/2022 16:00,318,1166,639942,1235215,1484,1875157,SATURDAY,1,0,22.8,79,25.9,1017.3,Cloudy
8/27/2022 17:00,313,1241,661372,1598233,1554,2259605,SATURDAY,1,0,22.2,76,25.9,1017.4,Cloudy
8/27/2022 18:00,361,1213,746825,1503443,1574,2250268,SATURDAY,1,0,22.2,76,27.7,1017.4,Cloudy
8/27/2022 19:00,369,1360,1060611,1715470,1729,2776081,SATURDAY,1,0,22.8,76,20.5,1017.3,Cloudy
8/27/2022 20:00,365,1372,814560,3133030,1737,3947590,SATURDAY,1,0,22.2,79,18.4,1017.4,Cloudy
8/27/2022 21:00,323,1457,1107971,3009039,1780,4117010,SATURDAY,1,0,21.7,79,18.4,1017.7,Fair
8/27/2022 22:00,418,1442,1135276,2456570,1860,3591846,SATURDAY,1,0,20.6,81,14.8,1018.3,Cloudy
8/27/2022 23:00,311,1334,788908,1694234,1645,2483142,SATURDAY,1,0,20.6,81,14.8,1018.3,Cloudy
8/28/2022 0:00,217,896,746987,936102,1113,1683089,SUNDAY,1,0,20.6,84,13,1018.8,Cloudy
8/28/2022 1:00,168,759,874181,1305255,927,2179436,SUNDAY,1,0,20.6,84,14.8,1020,Fair
8/28/2022 2:00,174,668,669145,861755,842,1530900,SUNDAY,1,0,20.6,81,13,1020.6,Fair
8/28/2022 3:00,151,508,244599,560318,659,804917,SUNDAY,1,0,20.6,81,13,1020.6,Fair
8/28/2022 4:00,137,398,1798645,540994,535,2339639,SUNDAY,1,0,19.4,87,7.6,1020.8,Fair
8/28/2022 5:00,132,310,378503,391016,442,769519,SUNDAY,1,0,19.4,87,7.6,1020.8,Fair
8/28/2022 6:00,50,140,104030,159080,190,263110,SUNDAY,1,0,20,87,5.4,1021.3,Fair
8/28/2022 7:00,14,68,26743,209006,82,235749,SUNDAY,1,0,20,87,5.4,1021.3,Fair
8/28/2022 8:00,5,23,50364,28852,28,79216,SUNDAY,1,0,19.4,87,5.4,1021.4,Cloudy
8/28/2022 9:00,10,21,15793,23356,31,39149,SUNDAY,1,0,18.9,90,7.6,1022.2,Cloudy
8/28/2022 10:00,13,120,21934,106889,133,128823,SUNDAY,1,0,18.9,90,7.6,1022.2,Cloudy
8/28/2022 11:00,19,180,40413,187169,199,227582,SUNDAY,1,0,21.1,78,7.6,1023.3,Cloudy
8/28/2022 12:00,54,419,127171,445292,473,572463,SUNDAY,1,0,21.7,73,9.4,1023.4,Cloudy
8/28/2022 13:00,112,600,201886,611802,712,813688,SUNDAY,1,0,22.8,71,11.2,1023.8,Fair
8/28/2022 14:00,205,928,421548,1136739,1133,1558287,SUNDAY,1,0,22.8,71,11.2,1023.8,Fair
8/28/2022 15:00,271,1106,634821,2029003,1377,2663824,SUNDAY,1,0,22.8,69,13,1023.8,Fair
8/28/2022 16:00,319,1206,645606,1461103,1525,2106709,SUNDAY,1,0,23.9,66,20.5,1023,Fair
8/28/2022 17:00,296,1317,668152,1739414,1613,2407566,SUNDAY,1,0,23.9,66,20.5,1022.6,Fair
8/28/2022 18:00,329,1269,1485000,1548248,1598,3033248,SUNDAY,1,0,23.9,64,27.7,1022,Fair
8/28/2022 19:00,322,1259,683327,1625875,1581,2309202,SUNDAY,1,0,23.9,64,27.7,1022,Fair
8/28/2022 20:00,341,1462,691001,2325582,1803,3016583,SUNDAY,1,0,23.3,69,25.9,1021.1,Fair
8/28/2022 21:00,317,1481,656536,1735265,1798,2391801,SUNDAY,1,0,22.8,73,29.5,1020.8,Rain
8/28/2022 22:00,279,1422,698392,1583946,1701,2282338,SUNDAY,1,0,22.8,69,18.4,1020.9,Fair
8/28/2022 23:00,241,1249,1768973,1527100,1490,3296073,SUNDAY,1,0,21.7,73,14.8,1020.9,Fair
8/29/2022 0:00,137,848,228394,1266936,985,1495330,MONDAY,0,0,21.7,73,14.8,1020.9,Fair
8/29/2022 1:00,115,654,193945,722831,769,916776,MONDAY,0,0,21.1,73,14.8,1021.4,Fair
8/29/2022 2:00,83,444,162876,501633,527,664509,MONDAY,0,0,20.6,68,18.4,1021.3,Fair
8/29/2022 3:00,48,287,82877,402722,335,485599,MONDAY,0,0,20,63,14.8,1021.5,Fair
8/29/2022 4:00,36,185,534041,174289,221,708330,MONDAY,0,0,20,68,14.8,1021.3,Fair
8/29/2022 5:00,25,96,66243,106181,121,172424,MONDAY,0,0,20,68,14.8,1021.3,Fair
8/29/2022 6:00,12,51,29482,50079,63,79561,MONDAY,0,0,18.9,78,14.8,1020.9,Fair
8/29/2022 7:00,4,27,5766,34401,31,40167,MONDAY,0,0,19.4,84,14.8,1020.7,Fair
8/29/2022 8:00,6,26,12965,27132,32,40097,MONDAY,0,0,18.9,87,9.4,1020.4,Fair
8/29/2022 9:00,9,117,39042,84614,126,123656,MONDAY,0,0,18.9,90,9.4,1020.4,Fair
8/29/2022 10:00,29,320,42444,226138,349,268582,MONDAY,0,0,18.9,90,9.4,1020.4,Fair
8/29/2022 11:00,66,831,174400,1572051,897,1746451,MONDAY,0,0,21.1,82,16.6,1021,Fair
8/29/2022 12:00,81,1248,87527,1033587,1329,1121114,MONDAY,0,0,22.8,76,18.4,1020.7,Fair
8/29/2022 13:00,75,802,128640,670291,877,798931,MONDAY,0,0,25.6,67,16.6,1020.4,Fair
8/29/2022 14:00,91,652,209405,822376,743,1031781,MONDAY,0,0,25.6,67,16.6,1020.4,Fair
8/29/2022 15:00,100,681,242315,634371,781,876686,MONDAY,0,0,28.9,57,16.6,1019.3,Fair
8/29/2022 16:00,155,804,546289,784288,959,1330577,MONDAY,0,0,29.4,55,18.4,1018.6,Cloudy
8/29/2022 17:00,125,848,215799,764271,973,980070,MONDAY,0,0,30.6,51,20.5,1017.7,Cloudy
8/29/2022 18:00,176,816,367093,725437,992,1092530,MONDAY,0,0,31.1,48,16.6,1017.1,Cloudy
8/29/2022 19:00,158,988,263190,1019259,1146,1282449,MONDAY,0,0,31.1,48,16.6,1017.1,Cloudy
8/29/2022 20:00,193,1438,527017,2258689,1631,2785706,MONDAY,0,0,30.6,53,22.3,1016.2,Cloudy
8/29/2022 21:00,225,1935,883196,2658855,2160,3542051,MONDAY,0,0,28.3,63,24.1,1015.6,Rain
8/29/2022 22:00,233,1747,1148934,1902077,1980,3051011,MONDAY,0,0,28.3,63,24.1,1015.6,Fair
8/29/2022 23:00,197,1376,306080,1496287,1573,1802367,MONDAY,0,0,25,79,22.3,1015.8,Fair
8/30/2022 0:00,125,833,237553,1609904,958,1847457,TUESDAY,0,0,25,79,22.3,1015.8,Fair
8/30/2022 1:00,87,612,153621,690386,699,844007,TUESDAY,0,0,23.9,82,24.1,1016.4,Fair
8/30/2022 2:00,61,451,130555,851248,512,981803,TUESDAY,0,0,23.9,82,25.9,1016.1,Fair
8/30/2022 3:00,30,273,54705,298530,303,353235,TUESDAY,0,0,23.9,82,25.9,1016.1,Fair
8/30/2022 4:00,24,181,27546,212639,205,240185,TUESDAY,0,0,23.3,82,22.3,1015.8,Fair
8/30/2022 5:00,16,78,30994,341608,94,372602,TUESDAY,0,0,22.8,87,18.4,1015.5,Fair
8/30/2022 6:00,11,29,128977,144213,40,273190,TUESDAY,0,0,22.8,87,18.4,1014.7,Fair
8/30/2022 7:00,3,11,4084,9918,14,14002,TUESDAY,0,0,22.8,87,16.6,1013.9,Fair
8/30/2022 8:00,2,16,1521,14611,18,16132,TUESDAY,0,0,22.2,94,20.5,1013.9,Fair
8/30/2022 9:00,10,162,8791,119944,172,128735,TUESDAY,0,0,22.2,91,20.5,1013.7,Fair
8/30/2022 10:00,30,396,47667,338458,426,386125,TUESDAY,0,0,22.2,91,20.5,1013.7,Fair
8/30/2022 11:00,58,1022,56555,796861,1080,853416,TUESDAY,0,0,24.4,79,22.3,1013.6,Fair
8/30/2022 12:00,95,1457,118339,1567258,1552,1685597,TUESDAY,0,0,24.4,79,22.3,1013.6,Fair
8/30/2022 13:00,70,887,216727,731237,957,947964,TUESDAY,0,0,28.3,63,16.6,1012.9,Fair
8/30/2022 14:00,79,626,94914,640775,705,735689,TUESDAY,0,0,28.3,63,16.6,1012.9,Fair
8/30/2022 15:00,106,644,210953,977410,750,1188363,TUESDAY,0,0,31.1,52,14.8,1011.8,Fair
8/30/2022 16:00,106,824,218820,724658,930,943478,TUESDAY,0,0,31.1,52,14.8,1011.8,Fair
8/30/2022 17:00,126,777,202777,638951,903,841728,TUESDAY,0,0,32.8,45,20.5,1010.3,Fair
8/30/2022 18:00,107,873,208141,761107,980,969248,TUESDAY,0,0,31.1,57,20.5,1009.5,Fair
8/30/2022 19:00,141,1049,711696,1040841,1190,1752537,TUESDAY,0,0,31.1,57,25.9,1009.5,Cloudy
8/30/2022 20:00,165,1482,250190,1378064,1647,1628254,TUESDAY,0,0,30,57,29.5,1008.6,Cloudy
8/30/2022 21:00,209,2024,297966,2057295,2233,2355261,TUESDAY,0,0,28.9,57,29.5,1008.5,Rain
8/30/2022 22:00,213,1762,598612,3219082,1975,3817694,TUESDAY,0,0,26.7,67,29.5,1008.5,Cloudy
8/30/2022 23:00,162,1406,667992,1673156,1568,2341148,TUESDAY,0,0,25.6,76,29.5,1008.7,Cloudy
8/31/2022 0:00,102,889,917802,901540,991,1819342,WEDNESDAY,0,0,25.6,76,29.5,1008.7,Cloudy
8/31/2022 1:00,73,681,98500,659534,754,758034,WEDNESDAY,0,0,24.4,82,18.4,1008.9,Cloudy
8/31/2022 2:00,51,451,88394,965957,502,1054351,WEDNESDAY,0,0,24.4,85,18.4,1008.6,Cloudy
8/31/2022 3:00,39,240,124389,523942,279,648331,WEDNESDAY,0,0,23.9,90,18.4,1008.4,Cloudy
8/31/2022 4:00,17,131,29495,383386,148,412881,WEDNESDAY,0,0,23.9,88,13,1007.9,Cloudy
8/31/2022 5:00,14,81,15854,63547,95,79401,WEDNESDAY,0,0,23.3,94,13,1007.1,Cloudy
8/31/2022 6:00,2,22,1096,22391,24,23487,WEDNESDAY,0,0,23.3,94,14.8,1006.4,Cloudy
8/31/2022 7:00,0,15,0,32872,15,32872,WEDNESDAY,0,0,23.3,94,14.8,1006.4,Cloudy
8/31/2022 8:00,3,9,4960,9596,12,14556,WEDNESDAY,0,0,22.2,94,16.6,1005.8,Rain
8/31/2022 9:00,3,60,5545,49352,63,54897,WEDNESDAY,0,0,22.2,94,16.6,1005.8,Rain
8/31/2022 10:00,9,218,6230,153665,227,159895,WEDNESDAY,0,0,22.2,91,5.4,1006.3,Rain
8/31/2022 11:00,47,841,43500,699075,888,742575,WEDNESDAY,0,0,22.2,87,18.4,1006.7,Rain
8/31/2022 12:00,91,1403,257509,1112088,1494,1369597,WEDNESDAY,0,0,22.8,81,11.2,1007,Cloudy
8/31/2022 13:00,68,939,129512,763141,1007,892653,WEDNESDAY,0,0,22.8,81,11.2,1007,Cloudy
8/31/2022 14:00,75,677,142148,549471,752,691619,WEDNESDAY,0,0,26.1,60,13,1006.2,Cloudy
8/31/2022 15:00,104,743,275811,700300,847,976111,WEDNESDAY,0,0,27.8,53,16.6,1005.8,Cloudy
8/31/2022 16:00,119,846,247737,717120,965,964857,WEDNESDAY,0,0,27.8,51,20.5,1005.3,Fair
8/31/2022 17:00,116,941,220263,869995,1057,1090258,WEDNESDAY,0,0,29.4,45,14.8,1005.1,Fair
8/31/2022 18:00,122,1024,173923,1074152,1146,1248075,WEDNESDAY,0,0,27.8,47,25.9,1005.2,Fair
8/31/2022 19:00,163,1240,259667,1226373,1403,1486040,WEDNESDAY,0,0,27.8,47,25.9,1005.2,Fair
8/31/2022 20:00,178,1483,323415,1420309,1661,1743724,WEDNESDAY,0,0,28.3,33,25.9,1005.6,Fair
8/31/2022 21:00,260,2110,385966,2282837,2370,2668803,WEDNESDAY,0,0,28.3,33,31.7,1005.6,Fair
8/31/2022 22:00,206,1900,495646,2129286,2106,2624932,WEDNESDAY,0,0,27.2,33,20.5,1006.4,Fair
8/31/2022 23:00,159,1416,244464,2189549,1575,2434013,WEDNESDAY,0,0,26.1,31,22.3,1007.1,Fair
9/1/2022 0:00,22,139,706901,139739,161,846640,THURSDAY,0,0,25,36,22.3,1008,Fair
9/1/2022 1:00,21,81,29916,82759,102,112675,THURSDAY,0,0,23.9,40,13,1008.8,Fair
9/1/2022 2:00,5,31,8797,31406,36,40203,THURSDAY,0,0,22.8,43,11.2,1009.1,Fair
9/1/2022 3:00,3,15,2938,14465,18,17403,THURSDAY,0,0,21.1,53,13,1008.9,Fair
9/1/2022 4:00,3,17,3602,26213,20,29815,THURSDAY,0,0,21.1,53,13,1008.9,Fair
9/1/2022 5:00,7,114,4417,84315,121,88732,THURSDAY,0,0,20,59,14.8,1008.7,Fair
9/1/2022 6:00,23,344,26138,542833,367,568971,THURSDAY,0,0,20,59,20.5,1008.8,Clear
9/1/2022 7:00,56,923,69111,760975,979,830086,THURSDAY,0,0,20,57,22.3,1008.8,Clear
9/1/2022 8:00,88,1364,106763,3601365,1452,3708128,THURSDAY,0,0,20,57,22.3,1008.8,Clear
9/1/2022 9:00,73,973,96073,1555148,1046,1651221,THURSDAY,0,0,19.4,59,16.6,1009.1,Clear
9/1/2022 10:00,91,775,136953,720258,866,857211,THURSDAY,0,0,21.7,51,16.6,1009.7,Clear
9/1/2022 11:00,106,842,228386,754803,948,983189,THURSDAY,0,0,22.2,51,18.4,1010,Fair
9/1/2022 12:00,147,924,236902,934969,1071,1171871,THURSDAY,0,0,23.3,46,18.4,1010.3,Fair
9/1/2022 13:00,143,1099,265901,1570494,1242,1836395,THURSDAY,0,0,23.3,46,18.4,1010.3,Fair
9/1/2022 14:00,158,1170,295066,2083715,1328,2378781,THURSDAY,0,0,25,40,22.3,1010.6,Fair
9/1/2022 15:00,193,1232,838654,1216420,1425,2055074,THURSDAY,0,0,25,40,25.9,1011,Rain
9/1/2022 16:00,214,1605,422801,1839803,1819,2262604,THURSDAY,0,0,26.1,30,14.8,1011.2,Fair
9/1/2022 17:00,334,2079,495943,3339474,2413,3835417,THURSDAY,0,0,26.1,29,14.8,1011.6,Fair
9/1/2022 18:00,311,1825,592994,1866488,2136,2459482,THURSDAY,0,0,26.1,29,14.8,1011.6,Fair
9/1/2022 19:00,216,1480,511381,3272665,1696,3784046,THURSDAY,0,0,26.7,29,22.3,1011.8,Cloudy
9/1/2022 20:00,109,969,826388,5158282,1078,5984670,THURSDAY,0,0,26.7,29,22.3,1011.8,Cloudy
9/1/2022 21:00,106,690,493935,655468,796,1149403,THURSDAY,0,0,25.6,31,22.3,1012.4,Cloudy
9/1/2022 22:00,129,568,215552,1175905,697,1391457,THURSDAY,0,0,23.9,34,18.4,1014,Fair
9/1/2022 23:00,69,348,76262,1219703,417,1295965,THURSDAY,0,0,23.9,34,18.4,1014,Fair
9/2/2022 0:00,46,182,137334,251154,228,388488,FRIDAY,0,0,21.7,41,14.8,1016.4,Fair
9/2/2022 1:00,30,126,104446,1540483,156,1644929,FRIDAY,0,0,20.6,44,14.8,1017.1,Fair
9/2/2022 2:00,13,44,15055,36456,57,51511,FRIDAY,0,0,19.4,47,13,1017.8,Fair
9/2/2022 3:00,6,14,4493,11428,20,15921,FRIDAY,0,0,17.8,50,18.4,1018.7,Fair
9/2/2022 4:00,4,27,9108,53875,31,62983,FRIDAY,0,0,17.8,50,18.4,1018.7,Fair
9/2/2022 5:00,9,110,8711,88929,119,97640,FRIDAY,0,0,16.7,52,20.5,1019.5,Fair
9/2/2022 6:00,14,281,19148,230349,295,249497,FRIDAY,0,0,16.1,52,14.8,1020.6,Clear
9/2/2022 7:00,57,609,64546,461442,666,525988,FRIDAY,0,0,15.6,53,18.4,1021.1,Clear
9/2/2022 8:00,67,1030,80520,1290719,1097,1371239,FRIDAY,0,0,15.6,53,18.4,1021.1,Clear
9/2/2022 9:00,85,842,117523,1523859,927,1641382,FRIDAY,0,0,14.4,62,11.2,1022.9,Clear
9/2/2022 10:00,127,798,254330,1826557,925,2080887,FRIDAY,0,0,15,60,14.8,1024,Rain
9/2/2022 11:00,172,932,299601,1306442,1104,1606043,FRIDAY,0,0,16.7,58,11.2,1024.7,Fair
9/2/2022 12:00,203,1075,1030706,1535770,1278,2566476,FRIDAY,0,0,16.7,58,11.2,1024.7,Fair
9/2/2022 13:00,216,1259,443200,1843583,1475,2286783,FRIDAY,0,0,18.3,50,16.6,1025.3,Fair
9/2/2022 14:00,239,1276,1318749,2495782,1515,3814531,FRIDAY,0,0,18.9,52,18.4,1025.8,Fair
9/2/2022 15:00,267,1392,527367,1428173,1659,1955540,FRIDAY,0,0,18.9,52,16.6,1025.8,Fair
9/2/2022 16:00,304,1673,750803,3067974,1977,3818777,FRIDAY,0,0,19.4,55,16.6,1025.7,Fair
9/2/2022 17:00,277,1773,435579,4034436,2050,4470015,FRIDAY,0,0,19.4,57,14.8,1025.7,Fair
9/2/2022 18:00,298,1655,1144735,3165118,1953,4309853,FRIDAY,0,0,19.4,57,14.8,1025.7,Fair
9/2/2022 19:00,219,1302,3193452,1381127,1521,4574579,FRIDAY,0,0,19.4,57,16.6,1025.3,Fair
9/2/2022 20:00,162,882,1724623,2298461,1044,4023084,FRIDAY,0,0,20,57,18.4,1025.3,Fair
9/2/2022 21:00,118,794,232413,876573,912,1108986,FRIDAY,0,0,20,57,18.4,1025.3,Fair
9/2/2022 22:00,179,681,3823724,1226877,860,5050601,FRIDAY,0,0,18.9,61,20.5,1025.3,Fair
9/2/2022 23:00,116,501,234922,1087660,617,1322582,FRIDAY,0,0,18.9,61,20.5,1025.6,Fair
9/3/2022 0:00,77,353,207083,2483557,430,2690640,SATURDAY,1,0,17.8,70,14.8,1025.9,Fair
9/3/2022 1:00,111,229,377556,379293,340,756849,SATURDAY,1,0,17.8,68,14.8,1025.9,Fair
9/3/2022 2:00,35,119,695235,134276,154,829511,SATURDAY,1,0,17.2,70,9.4,1026.2,Fair
9/3/2022 3:00,8,30,8484,32292,38,40776,SATURDAY,1,0,17.2,70,9.4,1026.2,Clear
9/3/2022 4:00,1,24,674,100528,25,101202,SATURDAY,1,0,17.2,70,9.4,1026.2,Clear
9/3/2022 5:00,2,47,7480,52834,49,60314,SATURDAY,1,0,15.6,78,11.2,1026.2,Clear
9/3/2022 6:00,8,128,32373,95254,136,127627,SATURDAY,1,0,15.6,80,9.4,1026.1,Clear
9/3/2022 7:00,32,263,67461,227172,295,294633,SATURDAY,1,0,15,83,9.4,1026.3,Clear
9/3/2022 8:00,89,466,182771,458927,555,641698,SATURDAY,1,0,15,83,9.4,1026.3,Fair
9/3/2022 9:00,143,660,658118,622988,803,1281106,SATURDAY,1,0,15.6,83,5.4,1026.5,Fair
9/3/2022 10:00,230,949,478347,1115001,1179,1593348,SATURDAY,1,0,16.1,84,9.4,1027.2,Fair
9/3/2022 11:00,278,1169,687754,1406400,1447,2094154,SATURDAY,1,0,17.8,75,9.4,1027.2,Fair
9/3/2022 12:00,323,1198,776239,5431969,1521,6208208,SATURDAY,1,0,19.4,71,9.4,1027.1,Fair
9/3/2022 13:00,442,1242,1440124,5526559,1684,6966683,SATURDAY,1,0,19.4,71,9.4,1027.1,Fair
9/3/2022 14:00,338,1316,3516454,2192198,1654,5708652,SATURDAY,1,0,21.7,63,9.4,1026.1,Cloudy
9/3/2022 15:00,396,1561,838393,2854545,1957,3692938,SATURDAY,1,0,23.9,52,14.8,1025.3,Rain
9/3/2022 16:00,355,1491,3840169,6981540,1846,10821709,SATURDAY,1,0,23.3,60,14.8,1024.9,Cloudy
9/3/2022 17:00,358,1359,3711647,1655508,1717,5367155,SATURDAY,1,0,22.2,59,27.7,1024.4,Cloudy
9/3/2022 18:00,343,1521,1393754,3624991,1864,5018745,SATURDAY,1,0,22.2,59,35.3,1024.4,Cloudy
9/3/2022 19:00,329,1385,663352,4280007,1714,4943359,SATURDAY,1,0,21.7,55,33.5,1023.2,Cloudy
9/3/2022 20:00,219,1037,554812,2604927,1256,3159739,SATURDAY,1,0,21.7,55,27.7,1022.6,Cloudy
9/3/2022 21:00,151,860,405594,2123179,1011,2528773,SATURDAY,1,0,21.7,55,24.1,1022.6,Cloudy
9/3/2022 22:00,136,719,555662,1762484,855,2318146,SATURDAY,1,0,21.7,61,20.5,1022.2,Cloudy
9/3/2022 23:00,120,603,576691,899747,723,1476438,SATURDAY,1,0,21.1,59,20.5,1021.7,Cloudy
9/4/2022 0:00,119,388,1261695,2210841,507,3472536,SUNDAY,1,0,20,55,22.3,1022.1,Cloudy
9/4/2022 1:00,129,298,209228,354245,427,563473,SUNDAY,1,0,20,55,22.3,1022.1,Cloudy
9/4/2022 2:00,43,145,52476,190415,188,242891,SUNDAY,1,0,18.9,65,13,1022.3,Cloudy
9/4/2022 3:00,11,44,57191,75063,55,132254,SUNDAY,1,0,18.9,65,13,1022.3,Fair
9/4/2022 4:00,2,26,349104,1014290,28,1363394,SUNDAY,1,0,18.9,65,16.6,1022.3,Fair
9/4/2022 5:00,4,39,5779,38757,43,44536,SUNDAY,1,0,18.3,73,13,1021.1,Fair
9/4/2022 6:00,11,98,10813,99287,109,110100,SUNDAY,1,0,18.3,76,14.8,1021,Fair
9/4/2022 7:00,27,184,79865,1606400,211,1686265,SUNDAY,1,0,18.3,76,14.8,1021,Fair
9/4/2022 8:00,59,436,117549,422896,495,540445,SUNDAY,1,0,17.8,81,13,1020.7,Fair
9/4/2022 9:00,159,689,376692,678539,848,1055231,SUNDAY,1,0,18.3,81,13,1020.4,Fair
9/4/2022 10:00,277,910,587985,984108,1187,1572093,SUNDAY,1,0,18.3,84,13,1020.5,Rain
9/4/2022 11:00,300,1172,3730205,1382072,1472,5112277,SUNDAY,1,0,20.6,73,18.4,1020.6,Fair
9/4/2022 12:00,395,1276,973470,2919067,1671,3892537,SUNDAY,1,0,20.6,73,18.4,1020.6,Fair
9/4/2022 13:00,385,1224,3694244,1555510,1609,5249754,SUNDAY,1,0,23.9,62,5.4,1020.3,Fair
9/4/2022 14:00,412,1330,1787621,1935725,1742,3723346,SUNDAY,1,0,25.6,60,5.4,1020,Fair
9/4/2022 15:00,412,1482,1080445,1794607,1894,2875052,SUNDAY,1,0,26.1,58,11.2,1019.5,Fair
9/4/2022 16:00,429,1595,840998,6281521,2024,7122519,SUNDAY,1,0,27.8,55,13,1019.1,Fair
9/4/2022 17:00,442,1703,1146005,3696810,2145,4842815,SUNDAY,1,0,26.7,58,13,1018.6,Fair
9/4/2022 18:00,389,1606,771097,2334820,1995,3105917,SUNDAY,1,0,26.7,58,18.4,1018.6,Fair
9/4/2022 19:00,290,1315,1953373,1677802,1605,3631175,SUNDAY,1,0,26.1,65,24.1,1017.6,Cloudy
9/4/2022 20:00,228,1028,549317,3398332,1256,3947649,SUNDAY,1,0,26.1,65,18.4,1017.5,Cloudy
9/4/2022 21:00,159,877,794930,1167872,1036,1962802,SUNDAY,1,0,26.1,65,18.4,1017.5,Cloudy
9/4/2022 22:00,160,670,1797891,776505,830,2574396,SUNDAY,1,0,23.9,76,13,1017.6,Cloudy
9/4/2022 23:00,134,543,530054,659804,677,1189858,SUNDAY,1,0,25,71,18.4,1018.1,Cloudy
9/5/2022 0:00,118,423,845229,540588,541,1385817,MONDAY,0,1,23.9,76,16.6,1018.6,Cloudy
9/5/2022 1:00,87,250,137880,2891905,337,3029785,MONDAY,0,1,23.9,76,16.6,1018.6,Cloudy
9/5/2022 2:00,55,107,95308,132901,162,228209,MONDAY,0,1,22.8,81,14.8,1019,Cloudy
9/5/2022 3:00,7,36,22246,93824,43,116070,MONDAY,0,1,22.8,81,14.8,1019,Cloudy
9/5/2022 4:00,10,15,61550,131415,25,192965,MONDAY,0,1,22.2,87,13,1019,Cloudy
9/5/2022 5:00,8,37,7909,35482,45,43391,MONDAY,0,1,22.2,87,13,1019,Cloudy
9/5/2022 6:00,6,121,8458,89597,127,98055,MONDAY,0,1,21.7,90,9.4,1018.9,Rain
9/5/2022 7:00,21,198,30124,154112,219,184236,MONDAY,0,1,21.7,90,9.4,1018.9,Rain
9/5/2022 8:00,37,296,69822,224625,333,294447,MONDAY,0,1,20.6,93,13,1018.9,Rain
9/5/2022 9:00,81,594,141990,496270,675,638260,MONDAY,0,1,20.6,93,9.4,1020,Rain
9/5/2022 10:00,121,776,215023,2259159,897,2474182,MONDAY,0,1,20.6,93,9.4,1020,Rain
9/5/2022 11:00,68,488,92554,392008,556,484562,MONDAY,0,1,20.6,93,7.6,1020.4,Rain
9/5/2022 12:00,29,273,156656,266873,302,423529,MONDAY,0,1,21.1,93,11.2,1020.9,Rain
9/5/2022 13:00,38,336,59078,342174,374,401252,MONDAY,0,1,21.7,87,16.6,1021.1,Rain
9/5/2022 14:00,51,546,87401,666667,597,754068,MONDAY,0,1,21.7,87,16.6,1021.2,Rain
9/5/2022 15:00,106,815,136749,800792,921,937541,MONDAY,0,1,21.7,87,16.6,1021.2,Rain
9/5/2022 16:00,121,884,242783,1086489,1005,1329272,MONDAY,0,1,20.6,93,18.4,1021.1,Rain
9/5/2022 17:00,47,580,698613,2624698,627,3323311,MONDAY,0,1,18.9,96,25.9,1021.3,Rain
9/5/2022 18:00,36,563,41516,560678,599,602194,MONDAY,0,1,19.4,93,24.1,1021,Cloudy
9/5/2022 19:00,40,418,52029,438988,458,491017,MONDAY,0,1,19.4,93,14.8,1020.6,Rain
9/5/2022 20:00,15,253,23940,491534,268,515474,MONDAY,0,1,19.4,93,14.8,1020.6,Rain
9/5/2022 21:00,22,185,31768,140205,207,171973,MONDAY,0,1,20,87,13,1020.9,Rain
9/5/2022 22:00,15,161,20956,125049,176,146005,MONDAY,0,1,19.4,93,13,1021.1,Rain
9/5/2022 23:00,13,117,12158,85959,130,98117,MONDAY,0,1,18.3,97,13,1020.9,Rain
9/6/2022 0:00,4,75,8558,62480,79,71038,TUESDAY,0,0,18.3,97,13,1020.8,Rain
9/6/2022 1:00,3,41,3204,99606,44,102810,TUESDAY,0,0,18.3,97,13,1021.1,Rain
9/6/2022 2:00,2,14,2387,10533,16,12920,TUESDAY,0,0,17.8,96,11.2,1020.8,Rain
9/6/2022 3:00,1,13,1219,9562,14,10781,TUESDAY,0,0,17.8,96,11.2,1020.8,Rain
9/6/2022 4:00,1,15,862,21939,16,22801,TUESDAY,0,0,17.2,97,13,1020.8,Rain
9/6/2022 5:00,0,51,0,35342,51,35342,TUESDAY,0,0,17.2,90,11.2,1020,Rain
9/6/2022 6:00,6,149,6636,139315,155,145951,TUESDAY,0,0,17.2,90,11.2,1020,Rain
9/6/2022 7:00,11,338,15290,567619,349,582909,TUESDAY,0,0,17.2,97,5.4,1019.6,Rain
9/6/2022 8:00,31,511,25748,414653,542,440401,TUESDAY,0,0,17.2,93,16.6,1019.2,Rain
9/6/2022 9:00,16,364,25589,275747,380,301336,TUESDAY,0,0,17.2,93,9.4,1019.4,Rain
9/6/2022 10:00,14,286,98313,210584,300,308897,TUESDAY,0,0,17.2,93,11.2,1019.6,Rain
9/6/2022 11:00,22,338,28896,257305,360,286201,TUESDAY,0,0,17.8,93,11.2,1019.8,Rain
9/6/2022 12:00,28,461,30835,629993,489,660828,TUESDAY,0,0,17.8,93,11.2,1019.8,Rain
9/6/2022 13:00,51,571,54562,2304989,622,2359551,TUESDAY,0,0,18.3,90,16.6,1020.1,Rain
9/6/2022 14:00,59,645,87262,1547349,704,1634611,TUESDAY,0,0,17.8,93,18.4,1020.3,Rain
9/6/2022 15:00,37,578,94060,439958,615,534018,TUESDAY,0,0,17.8,93,14.8,1020,Rain
9/6/2022 16:00,51,595,51153,462698,646,513851,TUESDAY,0,0,17.8,90,14.8,1020,Rain
9/6/2022 17:00,82,989,3106037,1388764,1071,4494801,TUESDAY,0,0,17.8,90,14.8,1020,Rain
9/6/2022 18:00,75,869,86239,791749,944,877988,TUESDAY,0,0,18.3,90,7.6,1019.3,Rain
9/6/2022 19:00,43,645,45742,672044,688,717786,TUESDAY,0,0,18.3,90,7.6,1019.3,Rain
9/6/2022 20:00,33,532,55834,960110,565,1015944,TUESDAY,0,0,18.3,97,20.5,1018.9,Rain
9/6/2022 21:00,38,481,406776,468051,519,874827,TUESDAY,0,0,18.3,97,24.1,1018.8,Cloudy
9/6/2022 22:00,33,371,41106,322104,404,363210,TUESDAY,0,0,17.8,96,20.5,1019.1,Cloudy
9/6/2022 23:00,20,204,19682,361296,224,380978,TUESDAY,0,0,17.8,96,18.4,1019.1,Cloudy
9/7/2022 0:00,9,88,9719,84062,97,93781,WEDNESDAY,0,0,17.8,96,22.3,1019.7,Rain
9/7/2022 1:00,8,46,7264,109844,54,117108,WEDNESDAY,0,0,17.8,96,22.3,1019.7,Rain
9/7/2022 2:00,6,19,9803,15953,25,25756,WEDNESDAY,0,0,17.8,96,22.3,1019.7,Cloudy
9/7/2022 3:00,1,11,1451,30803,12,32254,WEDNESDAY,0,0,17.8,93,20.5,1019.7,Cloudy
9/7/2022 4:00,3,22,3734,46631,25,50365,WEDNESDAY,0,0,17.8,93,20.5,1019.7,Cloudy
9/7/2022 5:00,7,120,4559,79739,127,84298,WEDNESDAY,0,0,17.2,97,22.3,1019.3,Cloudy
9/7/2022 6:00,28,417,26184,469629,445,495813,WEDNESDAY,0,0,17.2,90,18.4,1018.8,Cloudy
9/7/2022 7:00,58,1024,77075,1001521,1082,1078596,WEDNESDAY,0,0,17.2,87,22.3,1018.1,Cloudy
9/7/2022 8:00,92,1571,102566,1346219,1663,1448785,WEDNESDAY,0,0,16.1,90,16.6,1017.7,Cloudy
9/7/2022 9:00,59,1033,77761,815653,1092,893414,WEDNESDAY,0,0,15.6,96,16.6,1017.9,Cloudy
9/7/2022 10:00,73,734,142371,615820,807,758191,WEDNESDAY,0,0,16.1,93,14.8,1018.4,Cloudy
9/7/2022 11:00,83,854,203113,1044097,937,1247210,WEDNESDAY,0,0,17.8,87,16.6,1018.6,Cloudy
9/7/2022 12:00,92,1043,1658703,894112,1135,2552815,WEDNESDAY,0,0,17.8,87,16.6,1018.6,Cloudy
9/7/2022 13:00,116,987,200418,1255843,1103,1456261,WEDNESDAY,0,0,19.4,76,24.1,1018.1,Cloudy
9/7/2022 14:00,151,1101,2586361,1218689,1252,3805050,WEDNESDAY,0,0,20,70,20.5,1017.9,Cloudy
9/7/2022 15:00,194,1233,295621,1052273,1427,1347894,WEDNESDAY,0,0,21.1,66,22.3,1017.5,Cloudy
9/7/2022 16:00,215,1756,1092829,1946359,1971,3039188,WEDNESDAY,0,0,21.1,68,20.5,1017.6,Cloudy
9/7/2022 17:00,253,2352,407236,5474524,2605,5881760,WEDNESDAY,0,0,21.1,68,20.5,1017.6,Cloudy
9/7/2022 18:00,234,2035,398276,2411165,2269,2809441,WEDNESDAY,0,0,21.7,63,20.5,1016.6,Cloudy
9/7/2022 19:00,136,1432,203858,1499300,1568,1703158,WEDNESDAY,0,0,20.6,70,22.3,1016.3,Cloudy
9/7/2022 20:00,88,1004,143750,1384261,1092,1528011,WEDNESDAY,0,0,20.6,73,24.1,1016.1,Cloudy
9/7/2022 21:00,78,738,118612,763585,816,882197,WEDNESDAY,0,0,20.6,73,24.1,1016.1,Cloudy
9/7/2022 22:00,46,436,87663,492773,482,580436,WEDNESDAY,0,0,19.4,76,20.5,1016,Cloudy
9/7/2022 23:00,46,264,116273,307797,310,424070,WEDNESDAY,0,0,18.3,84,16.6,1016.1,Cloudy
9/8/2022 0:00,30,142,41582,148363,172,189945,THURSDAY,0,0,18.3,84,16.6,1016.1,Cloudy
9/8/2022 1:00,11,100,14736,167645,111,182381,THURSDAY,0,0,17.8,84,14.8,1016.3,Cloudy
9/8/2022 2:00,5,43,61750,33014,48,94764,THURSDAY,0,0,17.2,90,11.2,1015.9,Cloudy
9/8/2022 3:00,3,19,3660,34067,22,37727,THURSDAY,0,0,16.7,93,9.4,1015.2,Cloudy
9/8/2022 4:00,1,20,600,83245,21,83845,THURSDAY,0,0,16.7,93,9.4,1015.2,Cloudy
9/8/2022 5:00,7,130,6615,89967,137,96582,THURSDAY,0,0,16.1,93,9.4,1014.8,Cloudy
9/8/2022 6:00,22,408,19106,315793,430,334899,THURSDAY,0,0,16.1,90,9.4,1014.6,Cloudy
9/8/2022 7:00,72,1028,62553,902516,1100,965069,THURSDAY,0,0,16.1,90,9.4,1014.6,Cloudy
9/8/2022 8:00,107,1619,838335,1425134,1726,2263469,THURSDAY,0,0,15,96,11.2,1014.5,Cloudy
9/8/2022 9:00,78,1002,101939,874676,1080,976615,THURSDAY,0,0,15,93,11.2,1014.3,Cloudy
9/8/2022 10:00,94,826,159994,674721,920,834715,THURSDAY,0,0,15,93,11.2,1014.6,Cloudy
9/8/2022 11:00,85,817,1066776,713829,902,1780605,THURSDAY,0,0,17.2,84,14.8,1014.7,Cloudy
9/8/2022 12:00,132,1034,236524,963807,1166,1200331,THURSDAY,0,0,17.2,84,14.8,1014.7,Cloudy
9/8/2022 13:00,138,961,460898,848625,1099,1309523,THURSDAY,0,0,20,70,16.6,1014.3,Cloudy
9/8/2022 14:00,144,1136,245329,2105883,1280,2351212,THURSDAY,0,0,21.1,64,14.8,1014.4,Cloudy
9/8/2022 15:00,226,1368,337118,1268141,1594,1605259,THURSDAY,0,0,21.1,66,18.4,1014,Cloudy
9/8/2022 16:00,228,1651,1537657,1664984,1879,3202641,THURSDAY,0,0,21.1,66,18.4,1014,Fair
9/8/2022 17:00,298,2222,527909,2462770,2520,2990679,THURSDAY,0,0,21.1,68,22.3,1014,Fair
9/8/2022 18:00,302,1933,656337,2411011,2235,3067348,THURSDAY,0,0,21.1,68,22.3,1013.8,Fair
9/8/2022 19:00,204,1513,308431,1528911,1717,1837342,THURSDAY,0,0,20.6,70,24.1,1013.5,Fair
9/8/2022 20:00,115,1024,137768,929035,1139,1066803,THURSDAY,0,0,20,70,20.5,1013.2,Fair
9/8/2022 21:00,81,727,459033,2550868,808,3009901,THURSDAY,0,0,20,70,20.5,1013.2,Fair
9/8/2022 22:00,100,545,147808,1316907,645,1464715,THURSDAY,0,0,19.4,71,18.4,1013.2,Fair
9/8/2022 23:00,97,412,1716779,464073,509,2180852,THURSDAY,0,0,17.8,78,11.2,1014.1,Fair
9/9/2022 0:00,40,207,91251,341399,247,432650,FRIDAY,0,0,17.8,78,11.2,1014.1,Fair
9/9/2022 1:00,26,74,98667,71944,100,170611,FRIDAY,0,0,17.2,78,13,1014.5,Fair
9/9/2022 2:00,22,56,1687309,65094,78,1752403,FRIDAY,0,0,16.7,80,11.2,1014.6,Fair
9/9/2022 3:00,3,30,4431,41671,33,46102,FRIDAY,0,0,16.7,84,11.2,1015,Clear
9/9/2022 4:00,5,23,2741,16393,28,19134,FRIDAY,0,0,16.7,84,11.2,1015,Clear
9/9/2022 5:00,9,101,11606,82001,110,93607,FRIDAY,0,0,16.1,90,11.2,1015.4,Fair
9/9/2022 6:00,19,337,19285,264174,356,283459,FRIDAY,0,0,16.1,90,11.2,1015.4,Clear
9/9/2022 7:00,51,794,85540,707750,845,793290,FRIDAY,0,0,16.1,90,11.2,1015.5,Clear
9/9/2022 8:00,64,1272,89977,1913349,1336,2003326,FRIDAY,0,0,15,90,11.2,1016.1,Clear
9/9/2022 9:00,81,907,117052,736674,988,853726,FRIDAY,0,0,15,90,11.2,1016.7,Clear
9/9/2022 10:00,79,760,1125733,643256,839,1768989,FRIDAY,0,0,15,90,11.2,1017.2,Clear
9/9/2022 11:00,140,1032,252311,923508,1172,1175819,FRIDAY,0,0,16.1,87,7.6,1017.7,Fair
9/9/2022 12:00,147,1215,1057660,1019951,1362,2077611,FRIDAY,0,0,16.1,87,7.6,1017.7,Fair
9/9/2022 13:00,153,1225,300186,1487510,1378,1787696,FRIDAY,0,0,19.4,79,0,1018.6,Fair
9/9/2022 14:00,197,1353,397528,1294940,1550,1692468,FRIDAY,0,0,20,78,11.2,1018.7,Fair
9/9/2022 15:00,244,1575,518464,1712827,1819,2231291,FRIDAY,0,0,20.6,75,13,1018.6,Fair
9/9/2022 16:00,262,1820,3058014,1752176,2082,4810190,FRIDAY,0,0,20.6,75,13,1018.6,Fair
9/9/2022 17:00,328,2144,1131849,3213266,2472,4345115,FRIDAY,0,0,22.2,59,14.8,1018.2,Fair
9/9/2022 18:00,291,1997,1825668,2445030,2288,4270698,FRIDAY,0,0,22.8,59,13,1018,Fair
9/9/2022 19:00,192,1667,304912,1777641,1859,2082553,FRIDAY,0,0,23.3,52,11.2,1017.7,Fair
9/9/2022 20:00,172,1143,887215,1319983,1315,2207198,FRIDAY,0,0,22.8,59,9.4,1017.8,Fair
9/9/2022 21:00,147,1030,168725,2113023,1177,2281748,FRIDAY,0,0,22.8,59,9.4,1017.8,Fair
9/9/2022 22:00,164,874,911697,1651041,1038,2562738,FRIDAY,0,0,21.7,68,11.2,1018.2,Fair
9/9/2022 23:00,117,642,163986,1379427,759,1543413,FRIDAY,0,0,21.1,73,0,1018.4,Fair
9/10/2022 0:00,150,471,331584,2113176,621,2444760,SATURDAY,1,0,20.6,81,0,1018.6,Fair
9/10/2022 1:00,104,417,189185,513045,521,702230,SATURDAY,1,0,20.6,78,0,1019.4,Fair
9/10/2022 2:00,58,208,587425,423617,266,1011042,SATURDAY,1,0,20.6,78,5.4,1019.6,Fair
9/10/2022 3:00,9,83,13647,574157,92,587804,SATURDAY,1,0,21.1,66,7.6,1020.2,Clear
9/10/2022 4:00,7,18,7994,17569,25,25563,SATURDAY,1,0,21.7,63,14.8,1020.2,Clear
9/10/2022 5:00,9,46,18510,54008,55,72518,SATURDAY,1,0,21.7,63,14.8,1020.2,Clear
9/10/2022 6:00,19,128,14607,119952,147,134559,SATURDAY,1,0,20.6,68,14.8,1020.5,Clear
9/10/2022 7:00,26,295,62910,270230,321,333140,SATURDAY,1,0,19.4,73,9.4,1021,Clear
9/10/2022 8:00,66,531,112024,545331,597,657355,SATURDAY,1,0,19.4,73,9.4,1021,Clear
9/10/2022 9:00,147,812,353134,899895,959,1253029,SATURDAY,1,0,19.4,73,13,1021.4,Clear
9/10/2022 10:00,185,1046,455845,1152748,1231,1608593,SATURDAY,1,0,19.4,73,11.2,1021.9,Clear
9/10/2022 11:00,245,1317,561925,1474679,1562,2036604,SATURDAY,1,0,20,73,11.2,1022.5,Fair
9/10/2022 12:00,263,1398,2636584,1535342,1661,4171926,SATURDAY,1,0,20,73,11.2,1022.5,Fair
9/10/2022 13:00,329,1496,2234407,1636151,1825,3870558,SATURDAY,1,0,25.6,52,9.4,1023.2,Fair
9/10/2022 14:00,379,1538,1002016,1855372,1917,2857388,SATURDAY,1,0,25,58,7.6,1023.2,Fair
9/10/2022 15:00,350,1691,654592,2483106,2041,3137698,SATURDAY,1,0,26.1,54,11.2,1022.8,Rain
9/10/2022 16:00,356,1769,595338,2065038,2125,2660376,SATURDAY,1,0,26.1,54,11.2,1022.8,Fair
9/10/2022 17:00,356,1745,3313651,2107381,2101,5421032,SATURDAY,1,0,25,58,14.8,1022.6,Fair
9/10/2022 18:00,361,1665,727277,2463627,2026,3190904,SATURDAY,1,0,26.1,52,16.6,1022.1,Fair
9/10/2022 19:00,243,1426,524866,1991288,1669,2516154,SATURDAY,1,0,25.6,52,16.6,1021.8,Fair
9/10/2022 20:00,179,1117,503655,1223658,1296,1727313,SATURDAY,1,0,25,54,13,1021.5,Fair
9/10/2022 21:00,139,1002,216470,1561717,1141,1778187,SATURDAY,1,0,25,54,13,1021.5,Fair
9/10/2022 22:00,276,942,797607,1232211,1218,2029818,SATURDAY,1,0,22.8,64,14.8,1021.5,Fair
9/10/2022 23:00,275,769,710751,866526,1044,1577277,SATURDAY,1,0,21.7,76,7.6,1021.6,Fair
9/11/2022 0:00,174,620,2376985,656404,794,3033389,SUNDAY,1,0,21.1,78,5.4,1021.6,Fair
9/11/2022 1:00,123,426,292682,2332153,549,2624835,SUNDAY,1,0,21.1,82,0,1021.9,Fair
9/11/2022 2:00,62,255,311762,323403,317,635165,SUNDAY,1,0,22.2,73,7.6,1021.9,Fair
9/11/2022 3:00,17,66,116749,156078,83,272827,SUNDAY,1,0,22.2,73,7.6,1021.6,Fair
9/11/2022 4:00,5,34,15101,36117,39,51218,SUNDAY,1,0,22.2,73,0,1021.7,Fair
9/11/2022 5:00,7,28,9017,36190,35,45207,SUNDAY,1,0,22.2,73,0,1021.7,Cloudy
9/11/2022 6:00,6,82,6098,63642,88,69740,SUNDAY,1,0,21.1,82,0,1021.3,Fair
9/11/2022 7:00,26,195,56852,188492,221,245344,SUNDAY,1,0,22.2,71,5.4,1020.8,Fair
9/11/2022 8:00,52,395,132464,401979,447,534443,SUNDAY,1,0,21.7,71,11.2,1020.7,Fair
9/11/2022 9:00,110,672,357325,726470,782,1083795,SUNDAY,1,0,21.7,71,13,1020.5,Fair
9/11/2022 10:00,187,1004,2125154,963454,1191,3088608,SUNDAY,1,0,21.7,71,13,1020.8,Cloudy
9/11/2022 11:00,234,1259,391170,1297596,1493,1688766,SUNDAY,1,0,21.7,71,13,1020.8,Cloudy
9/11/2022 12:00,199,1177,302801,1114354,1376,1417155,SUNDAY,1,0,23.3,62,9.4,1020.2,Cloudy
9/11/2022 13:00,151,864,284141,1661783,1015,1945924,SUNDAY,1,0,25.6,52,5.4,1019.9,Cloudy
9/11/2022 14:00,162,1130,363387,1109453,1292,1472840,SUNDAY,1,0,26.7,51,7.6,1019.7,Cloudy
9/11/2022 15:00,265,1300,2836829,1677675,1565,4514504,SUNDAY,1,0,25.6,58,7.6,1019.3,Cloudy
9/11/2022 16:00,256,1503,414954,6132485,1759,6547439,SUNDAY,1,0,25.6,58,7.6,1019.3,Cloudy
9/11/2022 17:00,230,1407,3093542,3134718,1637,6228260,SUNDAY,1,0,23.9,66,13,1018.8,Cloudy
9/11/2022 18:00,176,1302,880524,2027423,1478,2907947,SUNDAY,1,0,25,58,13,1018.2,Cloudy
9/11/2022 19:00,154,1111,243142,1093723,1265,1336865,SUNDAY,1,0,24.4,58,9.4,1017.5,Cloudy
9/11/2022 20:00,101,830,190650,845336,931,1035986,SUNDAY,1,0,24.4,58,9.4,1017.5,Cloudy
9/11/2022 21:00,71,653,161730,616934,724,778664,SUNDAY,1,0,23.9,58,18.4,1016.9,Cloudy
9/11/2022 22:00,58,445,101968,697788,503,799756,SUNDAY,1,0,23.9,50,13,1016.6,Cloudy
9/11/2022 23:00,43,318,516523,380552,361,897075,SUNDAY,1,0,23.9,50,13,1016.6,Cloudy
9/12/2022 0:00,13,130,9761,113310,143,123071,MONDAY,0,0,22.8,64,16.6,1016.6,Cloudy
9/12/2022 1:00,6,79,7011,58748,85,65759,MONDAY,0,0,22.8,59,13,1016.4,Cloudy
9/12/2022 2:00,4,22,5758,26032,26,31790,MONDAY,0,0,21.7,63,14.8,1015.7,Cloudy
9/12/2022 3:00,3,6,3195,4570,9,7765,MONDAY,0,0,21.1,66,18.4,1015.5,Cloudy
9/12/2022 4:00,1,20,956,21746,21,22702,MONDAY,0,0,21.1,66,18.4,1015.5,Cloudy
9/12/2022 5:00,5,111,42052,82433,116,124485,MONDAY,0,0,20,78,13,1014.3,Cloudy
9/12/2022 6:00,20,342,47743,282467,362,330210,MONDAY,0,0,20,78,13,1014.3,Cloudy
9/12/2022 7:00,47,930,42714,720731,977,763445,MONDAY,0,0,18.9,90,16.6,1013,Cloudy
9/12/2022 8:00,104,1473,147569,1235674,1577,1383243,MONDAY,0,0,18.9,90,16.6,1013,Cloudy
9/12/2022 9:00,74,906,132776,722637,980,855413,MONDAY,0,0,18.9,93,13,1012.7,Cloudy
9/12/2022 10:00,75,751,129745,632586,826,762331,MONDAY,0,0,18.9,93,9.4,1012.5,Cloudy
9/12/2022 11:00,115,867,238473,2163770,982,2402243,MONDAY,0,0,19.4,93,9.4,1012.2,Cloudy
9/12/2022 12:00,84,1020,135693,2241517,1104,2377210,MONDAY,0,0,20.6,87,11.2,1011.6,Cloudy
9/12/2022 13:00,129,964,281916,770048,1093,1051964,MONDAY,0,0,22.2,79,14.8,1011.6,Cloudy
9/12/2022 14:00,152,1166,207456,1107686,1318,1315142,MONDAY,0,0,21.7,84,9.4,1011.5,Cloudy
9/12/2022 15:00,161,1271,337641,1305938,1432,1643579,MONDAY,0,0,22.8,81,11.2,1011.1,Cloudy
9/12/2022 16:00,189,1708,405636,1851109,1897,2256745,MONDAY,0,0,22.8,81,11.2,1011.1,Cloudy
9/12/2022 17:00,230,2254,1366039,2249380,2484,3615419,MONDAY,0,0,23.3,79,14.8,1010.1,Cloudy
9/12/2022 18:00,198,2057,998570,2233941,2255,3232511,MONDAY,0,0,23.9,76,13,1009.5,Cloudy
9/12/2022 19:00,126,1476,252699,1755683,1602,2008382,MONDAY,0,0,23.9,79,13,1009,Cloudy
9/12/2022 20:00,96,957,159227,1523277,1053,1682504,MONDAY,0,0,23.9,79,13,1009,Cloudy
9/12/2022 21:00,58,696,162593,625608,754,788201,MONDAY,0,0,22.8,81,13,1008.9,Cloudy
9/12/2022 22:00,44,469,132776,1789695,513,1922471,MONDAY,0,0,22.8,84,9.4,1008.7,Cloudy
9/12/2022 23:00,11,265,12813,268093,276,280906,MONDAY,0,0,21.1,90,9.4,1009.1,Cloudy
9/13/2022 0:00,25,127,49200,123031,152,172231,TUESDAY,0,0,21.1,90,9.4,1009.1,Cloudy
9/13/2022 1:00,11,60,23627,73596,71,97223,TUESDAY,0,0,21.7,90,7.6,1009.4,Cloudy
9/13/2022 2:00,6,36,8555,50411,42,58966,TUESDAY,0,0,21.1,93,7.6,1009.3,Cloudy
9/13/2022 3:00,4,19,7201,14662,23,21863,TUESDAY,0,0,20.6,96,7.6,1009.5,Cloudy
9/13/2022 4:00,3,25,8614,49519,28,58133,TUESDAY,0,0,20.6,96,11.2,1009.7,Cloudy
9/13/2022 5:00,6,131,5323,102193,137,107516,TUESDAY,0,0,19.4,100,7.6,1009.5,Cloudy
9/13/2022 6:00,28,399,45177,314140,427,359317,TUESDAY,0,0,19.4,100,5.4,1009.5,Cloudy
9/13/2022 7:00,53,1109,49290,969085,1162,1018375,TUESDAY,0,0,19.4,100,7.6,1008.8,Cloudy
9/13/2022 8:00,62,1095,1627681,830450,1157,2458131,TUESDAY,0,0,19.4,100,7.6,1008.8,Cloudy
9/13/2022 9:00,29,374,942535,305737,403,1248272,TUESDAY,0,0,19.4,100,9.4,1008.7,Cloudy
9/13/2022 10:00,18,313,26488,232862,331,259350,TUESDAY,0,0,20,100,5.4,1010,Cloudy
9/13/2022 11:00,44,468,46329,309007,512,355336,TUESDAY,0,0,20,100,11.2,1009.5,Cloudy
9/13/2022 12:00,68,825,382278,1560971,893,1943249,TUESDAY,0,0,20,100,11.2,1009.5,Cloudy
9/13/2022 13:00,93,886,141858,714979,979,856837,TUESDAY,0,0,20.6,100,7.6,1009.4,Cloudy
9/13/2022 14:00,96,945,1201511,1883474,1041,3084985,TUESDAY,0,0,20.6,96,11.2,1010,Cloudy
9/13/2022 15:00,127,1257,1378793,1742683,1384,3121476,TUESDAY,0,0,20.6,100,14.8,1009.2,Cloudy
9/13/2022 16:00,154,1616,405895,3427503,1770,3833398,TUESDAY,0,0,20.6,100,14.8,1009.2,Cloudy
9/13/2022 17:00,206,2173,806135,2114786,2379,2920921,TUESDAY,0,0,21.7,94,13,1008.7,Cloudy
9/13/2022 18:00,189,1705,263013,1964308,1894,2227321,TUESDAY,0,0,21.7,94,13,1008.7,Cloudy
9/13/2022 19:00,114,1261,216154,2276939,1375,2493093,TUESDAY,0,0,22.2,91,13,1007.2,Cloudy
9/13/2022 20:00,72,952,81903,2442935,1024,2524838,TUESDAY,0,0,22.2,91,13,1007.2,Cloudy
9/13/2022 21:00,59,664,748756,649773,723,1398529,TUESDAY,0,0,22.8,84,11.2,1006.4,Rain
9/13/2022 22:00,72,481,99167,478347,553,577514,TUESDAY,0,0,21.7,90,9.4,1006.4,Rain
9/13/2022 23:00,43,315,102953,1119876,358,1222829,TUESDAY,0,0,22.2,94,14.8,1006.2,Cloudy
9/14/2022 0:00,16,126,50664,112845,142,163509,WEDNESDAY,0,0,22.2,94,14.8,1006.2,Cloudy
9/14/2022 1:00,12,62,14671,224132,74,238803,WEDNESDAY,0,0,22.8,90,9.4,1006.7,Cloudy
9/14/2022 2:00,7,29,9152,28062,36,37214,WEDNESDAY,0,0,22.2,97,13,1006,Cloudy
9/14/2022 3:00,1,8,949,26088,9,27037,WEDNESDAY,0,0,21.7,84,18.4,1006.1,Cloudy
9/14/2022 4:00,2,17,3406,10900,19,14306,WEDNESDAY,0,0,21.7,84,18.4,1006.1,Fair
9/14/2022 5:00,14,132,13593,98487,146,112080,WEDNESDAY,0,0,20.6,84,20.5,1006.3,Fair
9/14/2022 6:00,24,376,17481,309594,400,327075,WEDNESDAY,0,0,20.6,84,20.5,1006.3,Fair
9/14/2022 7:00,61,1120,61398,922076,1181,983474,WEDNESDAY,0,0,18.3,73,20.5,1007.4,Fair
9/14/2022 8:00,112,1637,137213,1413011,1749,1550224,WEDNESDAY,0,0,17.8,75,22.3,1007.6,Clear
9/14/2022 9:00,75,1098,216435,851149,1173,1067584,WEDNESDAY,0,0,17.2,78,24.1,1007.9,Clear
9/14/2022 10:00,66,762,407797,656788,828,1064585,WEDNESDAY,0,0,17.2,78,24.1,1007.9,Clear
9/14/2022 11:00,77,933,124668,733559,1010,858227,WEDNESDAY,0,0,18.3,73,22.3,1009.1,Fair
9/14/2022 12:00,102,1066,196481,969807,1168,1166288,WEDNESDAY,0,0,20,63,20.5,1009.4,Fair
9/14/2022 13:00,117,1044,233995,902298,1161,1136293,WEDNESDAY,0,0,21.7,59,18.4,1009.6,Fair
9/14/2022 14:00,153,1229,1039857,2626441,1382,3666298,WEDNESDAY,0,0,22.8,57,29.5,1009.8,Fair
9/14/2022 15:00,167,1373,343804,1868814,1540,2212618,WEDNESDAY,0,0,22.8,57,29.5,1009.8,Fair
9/14/2022 16:00,242,1906,1132536,1969509,2148,3102045,WEDNESDAY,0,0,24.4,56,25.9,1010,Fair
9/14/2022 17:00,315,2429,551446,3216926,2744,3768372,WEDNESDAY,0,0,25.6,50,24.1,1010.1,Fair
9/14/2022 18:00,319,2179,740196,2804408,2498,3544604,WEDNESDAY,0,0,26.7,45,16.6,1010.2,Fair
9/14/2022 19:00,180,1645,483911,1662516,1825,2146427,WEDNESDAY,0,0,26.1,47,25.9,1010.4,Fair
9/14/2022 20:00,106,1140,191330,1091543,1246,1282873,WEDNESDAY,0,0,26.1,47,25.9,1010.4,Fair
9/14/2022 21:00,74,967,133115,909076,1041,1042191,WEDNESDAY,0,0,25.6,45,20.5,1011.1,Fair
9/14/2022 22:00,90,646,105043,620687,736,725730,WEDNESDAY,0,0,25.6,45,20.5,1011.1,Fair
9/14/2022 23:00,80,381,202386,421015,461,623401,WEDNESDAY,0,0,24.4,50,16.6,1011.6,Fair
9/15/2022 0:00,25,181,39960,184082,206,224042,THURSDAY,0,0,23.3,56,13,1012.1,Fair
9/15/2022 1:00,14,72,102362,63700,86,166062,THURSDAY,0,0,22.2,61,14.8,1013.1,Fair
9/15/2022 2:00,2,38,3243,34384,40,37627,THURSDAY,0,0,22.2,61,14.8,1013.1,Fair
9/15/2022 3:00,1,20,1792,35316,21,37108,THURSDAY,0,0,20.6,70,13,1013.5,Fair
9/15/2022 4:00,2,16,2356,25576,18,27932,THURSDAY,0,0,20.6,70,13,1013.5,Fair
9/15/2022 5:00,7,112,7889,81803,119,89692,THURSDAY,0,0,20,70,14.8,1013.5,Fair
9/15/2022 6:00,26,385,17139,1190627,411,1207766,THURSDAY,0,0,19.4,71,18.4,1014.4,Fair
9/15/2022 7:00,75,1034,74431,837864,1109,912295,THURSDAY,0,0,18.9,68,20.5,1015.1,Fair
9/15/2022 8:00,99,1639,513576,1320380,1738,1833956,THURSDAY,0,0,18.3,58,20.5,1016.2,Clear
9/15/2022 9:00,76,1008,117810,779883,1084,897693,THURSDAY,0,0,16.7,60,29.5,1016.8,Clear
9/15/2022 10:00,71,809,177085,643599,880,820684,THURSDAY,0,0,16.7,60,29.5,1016.8,Rain
9/15/2022 11:00,97,800,152697,897426,897,1050123,THURSDAY,0,0,15.6,49,29.5,1018.9,Fair
9/15/2022 12:00,106,1066,212987,1964228,1172,2177215,THURSDAY,0,0,16.1,46,24.1,1019,Fair
9/15/2022 13:00,102,1023,191127,852391,1125,1043518,THURSDAY,0,0,17.2,43,24.1,1019.1,Fair
9/15/2022 14:00,153,1164,248283,1878314,1317,2126597,THURSDAY,0,0,18.9,38,22.3,1018.8,Fair
9/15/2022 15:00,187,1401,303775,1703788,1588,2007563,THURSDAY,0,0,19.4,37,22.3,1018.8,Rain
9/15/2022 16:00,210,1861,349265,3708846,2071,4058111,THURSDAY,0,0,19.4,37,25.9,1018.8,Fair
9/15/2022 17:00,278,2434,607791,3040555,2712,3648346,THURSDAY,0,0,21.7,30,22.3,1018.4,Fair
9/15/2022 18:00,259,2030,327179,1847961,2289,2175140,THURSDAY,0,0,21.7,30,25.9,1018,Fair
9/15/2022 19:00,195,1512,519693,1383364,1707,1903057,THURSDAY,0,0,21.7,30,29.5,1018,Fair
9/15/2022 20:00,101,1033,165159,820328,1134,985487,THURSDAY,0,0,21.7,30,31.7,1017.2,Fair
9/15/2022 21:00,65,808,80575,674045,873,754620,THURSDAY,0,0,19.4,34,25.9,1018.5,Fair
9/15/2022 22:00,49,589,50747,500594,638,551341,THURSDAY,0,0,19.4,34,29.5,1018.5,Fair
9/15/2022 23:00,45,357,43396,561544,402,604940,THURSDAY,0,0,18.9,33,24.1,1018.8,Fair
9/16/2022 0:00,19,212,56586,864079,231,920665,FRIDAY,0,0,17.2,35,13,1020.4,Fair
9/16/2022 1:00,14,104,12876,143089,118,155965,FRIDAY,0,0,17.2,35,13,1020.4,Fair
9/16/2022 2:00,6,49,11774,37000,55,48774,FRIDAY,0,0,15.6,39,16.6,1021,Fair
9/16/2022 3:00,2,15,40099,10743,17,50842,FRIDAY,0,0,15.6,39,16.6,1021,Clear
9/16/2022 4:00,4,29,3717,66573,33,70290,FRIDAY,0,0,15,42,13,1021.2,Fair
9/16/2022 5:00,11,110,9301,72067,121,81368,FRIDAY,0,0,14.4,47,9.4,1020.9,Clear
9/16/2022 6:00,28,304,24129,225580,332,249709,FRIDAY,0,0,13.9,47,16.6,1020.5,Clear
9/16/2022 7:00,50,797,127472,655283,847,782755,FRIDAY,0,0,13.3,47,16.6,1020.5,Clear
9/16/2022 8:00,83,1247,115617,1081210,1330,1196827,FRIDAY,0,0,13.3,49,20.5,1020.6,Clear
9/16/2022 9:00,81,862,115366,705093,943,820459,FRIDAY,0,0,12.8,51,16.6,1020.5,Clear
9/16/2022 10:00,95,839,209607,712854,934,922461,FRIDAY,0,0,12.8,51,16.6,1020.5,Rain
9/16/2022 11:00,145,946,297256,768084,1091,1065340,FRIDAY,0,0,14.4,49,16.6,1021.1,Fair
9/16/2022 12:00,142,1040,234081,872198,1182,1106279,FRIDAY,0,0,15.6,47,24.1,1020.9,Fair
9/16/2022 13:00,171,1254,1988394,1088016,1425,3076410,FRIDAY,0,0,17.8,41,20.5,1021.1,Fair
9/16/2022 14:00,193,1383,336106,3330564,1576,3666670,FRIDAY,0,0,17.2,43,18.4,1021.3,Fair
9/16/2022 15:00,226,1629,474223,1586978,1855,2061201,FRIDAY,0,0,17.2,43,18.4,1021.3,Rain
9/16/2022 16:00,311,1949,492504,2827586,2260,3320090,FRIDAY,0,0,20,35,16.6,1020.2,Fair
9/16/2022 17:00,276,2274,2082083,3820213,2550,5902296,FRIDAY,0,0,20.6,36,14.8,1019.6,Fair
9/16/2022 18:00,308,2027,702386,2504588,2335,3206974,FRIDAY,0,0,21.1,38,9.4,1019,Fair
9/16/2022 19:00,207,1452,335987,1852041,1659,2188028,FRIDAY,0,0,21.1,38,9.4,1019,Fair
9/16/2022 20:00,139,1092,253624,1348377,1231,1602001,FRIDAY,0,0,22.2,38,14.8,1019,Fair
9/16/2022 21:00,144,971,257395,896966,1115,1154361,FRIDAY,0,0,21.7,39,13,1019.3,Fair
9/16/2022 22:00,159,806,255671,1668092,965,1923763,FRIDAY,0,0,21.7,39,13,1019.3,Fair
9/16/2022 23:00,100,620,196970,694622,720,891592,FRIDAY,0,0,20.6,42,16.6,1020,Fair
9/17/2022 0:00,98,552,1437155,1060251,650,2497406,SATURDAY,1,0,19.4,44,20.5,1020.8,Fair
9/17/2022 1:00,88,405,166749,469398,493,636147,SATURDAY,1,0,18.3,47,20.5,1021.5,Fair
9/17/2022 2:00,44,195,55568,197417,239,252985,SATURDAY,1,0,16.7,52,16.6,1022.5,Fair
9/17/2022 3:00,11,80,10463,84681,91,95144,SATURDAY,1,0,15.6,53,14.8,1023,Fair
9/17/2022 4:00,3,33,27237,48603,36,75840,SATURDAY,1,0,14.4,60,11.2,1023.4,Fair
9/17/2022 5:00,1,48,772,43053,49,43825,SATURDAY,1,0,14.4,60,11.2,1023.4,Clear
9/17/2022 6:00,10,118,17244,94239,128,111483,SATURDAY,1,0,13.3,62,11.2,1024.3,Clear
9/17/2022 7:00,23,235,36855,225436,258,262291,SATURDAY,1,0,12.8,62,13,1024.4,Clear
9/17/2022 8:00,60,496,108310,432108,556,540418,SATURDAY,1,0,12.2,64,13,1024.6,Clear
9/17/2022 9:00,107,818,218943,2124484,925,2343427,SATURDAY,1,0,11.7,69,11.2,1025.3,Clear
9/17/2022 10:00,204,1038,487969,1094694,1242,1582663,SATURDAY,1,0,11.7,69,11.2,1025.3,Clear
9/17/2022 11:00,275,1309,549995,1396734,1584,1946729,SATURDAY,1,0,13.9,59,11.2,1025.8,Fair
9/17/2022 12:00,330,1484,674499,3231874,1814,3906373,SATURDAY,1,0,16.1,48,11.2,1026,Fair
9/17/2022 13:00,315,1560,708760,4028958,1875,4737718,SATURDAY,1,0,16.7,44,14.8,1026.4,Fair
9/17/2022 14:00,404,1680,2290041,2199772,2084,4489813,SATURDAY,1,0,16.7,44,14.8,1026.4,Fair
9/17/2022 15:00,482,1825,1686336,2428333,2307,4114669,SATURDAY,1,0,17.2,38,11.2,1026.1,Rain
9/17/2022 16:00,359,1807,789000,2015950,2166,2804950,SATURDAY,1,0,17.2,46,13,1025.7,Fair
9/17/2022 17:00,329,1830,577211,2517481,2159,3094692,SATURDAY,1,0,17.8,41,14.8,1024.7,Fair
9/17/2022 18:00,341,1848,765015,2112423,2189,2877438,SATURDAY,1,0,18.3,39,14.8,1023.9,Fair
9/17/2022 19:00,226,1519,357676,2769438,1745,3127114,SATURDAY,1,0,18.3,39,14.8,1023.9,Fair
9/17/2022 20:00,197,1117,554675,1124682,1314,1679357,SATURDAY,1,0,17.8,52,22.3,1022.8,Fair
9/17/2022 21:00,151,914,875996,1938100,1065,2814096,SATURDAY,1,0,17.8,54,20.5,1022.3,Fair
9/17/2022 22:00,129,809,275977,695458,938,971435,SATURDAY,1,0,17.2,60,22.3,1022.1,Fair
9/17/2022 23:00,115,703,146847,643029,818,789876,SATURDAY,1,0,17.2,60,22.3,1022.1,Fair
9/18/2022 0:00,124,502,308225,510860,626,819085,SUNDAY,1,0,17.2,65,18.4,1022.1,Fair
9/18/2022 1:00,94,373,160300,545482,467,705782,SUNDAY,1,0,17.2,65,18.4,1022.1,Fair
9/18/2022 2:00,46,194,117420,188094,240,305514,SUNDAY,1,0,16.7,70,16.6,1021.4,Fair
9/18/2022 3:00,10,59,9590,61447,69,71037,SUNDAY,1,0,16.7,70,16.6,1021.4,Fair
9/18/2022 4:00,1,39,1220,55056,40,56276,SUNDAY,1,0,16.1,75,16.6,1020.9,Fair
9/18/2022 5:00,12,49,22725,34972,61,57697,SUNDAY,1,0,16.1,81,16.6,1020.5,Fair
9/18/2022 6:00,7,104,8651,80520,111,89171,SUNDAY,1,0,16.1,84,18.4,1018.8,Fair
9/18/2022 7:00,30,176,50079,155158,206,205237,SUNDAY,1,0,16.1,90,16.6,1018.4,Fair
9/18/2022 8:00,73,436,178413,383194,509,561607,SUNDAY,1,0,17.2,90,27.7,1017.8,Fair
9/18/2022 9:00,100,678,192156,618398,778,810554,SUNDAY,1,0,17.2,90,27.7,1017.8,Fair
9/18/2022 10:00,173,1092,390188,1146030,1265,1536218,SUNDAY,1,0,17.2,93,22.3,1017,Fair
9/18/2022 11:00,288,1184,647121,1284438,1472,1931559,SUNDAY,1,0,17.2,93,22.3,1017,Fair
9/18/2022 12:00,322,1531,610106,2652321,1853,3262427,SUNDAY,1,0,20,78,25.9,1016.5,Fair
9/18/2022 13:00,307,1466,613561,1609774,1773,2223335,SUNDAY,1,0,22.2,68,25.9,1016.4,Fair
9/18/2022 14:00,312,1458,751408,1641504,1770,2392912,SUNDAY,1,0,22.2,68,27.7,1016.4,Fair
9/18/2022 15:00,316,1461,643942,2391610,1777,3035552,SUNDAY,1,0,26.1,56,18.4,1014.7,Rain
9/18/2022 16:00,355,1766,908617,2278846,2121,3187463,SUNDAY,1,0,27.2,53,18.4,1014.4,Cloudy
9/18/2022 17:00,320,1740,544754,2220199,2060,2764953,SUNDAY,1,0,28.3,46,27.7,1013.7,Cloudy
9/18/2022 18:00,299,1555,659959,2856942,1854,3516901,SUNDAY,1,0,28.9,48,25.9,1013.2,Cloudy
9/18/2022 19:00,154,1254,204306,2565599,1408,2769905,SUNDAY,1,0,28.9,48,25.9,1013.2,Cloudy
9/18/2022 20:00,75,754,241302,592412,829,833714,SUNDAY,1,0,28.9,48,18.4,1012.9,Cloudy
9/18/2022 21:00,43,505,53173,473912,548,527085,SUNDAY,1,0,28.3,48,24.1,1012.5,Cloudy
9/18/2022 22:00,59,449,278643,823826,508,1102469,SUNDAY,1,0,27.8,51,22.3,1012.6,Cloudy
9/18/2022 23:00,32,244,41864,194090,276,235954,SUNDAY,1,0,25,64,20.5,1012.7,Cloudy
9/19/2022 0:00,10,100,38469,72427,110,110896,MONDAY,0,0,25,64,20.5,1012.7,Cloudy
9/19/2022 1:00,14,48,13557,77648,62,91205,MONDAY,0,0,23.3,76,25.9,1013.2,Cloudy
9/19/2022 2:00,4,21,3981,15151,25,19132,MONDAY,0,0,22.2,82,20.5,1012.7,Cloudy
9/19/2022 3:00,3,22,1686,14060,25,15746,MONDAY,0,0,21.7,87,18.4,1012.7,Cloudy
9/19/2022 4:00,9,30,10930,21785,39,32715,MONDAY,0,0,21.7,87,18.4,1012.7,Cloudy
9/19/2022 5:00,12,109,10749,78912,121,89661,MONDAY,0,0,22.2,79,16.6,1012.3,Cloudy
9/19/2022 6:00,22,309,19634,223800,331,243434,MONDAY,0,0,17.8,93,16.6,1013.1,Cloudy
9/19/2022 7:00,71,804,104097,648663,875,752760,MONDAY,0,0,17.2,97,20.5,1013.5,Cloudy
9/19/2022 8:00,92,1239,103996,943730,1331,1047726,MONDAY,0,0,15.6,96,18.4,1013.7,Cloudy
9/19/2022 9:00,80,838,211135,782725,918,993860,MONDAY,0,0,15.6,96,18.4,1013.7,Cloudy
9/19/2022 10:00,86,646,151641,475708,732,627349,MONDAY,0,0,15,93,20.5,1015,Rain
9/19/2022 11:00,108,714,191404,548762,822,740166,MONDAY,0,0,15.6,86,13,1015.3,Cloudy
9/19/2022 12:00,88,854,158505,672328,942,830833,MONDAY,0,0,15.6,86,13,1015.3,Cloudy
9/19/2022 13:00,135,837,317062,614156,972,931218,MONDAY,0,0,16.1,87,14.8,1015.4,Cloudy
9/19/2022 14:00,140,962,238101,861649,1102,1099750,MONDAY,0,0,16.7,84,14.8,1015.4,Cloudy
9/19/2022 15:00,154,1098,231594,2198273,1252,2429867,MONDAY,0,0,16.7,84,14.8,1015.4,Cloudy
9/19/2022 16:00,188,1347,656458,1976949,1535,2633407,MONDAY,0,0,16.7,86,16.6,1014.4,Cloudy
9/19/2022 17:00,209,1690,971234,1440511,1899,2411745,MONDAY,0,0,16.7,86,16.6,1014.4,Rain
9/19/2022 18:00,146,1289,229114,1091675,1435,1320789,MONDAY,0,0,17.2,84,14.8,1014,Rain
9/19/2022 19:00,115,937,121091,856009,1052,977100,MONDAY,0,0,17.2,90,16.6,1012.3,Rain
9/19/2022 20:00,59,597,508475,499731,656,1008206,MONDAY,0,0,17.2,93,16.6,1011.7,Cloudy
9/19/2022 21:00,10,162,5508,242987,172,248495,MONDAY,0,0,17.2,97,13,1011.6,Cloudy
9/19/2022 22:00,22,187,27737,144635,209,172372,MONDAY,0,0,17.2,97,13,1011.6,Cloudy
9/19/2022 23:00,8,121,8969,738134,129,747103,MONDAY,0,0,17.8,96,14.8,1010.7,Cloudy
9/20/2022 0:00,7,76,6148,56094,83,62242,TUESDAY,0,0,18.3,100,7.6,1009.6,Rain
9/20/2022 1:00,5,47,3305,52315,52,55620,TUESDAY,0,0,18.3,100,5.4,1010,Rain
9/20/2022 2:00,4,21,3465,24616,25,28081,TUESDAY,0,0,18.9,93,22.3,1009.2,Rain
9/20/2022 3:00,1,12,2679,9884,13,12563,TUESDAY,0,0,17.2,93,5.4,1009.5,Rain
9/20/2022 4:00,6,14,10320,7324,20,17644,TUESDAY,0,0,17.2,93,22.3,1009.5,Rain
9/20/2022 5:00,13,98,23619,75887,111,99506,TUESDAY,0,0,15,96,14.8,1009.8,Rain
9/20/2022 6:00,34,309,30592,230176,343,260768,TUESDAY,0,0,15,93,13,1010,Rain
9/20/2022 7:00,90,932,130470,703858,1022,834328,TUESDAY,0,0,15,93,7.6,1009.8,Cloudy
9/20/2022 8:00,94,1344,85653,1034410,1438,1120063,TUESDAY,0,0,15,93,0,1009.9,Cloudy
9/20/2022 9:00,76,797,97354,569368,873,666722,TUESDAY,0,0,15,93,0,1009.9,Cloudy
9/20/2022 10:00,80,604,140785,416714,684,557499,TUESDAY,0,0,15,93,5.4,1010.9,Cloudy
9/20/2022 11:00,80,723,116779,509433,803,626212,TUESDAY,0,0,15,93,5.4,1010.9,Cloudy
9/20/2022 12:00,115,816,159877,534716,931,694593,TUESDAY,0,0,15,96,9.4,1011.5,Cloudy
9/20/2022 13:00,124,801,209933,564531,925,774464,TUESDAY,0,0,15,96,9.4,1011.5,Cloudy
9/20/2022 14:00,126,907,193426,3201279,1033,3394705,TUESDAY,0,0,15,96,11.2,1011.6,Cloudy
9/20/2022 15:00,159,1152,271448,1226598,1311,1498046,TUESDAY,0,0,16.7,86,9.4,1011.8,Cloudy
9/20/2022 16:00,183,1464,353173,1505818,1647,1858991,TUESDAY,0,0,16.7,86,9.4,1011.8,Cloudy
9/20/2022 17:00,245,1923,300171,3178136,2168,3478307,TUESDAY,0,0,16.1,90,14.8,1011.9,Cloudy
9/20/2022 18:00,215,1481,544501,1219924,1696,1764425,TUESDAY,0,0,16.1,84,13,1012,Cloudy
9/20/2022 19:00,146,1085,200309,1347472,1231,1547781,TUESDAY,0,0,16.1,84,13,1012,Cloudy
9/20/2022 20:00,77,731,339875,674112,808,1013987,TUESDAY,0,0,16.1,84,14.8,1011.9,Cloudy
9/20/2022 21:00,77,539,80070,433509,616,513579,TUESDAY,0,0,16.1,84,14.8,1011.9,Cloudy
9/20/2022 22:00,59,404,149380,383573,463,532953,TUESDAY,0,0,16.1,84,14.8,1012.4,Cloudy
9/20/2022 23:00,30,174,66000,146123,204,212123,TUESDAY,0,0,16.1,84,13,1012.8,Cloudy
9/21/2022 0:00,10,61,19746,40066,71,59812,WEDNESDAY,0,0,15.6,83,13,1013.5,Cloudy
9/21/2022 1:00,7,50,159348,40604,57,199952,WEDNESDAY,0,0,15.6,83,13,1013.5,Cloudy
9/21/2022 2:00,8,19,12763,23359,27,36122,WEDNESDAY,0,0,15.6,83,16.6,1013.5,Cloudy
9/21/2022 3:00,1,15,599,15496,16,16095,WEDNESDAY,0,0,15.6,83,9.4,1013.4,Rain
9/21/2022 4:00,4,12,2395,11017,16,13412,WEDNESDAY,0,0,15.6,83,9.4,1013.4,Cloudy
9/21/2022 5:00,15,104,35314,73441,119,108755,WEDNESDAY,0,0,14.4,93,9.4,1013.2,Cloudy
9/21/2022 6:00,38,286,38492,236212,324,274704,WEDNESDAY,0,0,14.4,93,9.4,1013.2,Cloudy
9/21/2022 7:00,80,916,72213,718593,996,790806,WEDNESDAY,0,0,14.4,93,9.4,1013.6,Cloudy
9/21/2022 8:00,126,1348,139678,1121289,1474,1260967,WEDNESDAY,0,0,14.4,90,11.2,1013.2,Cloudy
9/21/2022 9:00,84,922,100166,778991,1006,879157,WEDNESDAY,0,0,14.4,87,9.4,1013.6,Cloudy
9/21/2022 10:00,93,664,207346,520319,757,727665,WEDNESDAY,0,0,13.9,83,7.6,1014.2,Cloudy
9/21/2022 11:00,113,714,241932,528676,827,770608,WEDNESDAY,0,0,14.4,87,11.2,1014.5,Cloudy
9/21/2022 12:00,123,793,356505,616546,916,973051,WEDNESDAY,0,0,16.1,78,7.6,1014.4,Cloudy
9/21/2022 13:00,114,833,175180,615508,947,790688,WEDNESDAY,0,0,16.1,78,7.6,1014.4,Cloudy
9/21/2022 14:00,127,975,882925,1885722,1102,2768647,WEDNESDAY,0,0,17.8,68,11.2,1014.3,Cloudy
9/21/2022 15:00,156,1056,210990,936522,1212,1147512,WEDNESDAY,0,0,18.3,63,13,1013.6,Cloudy
9/21/2022 16:00,242,1471,692001,1355052,1713,2047053,WEDNESDAY,0,0,18.3,65,13,1013.3,Cloudy
9/21/2022 17:00,321,1913,1324962,1657557,2234,2982519,WEDNESDAY,0,0,18.3,65,13,1012.6,Cloudy
9/21/2022 18:00,311,1691,467251,2132611,2002,2599862,WEDNESDAY,0,0,18.3,65,13,1012.6,Cloudy
9/21/2022 19:00,178,1277,374406,1068299,1455,1442705,WEDNESDAY,0,0,20,63,13,1011.5,Cloudy
9/21/2022 20:00,144,866,202448,641707,1010,844155,WEDNESDAY,0,0,20,63,13,1011.5,Cloudy
9/21/2022 21:00,97,619,147165,1086647,716,1233812,WEDNESDAY,0,0,18.9,73,7.6,1010.9,Cloudy
9/21/2022 22:00,83,437,102481,352585,520,455066,WEDNESDAY,0,0,17.8,84,13,1010.6,Fair
9/21/2022 23:00,54,275,58534,222418,329,280952,WEDNESDAY,0,0,17.8,84,13,1010.6,Cloudy
9/22/2022 0:00,30,115,39648,136184,145,175832,THURSDAY,0,0,17.2,87,14.8,1010.4,Cloudy
9/22/2022 1:00,22,77,34211,72093,99,106304,THURSDAY,0,0,16.7,90,18.4,1009.7,Fair
9/22/2022 2:00,5,28,7176,78018,33,85194,THURSDAY,0,0,16.7,86,18.4,1009.6,Fair
9/22/2022 3:00,2,18,1041,14484,20,15525,THURSDAY,0,0,16.7,90,20.5,1008.9,Fair
9/22/2022 4:00,2,23,2173,22459,25,24632,THURSDAY,0,0,16.7,90,20.5,1008.9,Fair
9/22/2022 5:00,13,95,12794,69281,108,82075,THURSDAY,0,0,17.8,90,22.3,1007.3,Fair
9/22/2022 6:00,46,283,42402,321597,329,363999,THURSDAY,0,0,17.8,93,22.3,1006,Fair
9/22/2022 7:00,92,827,86254,685044,919,771298,THURSDAY,0,0,17.8,93,24.1,1006,Cloudy
9/22/2022 8:00,147,1315,120942,1942444,1462,2063386,THURSDAY,0,0,18.3,93,29.5,1004.9,Cloudy
9/22/2022 9:00,28,221,30187,157397,249,187584,THURSDAY,0,0,20,87,20.5,1003.8,Rain
9/22/2022 10:00,14,145,12445,103746,159,116191,THURSDAY,0,0,20,90,20.5,1003.1,Rain
9/22/2022 11:00,29,374,28912,251034,403,279946,THURSDAY,0,0,21.1,84,24.1,1002.2,Rain
9/22/2022 12:00,31,316,22030,187776,347,209806,THURSDAY,0,0,21.1,84,24.1,1002.2,Rain
9/22/2022 13:00,16,177,17830,122166,193,139996,THURSDAY,0,0,20.6,93,20.5,1001.5,Rain
9/22/2022 14:00,26,214,35400,972442,240,1007842,THURSDAY,0,0,20,93,18.4,1000.6,Rain
9/22/2022 15:00,31,285,24564,191548,316,216112,THURSDAY,0,0,20,93,22.3,999.3,Rain
9/22/2022 16:00,57,556,55447,490268,613,545715,THURSDAY,0,0,20,93,22.3,999.3,Rain
9/22/2022 17:00,202,1365,351179,1091565,1567,1442744,THURSDAY,0,0,20.6,96,16.6,998.7,Rain
9/22/2022 18:00,219,1378,245659,1105340,1597,1350999,THURSDAY,0,0,15.6,93,14.8,998.4,Rain
9/22/2022 19:00,177,1049,189299,1406952,1226,1596251,THURSDAY,0,0,16.1,81,20.5,998.9,Rain
9/22/2022 20:00,117,668,213283,483133,785,696416,THURSDAY,0,0,15,87,13,998.6,Rain
9/22/2022 21:00,90,511,93110,527386,601,620496,THURSDAY,0,0,16.1,81,11.2,999.2,Rain
9/22/2022 22:00,75,427,154080,304940,502,459020,THURSDAY,0,0,16.1,81,11.2,999.2,Rain
9/22/2022 23:00,61,280,70062,278538,341,348600,THURSDAY,0,0,16.1,81,7.6,1000.2,Rain
9/23/2022 0:00,39,140,53814,114169,179,167983,FRIDAY,0,0,15.6,75,18.4,1001.6,Rain
9/23/2022 1:00,23,85,82834,81971,108,164805,FRIDAY,0,0,15,72,18.4,1002.7,Rain
9/23/2022 2:00,9,46,143015,54724,55,197739,FRIDAY,0,0,13.9,74,18.4,1003,Rain
9/23/2022 3:00,7,26,6164,28164,33,34328,FRIDAY,0,0,13.9,74,24.1,1003,Cloudy
9/23/2022 4:00,2,12,1605,9572,14,11177,FRIDAY,0,0,12.8,74,24.1,1004.7,Fair
9/23/2022 5:00,17,82,69385,71791,99,141176,FRIDAY,0,0,12.2,75,20.5,1005.1,Fair
9/23/2022 6:00,31,210,28998,149418,241,178416,FRIDAY,0,0,11.7,77,14.8,1005.1,Fair
9/23/2022 7:00,65,632,88329,470737,697,559066,FRIDAY,0,0,11.1,77,22.3,1005.7,Fair
9/23/2022 8:00,82,986,81270,746440,1068,827710,FRIDAY,0,0,11.1,77,22.3,1005.7,Fair
9/23/2022 9:00,95,747,113555,533146,842,646701,FRIDAY,0,0,10,66,20.5,1007.5,Fair
9/23/2022 10:00,95,579,161429,537043,674,698472,FRIDAY,0,0,10,66,29.5,1008.1,Cloudy
9/23/2022 11:00,139,720,255360,511878,859,767238,FRIDAY,0,0,11.1,63,22.3,1008.6,Fair
9/23/2022 12:00,158,757,1065715,585023,915,1650738,FRIDAY,0,0,11.1,63,22.3,1008.6,Fair
9/23/2022 13:00,210,884,463971,744676,1094,1208647,FRIDAY,0,0,12.8,57,31.7,1008.3,Cloudy
9/23/2022 14:00,191,845,289883,733447,1036,1023330,FRIDAY,0,0,13.3,55,31.7,1008.4,Cloudy
9/23/2022 15:00,265,1042,392226,852214,1307,1244440,FRIDAY,0,0,13.9,51,38.9,1008.3,Cloudy
9/23/2022 16:00,275,1204,546274,3254376,1479,3800650,FRIDAY,0,0,15,47,37.1,1008.2,Cloudy
9/23/2022 17:00,291,1471,415474,1225694,1762,1641168,FRIDAY,0,0,15.6,46,24.1,1007.2,Cloudy
9/23/2022 18:00,208,1234,1032898,1627662,1442,2660560,FRIDAY,0,0,15.6,46,24.1,1007.2,Cloudy
9/23/2022 19:00,175,850,205306,656983,1025,862289,FRIDAY,0,0,15.6,44,35.3,1007.1,Cloudy
9/23/2022 20:00,121,588,235087,1508517,709,1743604,FRIDAY,0,0,14.4,46,44.6,1007.4,Cloudy
9/23/2022 21:00,102,430,531162,419967,532,951129,FRIDAY,0,0,12.2,50,40.7,1008.4,Cloudy
9/23/2022 22:00,96,338,128838,462856,434,591694,FRIDAY,0,0,12.2,50,37.1,1008.4,Cloudy
9/23/2022 23:00,110,336,200467,289227,446,489694,FRIDAY,0,0,11.1,52,37.1,1009.7,Fair
9/24/2022 0:00,103,245,161645,178779,348,340424,SATURDAY,1,0,10.6,54,33.5,1010,Fair
9/24/2022 1:00,97,163,211294,141187,260,352481,SATURDAY,1,0,10.6,54,29.5,1010.1,Fair
9/24/2022 2:00,34,117,72430,116610,151,189040,SATURDAY,1,0,10.6,54,35.3,1009.9,Fair
9/24/2022 3:00,6,34,4631,38487,40,43118,SATURDAY,1,0,10.6,54,33.5,1009.9,Fair
9/24/2022 4:00,4,10,2764,9615,14,12379,SATURDAY,1,0,10,56,22.3,1010.2,Fair
9/24/2022 5:00,3,35,2987,28243,38,31230,SATURDAY,1,0,9.4,59,22.3,1010.6,Clear
9/24/2022 6:00,24,91,30398,61505,115,91903,SATURDAY,1,0,9.4,59,29.5,1010.2,Clear
9/24/2022 7:00,20,154,19421,115256,174,134677,SATURDAY,1,0,9.4,59,31.7,1010.2,Clear
9/24/2022 8:00,55,352,80570,291486,407,372056,SATURDAY,1,0,9.4,59,25.9,1010.5,Clear
9/24/2022 9:00,151,495,232225,912225,646,1144450,SATURDAY,1,0,9.4,59,25.9,1010.5,Clear
9/24/2022 10:00,197,647,570675,555686,844,1126361,SATURDAY,1,0,9.4,59,16.6,1010.7,Clear
9/24/2022 11:00,283,861,1232815,841558,1144,2074373,SATURDAY,1,0,10.6,54,31.7,1011.4,Fair
9/24/2022 12:00,355,987,735086,988133,1342,1723219,SATURDAY,1,0,10.6,54,25.9,1011.4,Fair
9/24/2022 13:00,399,998,753729,996117,1397,1749846,SATURDAY,1,0,13.9,44,22.3,1011.7,Fair
9/24/2022 14:00,457,956,986053,1515792,1413,2501845,SATURDAY,1,0,16.1,38,22.3,1011.3,Fair
9/24/2022 15:00,424,1139,809927,1264933,1563,2074860,SATURDAY,1,0,17.2,33,25.9,1010.7,Rain
9/24/2022 16:00,459,1108,1546003,1542865,1567,3088868,SATURDAY,1,0,18.9,32,35.3,1010.5,Fair
9/24/2022 17:00,436,1114,1104255,1481185,1550,2585440,SATURDAY,1,0,18.9,32,31.7,1010.5,Fair
9/24/2022 18:00,429,1186,1154951,1243478,1615,2398429,SATURDAY,1,0,20,31,24.1,1009.7,Fair
9/24/2022 19:00,270,906,525646,761903,1176,1287549,SATURDAY,1,0,20,32,22.3,1009.2,Fair
9/24/2022 20:00,234,719,389992,609193,953,999185,SATURDAY,1,0,20,33,22.3,1009.2,Fair
9/24/2022 21:00,188,539,306447,493370,727,799817,SATURDAY,1,0,18.9,34,29.5,1009.3,Fair
9/24/2022 22:00,173,487,385148,428129,660,813277,SATURDAY,1,0,18.9,34,25.9,1009.3,Fair
9/24/2022 23:00,202,434,1948272,374825,636,2323097,SATURDAY,1,0,18.3,39,18.4,1009.7,Fair
9/25/2022 0:00,135,333,268884,299987,468,568871,SUNDAY,1,0,16.7,46,0,1010.5,Fair
9/25/2022 1:00,164,266,310044,506012,430,816056,SUNDAY,1,0,15,55,11.2,1010.9,Fair
9/25/2022 2:00,76,148,455242,138647,224,593889,SUNDAY,1,0,13.9,62,13,1011,Fair
9/25/2022 3:00,31,63,49396,58331,94,107727,SUNDAY,1,0,13.9,62,13,1011,Clear
9/25/2022 4:00,7,9,9227,26264,16,35491,SUNDAY,1,0,12.8,69,13,1011,Clear
9/25/2022 5:00,8,25,10991,19054,33,30045,SUNDAY,1,0,13.9,67,13,1011,Fair
9/25/2022 6:00,17,78,15766,73252,95,89018,SUNDAY,1,0,13.3,69,11.2,1010.5,Clear
9/25/2022 7:00,32,116,29365,90187,148,119552,SUNDAY,1,0,13.3,69,11.2,1010.5,Clear
9/25/2022 8:00,56,267,152278,217055,323,369333,SUNDAY,1,0,11.1,77,0,1009.9,Clear
9/25/2022 9:00,137,512,279171,411319,649,690490,SUNDAY,1,0,11.1,77,0,1009.9,Clear
9/25/2022 10:00,184,673,1107009,557220,857,1664229,SUNDAY,1,0,10.6,83,13,1009.7,Clear
9/25/2022 11:00,291,757,577866,712711,1048,1290577,SUNDAY,1,0,13.3,72,0,1009.1,Fair
9/25/2022 12:00,361,941,670948,824977,1302,1495925,SUNDAY,1,0,14.4,67,9.4,1009.1,Cloudy
9/25/2022 13:00,348,977,649093,860705,1325,1509798,SUNDAY,1,0,14.4,67,9.4,1009.1,Cloudy
9/25/2022 14:00,337,990,644638,894452,1327,1539090,SUNDAY,1,0,17.8,54,18.4,1008.3,Cloudy
9/25/2022 15:00,317,906,462013,784866,1223,1246879,SUNDAY,1,0,17.8,54,18.4,1008.3,Rain
9/25/2022 16:00,233,809,326891,665617,1042,992508,SUNDAY,1,0,20,49,18.4,1007.1,Cloudy
9/25/2022 17:00,229,891,530038,876820,1120,1406858,SUNDAY,1,0,20,49,18.4,1007.1,Cloudy
9/25/2022 18:00,221,858,334111,696010,1079,1030121,SUNDAY,1,0,20.6,61,24.1,1005.5,Cloudy
9/25/2022 19:00,144,664,265742,541585,808,807327,SUNDAY,1,0,19.4,66,18.4,1005.2,Cloudy
9/25/2022 20:00,102,529,112464,431826,631,544290,SUNDAY,1,0,18.9,78,14.8,1004.7,Cloudy
9/25/2022 21:00,84,418,161991,329515,502,491506,SUNDAY,1,0,18.9,78,14.8,1004.7,Rain
9/25/2022 22:00,101,342,127519,266497,443,394016,SUNDAY,1,0,18.3,84,16.6,1004.1,Rain
9/25/2022 23:00,46,185,50156,146622,231,196778,SUNDAY,1,0,17.8,90,13,1003.6,Rain
9/26/2022 0:00,23,95,30435,68436,118,98871,MONDAY,0,0,18.9,84,18.4,1002.7,Cloudy
9/26/2022 1:00,15,23,38615,12214,38,50829,MONDAY,0,0,18.9,84,18.4,1002.7,Cloudy
9/26/2022 2:00,5,12,4266,9128,17,13394,MONDAY,0,0,18.9,87,14.8,1002.6,Cloudy
9/26/2022 3:00,3,8,1966,59631,11,61597,MONDAY,0,0,18.3,87,16.6,1002.3,Cloudy
9/26/2022 4:00,3,13,18455,12333,16,30788,MONDAY,0,0,18.3,84,20.5,1002.3,Cloudy
9/26/2022 5:00,12,88,17065,59041,100,76106,MONDAY,0,0,17.2,87,25.9,1002.5,Cloudy
9/26/2022 6:00,39,255,34887,204044,294,238931,MONDAY,0,0,16.7,90,7.6,1001,Cloudy
9/26/2022 7:00,74,693,70555,548033,767,618588,MONDAY,0,0,16.7,90,7.6,1001,Cloudy
9/26/2022 8:00,131,1121,183998,1194474,1252,1378472,MONDAY,0,0,16.1,97,13,1000.8,Cloudy
9/26/2022 9:00,118,714,320756,533657,832,854413,MONDAY,0,0,15,96,14.8,1001.7,Cloudy
9/26/2022 10:00,124,527,207285,388808,651,596093,MONDAY,0,0,15,96,14.8,1002.4,Rain
9/26/2022 11:00,146,624,1119411,490932,770,1610343,MONDAY,0,0,16.1,90,20.5,1003.3,Cloudy
9/26/2022 12:00,166,665,370190,482615,831,852805,MONDAY,0,0,16.1,90,20.5,1003.3,Fair
9/26/2022 13:00,198,637,395638,489859,835,885497,MONDAY,0,0,19.4,73,20.5,1004.3,Fair
9/26/2022 14:00,184,815,314745,584080,999,898825,MONDAY,0,0,18.9,75,20.5,1004.6,Fair
9/26/2022 15:00,217,873,394570,732782,1090,1127352,MONDAY,0,0,21.1,66,20.5,1004.5,Rain
9/26/2022 16:00,277,1258,660514,1041281,1535,1701795,MONDAY,0,0,22.8,57,16.6,1004.5,Fair
9/26/2022 17:00,353,1689,674395,1435394,2042,2109789,MONDAY,0,0,22.8,57,16.6,1004.5,Fair
9/26/2022 18:00,375,1503,555479,1280485,1878,1835964,MONDAY,0,0,23.3,50,20.5,1004.3,Fair
9/26/2022 19:00,193,1028,341812,821235,1221,1163047,MONDAY,0,0,23.3,48,29.5,1004.2,Fair
9/26/2022 20:00,40,319,34956,199199,359,234155,MONDAY,0,0,22.2,49,31.7,1004.3,Fair
9/26/2022 21:00,43,285,43012,253390,328,296402,MONDAY,0,0,22.2,49,33.5,1004.3,Fair
9/26/2022 22:00,44,260,70484,195826,304,266310,MONDAY,0,0,19.4,68,25.9,1005.2,Fair
9/26/2022 23:00,60,191,79595,145608,251,225203,MONDAY,0,0,19.4,68,25.9,1005.2,Fair
9/27/2022 0:00,15,86,12169,47981,101,60150,TUESDAY,0,0,16.1,81,27.7,1008.5,Fair
9/27/2022 1:00,7,38,11329,24615,45,35944,TUESDAY,0,0,16.1,81,27.7,1008.5,Fair
9/27/2022 2:00,3,22,5090,15357,25,20447,TUESDAY,0,0,16.1,84,14.8,1008.2,Fair
9/27/2022 3:00,0,4,0,3727,4,3727,TUESDAY,0,0,16.1,87,5.4,1008.5,Fair
9/27/2022 4:00,3,14,2912,11658,17,14570,TUESDAY,0,0,15.6,93,5.4,1008.6,Fair
9/27/2022 5:00,13,105,10778,69632,118,80410,TUESDAY,0,0,15,96,7.6,1008.6,Fair
9/27/2022 6:00,39,286,30245,212690,325,242935,TUESDAY,0,0,15.6,96,9.4,1008.3,Fair
9/27/2022 7:00,89,851,73543,633104,940,706647,TUESDAY,0,0,15.6,96,9.4,1008.3,Fair
9/27/2022 8:00,154,1345,179651,1018576,1499,1198227,TUESDAY,0,0,15.6,93,9.4,1008.8,Fair
9/27/2022 9:00,96,776,107703,639596,872,747299,TUESDAY,0,0,15.6,93,5.4,1008.7,Fair
9/27/2022 10:00,86,564,131673,424900,650,556573,TUESDAY,0,0,15.6,93,11.2,1008.9,Rain
9/27/2022 11:00,121,624,214493,919726,745,1134219,TUESDAY,0,0,16.1,93,9.4,1009.4,Cloudy
9/27/2022 12:00,145,774,235205,541427,919,776632,TUESDAY,0,0,16.1,93,9.4,1009.4,Cloudy
9/27/2022 13:00,178,738,276680,556459,916,833139,TUESDAY,0,0,18.9,63,18.4,1009.8,Cloudy
9/27/2022 14:00,168,794,268745,618847,962,887592,TUESDAY,0,0,20,55,16.6,1009.8,Cloudy
9/27/2022 15:00,195,1026,589557,880878,1221,1470435,TUESDAY,0,0,21.1,57,14.8,1009.6,Cloudy
9/27/2022 16:00,242,1296,322410,1609286,1538,1931696,TUESDAY,0,0,21.1,57,14.8,1009.6,Fair
9/27/2022 17:00,409,1814,1191210,1575022,2223,2766232,TUESDAY,0,0,23.3,40,25.9,1008.5,Fair
9/27/2022 18:00,376,1555,1070121,1289971,1931,2360092,TUESDAY,0,0,23.9,34,33.5,1008.2,Fair
9/27/2022 19:00,221,1027,728300,837384,1248,1565684,TUESDAY,0,0,23.9,34,35.3,1008.2,Fair
9/27/2022 20:00,137,641,171556,480153,778,651709,TUESDAY,0,0,22.2,33,31.7,1008.7,Fair
9/27/2022 21:00,127,583,170969,448965,710,619934,TUESDAY,0,0,22.2,33,27.7,1008.7,Fair
9/27/2022 22:00,118,381,177325,303292,499,480617,TUESDAY,0,0,21.1,38,24.1,1009.4,Fair
9/27/2022 23:00,45,198,586713,147010,243,733723,TUESDAY,0,0,18.3,50,16.6,1010.8,Fair
9/28/2022 0:00,26,97,26292,68302,123,94594,WEDNESDAY,0,0,17.8,54,16.6,1011.3,Fair
9/28/2022 1:00,24,61,58390,39519,85,97909,WEDNESDAY,0,0,16.7,62,16.6,1011.9,Fair
9/28/2022 2:00,7,33,14556,23506,40,38062,WEDNESDAY,0,0,16.7,62,16.6,1011.9,Fair
9/28/2022 3:00,6,9,4469,4927,15,9396,WEDNESDAY,0,0,15,69,14.8,1012.6,Fair
9/28/2022 4:00,8,19,6890,35464,27,42354,WEDNESDAY,0,0,14.4,72,16.6,1013,Clear
9/28/2022 5:00,13,91,8928,60512,104,69440,WEDNESDAY,0,0,14.4,72,14.8,1013.3,Fair
9/28/2022 6:00,40,281,86433,203455,321,289888,WEDNESDAY,0,0,14.4,72,18.4,1013.4,Clear
9/28/2022 7:00,123,918,102698,813284,1041,915982,WEDNESDAY,0,0,14.4,72,18.4,1013.4,Clear
9/28/2022 8:00,154,1330,155529,988003,1484,1143532,WEDNESDAY,0,0,13.9,74,11.2,1013.9,Clear
9/28/2022 9:00,118,798,1049172,1057035,916,2106207,WEDNESDAY,0,0,13.9,74,11.2,1014.3,Clear
9/28/2022 10:00,100,626,158588,433774,726,592362,WEDNESDAY,0,0,13.9,74,18.4,1014.7,Clear
9/28/2022 11:00,116,678,156604,480853,794,637457,WEDNESDAY,0,0,15.6,67,13,1015.2,Fair
9/28/2022 12:00,143,776,262370,586391,919,848761,WEDNESDAY,0,0,15.6,67,13,1015.2,Fair
9/28/2022 13:00,145,685,265098,508044,830,773142,WEDNESDAY,0,0,18.3,56,20.5,1016.2,Fair
9/28/2022 14:00,168,814,336480,602671,982,939151,WEDNESDAY,0,0,18.9,54,16.6,1016.5,Fair
9/28/2022 15:00,204,936,299694,998304,1140,1297998,WEDNESDAY,0,0,20,51,18.4,1016.5,Rain
9/28/2022 16:00,289,1298,357467,1100481,1587,1457948,WEDNESDAY,0,0,20,51,18.4,1016.5,Fair
9/28/2022 17:00,322,1753,504247,1603492,2075,2107739,WEDNESDAY,0,0,20.6,47,20.5,1016.9,Fair
9/28/2022 18:00,345,1476,466127,1568658,1821,2034785,WEDNESDAY,0,0,21.7,44,13,1016.9,Fair
9/28/2022 19:00,232,1025,285755,810450,1257,1096205,WEDNESDAY,0,0,20,49,16.6,1017.5,Fair
9/28/2022 20:00,127,736,154982,554647,863,709629,WEDNESDAY,0,0,20.6,47,16.6,1018,Cloudy
9/28/2022 21:00,123,567,173263,454571,690,627834,WEDNESDAY,0,0,20.6,47,16.6,1018,Cloudy
9/28/2022 22:00,116,403,237594,410095,519,647689,WEDNESDAY,0,0,19.4,55,16.6,1019.5,Cloudy
9/28/2022 23:00,68,225,92845,289031,293,381876,WEDNESDAY,0,0,18.3,54,13,1020.5,Cloudy
9/29/2022 0:00,20,111,18754,76490,131,95244,THURSDAY,0,0,18.3,54,13,1020.5,Cloudy
9/29/2022 1:00,16,52,63968,38732,68,102700,THURSDAY,0,0,17.8,58,14.8,1021.6,Fair
9/29/2022 2:00,4,28,3619,19876,32,23495,THURSDAY,0,0,16.1,65,18.4,1022.5,Fair
9/29/2022 3:00,6,18,9045,18788,24,27833,THURSDAY,0,0,16.1,65,18.4,1022.5,Fair
9/29/2022 4:00,4,24,4008,17687,28,21695,THURSDAY,0,0,14.4,72,18.4,1023.1,Fair
9/29/2022 5:00,16,89,22038,61553,105,83591,THURSDAY,0,0,13.9,72,20.5,1023.3,Fair
9/29/2022 6:00,45,303,42682,214678,348,257360,THURSDAY,0,0,13.3,72,20.5,1023.5,Fair
9/29/2022 7:00,116,790,129971,593011,906,722982,THURSDAY,0,0,13.3,72,20.5,1023.5,Fair
9/29/2022 8:00,151,1341,181845,1089669,1492,1271514,THURSDAY,0,0,12.2,75,20.5,1024.4,Fair
9/29/2022 9:00,100,794,239071,755914,894,994985,THURSDAY,0,0,12.2,75,20.5,1024.4,Fair
9/29/2022 10:00,108,586,178769,677789,694,856558,THURSDAY,0,0,11.7,77,20.5,1025.7,Fair
9/29/2022 11:00,137,626,216283,496854,763,713137,THURSDAY,0,0,12.8,72,18.4,1026.2,Fair
9/29/2022 12:00,171,766,244750,519397,937,764147,THURSDAY,0,0,12.8,72,18.4,1026.2,Fair
9/29/2022 13:00,196,723,387601,805149,919,1192750,THURSDAY,0,0,16.1,58,18.4,1027,Fair
9/29/2022 14:00,157,802,233166,677771,959,910937,THURSDAY,0,0,16.7,56,11.2,1027.1,Fair
9/29/2022 15:00,184,945,334188,733374,1129,1067562,THURSDAY,0,0,18.3,52,13,1026.9,Fair
9/29/2022 16:00,309,1275,416250,990273,1584,1406523,THURSDAY,0,0,18.3,52,13,1026.9,Fair
9/29/2022 17:00,403,1678,529933,1852182,2081,2382115,THURSDAY,0,0,15.6,67,16.6,1026.6,Fair
9/29/2022 18:00,375,1437,859044,1351952,1812,2210996,THURSDAY,0,0,15.6,69,14.8,1026.5,Fair
9/29/2022 19:00,238,1039,246067,882922,1277,1128989,THURSDAY,0,0,16.1,70,14.8,1026.6,Fair
9/29/2022 20:00,177,709,289984,559014,886,848998,THURSDAY,0,0,15,75,11.2,1027,Fair
9/29/2022 21:00,108,561,102926,426267,669,529193,THURSDAY,0,0,15,75,11.2,1027,Cloudy
9/29/2022 22:00,97,379,211512,347058,476,558570,THURSDAY,0,0,15,53,18.4,1027.3,Cloudy
9/29/2022 23:00,72,265,108910,190902,337,299812,THURSDAY,0,0,13.9,53,16.6,1027.7,Cloudy
9/30/2022 0:00,48,131,182743,100415,179,283158,FRIDAY,0,0,13.9,55,13,1027.9,Cloudy
9/30/2022 1:00,31,64,37843,47932,95,85775,FRIDAY,0,0,13.9,55,13,1027.9,Cloudy
9/30/2022 2:00,15,43,19614,75568,58,95182,FRIDAY,0,0,13.3,55,13,1027.9,Cloudy
9/30/2022 3:00,5,19,3149,13002,24,16151,FRIDAY,0,0,12.2,59,13,1028.1,Cloudy
9/30/2022 4:00,2,18,1274,15175,20,16449,FRIDAY,0,0,11.7,61,11.2,1028.4,Cloudy
9/30/2022 5:00,25,74,18354,51452,99,69806,FRIDAY,0,0,10.6,74,11.2,1028.2,Cloudy
9/30/2022 6:00,31,227,25433,156088,258,181521,FRIDAY,0,0,10.6,74,11.2,1028.2,Cloudy
9/30/2022 7:00,98,593,100280,426261,691,526541,FRIDAY,0,0,10.6,77,14.8,1027.9,Cloudy
9/30/2022 8:00,105,1019,97549,753451,1124,851000,FRIDAY,0,0,10.6,77,14.8,1027.9,Cloudy
9/30/2022 9:00,115,724,151643,518003,839,669646,FRIDAY,0,0,9.4,80,14.8,1028.1,Cloudy
9/30/2022 10:00,148,580,283028,406032,728,689060,FRIDAY,0,0,8.9,80,11.2,1028.5,Cloudy
9/30/2022 11:00,183,679,316756,532445,862,849201,FRIDAY,0,0,8.9,80,11.2,1028.5,Cloudy
9/30/2022 12:00,194,750,324856,563483,944,888339,FRIDAY,0,0,11.1,74,13,1028.9,Cloudy
9/30/2022 13:00,230,813,378275,915593,1043,1293868,FRIDAY,0,0,13.3,69,14.8,1028.8,Cloudy
9/30/2022 14:00,251,849,529231,650796,1100,1180027,FRIDAY,0,0,13.9,67,16.6,1028.4,Cloudy
9/30/2022 15:00,295,1048,439602,1257843,1343,1697445,FRIDAY,0,0,15,64,16.6,1027.7,Rain
9/30/2022 16:00,318,1159,527505,1177015,1477,1704520,FRIDAY,0,0,15,64,16.6,1027.7,Cloudy
9/30/2022 17:00,373,1456,460787,1228788,1829,1689575,FRIDAY,0,0,15,64,18.4,1026.1,Cloudy
9/30/2022 18:00,336,1256,406791,1135873,1592,1542664,FRIDAY,0,0,14.4,67,16.6,1025.6,Cloudy
9/30/2022 19:00,240,885,345334,702360,1125,1047694,FRIDAY,0,0,13.9,67,14.8,1025.5,Cloudy
9/30/2022 20:00,191,655,236709,813197,846,1049906,FRIDAY,0,0,13.3,67,13,1025.1,Cloudy
9/30/2022 21:00,171,524,225575,413077,695,638652,FRIDAY,0,0,13.3,67,13,1025.1,Cloudy
9/30/2022 22:00,175,460,243671,362132,635,605803,FRIDAY,0,0,13.3,62,11.2,1024.4,Cloudy
9/30/2022 23:00,168,316,574986,259508,484,834494,FRIDAY,0,0,12.8,62,7.6,1024,Cloudy
10/1/2022 0:00,140,216,2019653,179478,356,2199131,SATURDAY,1,0,12.8,64,9.4,1023.9,Cloudy
10/1/2022 1:00,54,115,76327,102984,169,179311,SATURDAY,1,0,12.8,66,9.4,1023.8,Cloudy
10/1/2022 2:00,15,42,16541,39920,57,56461,SATURDAY,1,0,12.2,69,5.4,1023.6,Cloudy
10/1/2022 3:00,7,15,6357,11982,22,18339,SATURDAY,1,0,12.8,62,0,1023.1,Cloudy
10/1/2022 4:00,6,27,15501,22353,33,37854,SATURDAY,1,0,12.2,72,5.4,1022.4,Cloudy
10/1/2022 5:00,11,58,16484,41835,69,58319,SATURDAY,1,0,11.7,74,5.4,1022,Cloudy
10/1/2022 6:00,34,162,60725,116640,196,177365,SATURDAY,1,0,11.7,74,5.4,1022,Cloudy
10/1/2022 7:00,71,313,99898,232997,384,332895,SATURDAY,1,0,11.1,77,5.4,1021.2,Cloudy
10/1/2022 8:00,133,407,206633,303494,540,510127,SATURDAY,1,0,11.7,71,7.6,1021.3,Cloudy
10/1/2022 9:00,115,393,140886,367600,508,508486,SATURDAY,1,0,11.7,69,9.4,1021.5,Cloudy
10/1/2022 10:00,92,395,330605,286632,487,617237,SATURDAY,1,0,11.7,69,11.2,1021.3,Cloudy
10/1/2022 11:00,132,523,139446,392563,655,532009,SATURDAY,1,0,11.7,69,11.2,1021.3,Rain
10/1/2022 12:00,189,614,223916,463016,803,686932,SATURDAY,1,0,12.2,66,9.4,1022.3,Rain
10/1/2022 13:00,217,654,3067293,542001,871,3609294,SATURDAY,1,0,12.2,72,7.6,1021.9,Rain
10/1/2022 14:00,277,751,2276365,616435,1028,2892800,SATURDAY,1,0,12.2,77,13,1021.2,Rain
10/1/2022 15:00,312,809,1954799,814968,1121,2769767,SATURDAY,1,0,12.2,77,13,1021.2,Rain
10/1/2022 16:00,242,844,705364,1242138,1086,1947502,SATURDAY,1,0,13.3,84,16.6,1020.1,Rain
10/1/2022 17:00,273,785,1978793,648978,1058,2627771,SATURDAY,1,0,14.4,75,16.6,1019.8,Rain
10/1/2022 18:00,230,635,1707239,1506655,865,3213894,SATURDAY,1,0,14.4,75,16.6,1019.8,Rain
10/1/2022 19:00,163,536,240366,395863,699,636229,SATURDAY,1,0,13.9,72,16.6,1019.1,Rain
10/1/2022 20:00,178,447,263060,398299,625,661359,SATURDAY,1,0,13.9,72,16.6,1019.1,Rain
10/1/2022 21:00,167,381,177029,668858,548,845887,SATURDAY,1,0,13.9,72,11.2,1019,Rain
10/1/2022 22:00,170,335,295068,329638,505,624706,SATURDAY,1,0,13.9,72,18.4,1018.7,Rain
10/1/2022 23:00,129,256,181542,205241,385,386783,SATURDAY,1,0,13.9,72,18.4,1018.7,Rain
10/2/2022 0:00,144,226,365723,216189,370,581912,SUNDAY,1,0,13.9,74,18.4,1018.4,Rain
10/2/2022 1:00,105,132,235061,103550,237,338611,SUNDAY,1,0,13.9,74,16.6,1018.7,Rain
10/2/2022 2:00,18,41,16266,35391,59,51657,SUNDAY,1,0,13.9,74,16.6,1018.2,Rain
10/2/2022 3:00,8,14,9325,13545,22,22870,SUNDAY,1,0,14,72,15,1018,Cloudy
10/2/2022 4:00,8,16,10402,20232,24,30634,SUNDAY,1,0,13.9,72,18.4,1018.2,Cloudy
10/2/2022 5:00,14,65,45234,47681,79,92915,SUNDAY,1,0,13.9,72,18.4,1018.2,Cloudy
10/2/2022 6:00,28,115,43732,76287,143,120019,SUNDAY,1,0,14.4,81,20.5,1018.7,Cloudy
10/2/2022 7:00,69,213,110708,198280,282,308988,SUNDAY,1,0,14.4,81,20.5,1019.3,Cloudy
10/2/2022 8:00,112,354,1494077,304534,466,1798611,SUNDAY,1,0,13.9,77,29.5,1019.5,Cloudy
10/2/2022 9:00,142,513,196255,373167,655,569422,SUNDAY,1,0,13.9,77,40.7,1019.5,Cloudy
10/2/2022 10:00,229,638,373248,502895,867,876143,SUNDAY,1,0,13.9,72,37.1,1019.9,Cloudy
10/2/2022 11:00,250,719,1381676,591167,969,1972843,SUNDAY,1,0,12.8,69,44.6,1021.3,Cloudy
10/2/2022 12:00,249,712,2909291,1512532,961,4421823,SUNDAY,1,0,12.8,64,46.4,1022.1,Cloudy
10/2/2022 13:00,239,702,356089,600892,941,956981,SUNDAY,1,0,12.2,64,42.5,1022.6,Cloudy
10/2/2022 14:00,255,749,425815,606062,1004,1031877,SUNDAY,1,0,12.2,59,44.6,1023.3,Cloudy
10/2/2022 15:00,282,780,388563,655816,1062,1044379,SUNDAY,1,0,12.2,59,46.4,1023.3,Cloudy
10/2/2022 16:00,191,770,227654,615915,961,843569,SUNDAY,1,0,12.8,51,38.9,1023.7,Cloudy
10/2/2022 17:00,173,693,199158,517335,866,716493,SUNDAY,1,0,12.8,52,44.6,1023.5,Cloudy
10/2/2022 18:00,136,546,177521,374825,682,552346,SUNDAY,1,0,12.8,55,40.7,1023.7,Cloudy
10/2/2022 19:00,99,384,760339,262891,483,1023230,SUNDAY,1,0,12.8,52,44.6,1023.6,Cloudy
10/2/2022 20:00,46,278,55776,207020,324,262796,SUNDAY,1,0,12.8,52,40.7,1023.6,Cloudy
10/2/2022 21:00,54,249,81222,194726,303,275948,SUNDAY,1,0,11.1,46,33.5,1024.7,Cloudy
10/2/2022 22:00,36,142,41620,99410,178,141030,SUNDAY,1,0,11.1,46,33.5,1024.7,Cloudy
10/2/2022 23:00,32,97,68642,63668,129,132310,SUNDAY,1,0,11.7,52,24.1,1025.4,Cloudy
10/3/2022 0:00,15,39,15089,24566,54,39655,MONDAY,0,0,11.7,52,24.1,1025.4,Cloudy
10/3/2022 1:00,6,19,5507,21579,25,27086,MONDAY,0,0,11.7,52,35.3,1025.2,Cloudy
10/3/2022 2:00,1,10,704,8497,11,9201,MONDAY,0,0,12.2,55,35.3,1025,Cloudy
10/3/2022 3:00,4,21,34856,18419,25,53275,MONDAY,0,0,11.7,59,31.7,1025.4,Cloudy
10/3/2022 4:00,14,70,13840,46150,84,59990,MONDAY,0,0,11.7,56,31.7,1025.3,Cloudy
10/3/2022 5:00,34,217,577348,143626,251,720974,MONDAY,0,0,11.7,56,31.7,1025.3,Cloudy
10/3/2022 6:00,87,605,382948,451329,692,834277,MONDAY,0,0,11.7,59,29.5,1024.7,Cloudy
10/3/2022 7:00,114,1054,943423,773028,1168,1716451,MONDAY,0,0,11.7,59,24.1,1024.4,Cloudy
10/3/2022 8:00,82,604,91424,414596,686,506020,MONDAY,0,0,11.7,59,24.1,1024.3,Cloudy
10/3/2022 9:00,86,488,139065,326049,574,465114,MONDAY,0,0,11.7,56,40.7,1025.4,Cloudy
10/3/2022 10:00,77,502,104765,310346,579,415111,MONDAY,0,0,11.7,56,31.7,1025.4,Cloudy
10/3/2022 11:00,98,568,152044,360630,666,512674,MONDAY,0,0,11.7,54,38.9,1025.6,Cloudy
10/3/2022 12:00,119,531,176745,380229,650,556974,MONDAY,0,0,11.7,54,33.5,1025.9,Cloudy
10/3/2022 13:00,143,626,194232,408370,769,602602,MONDAY,0,0,12.2,55,40.7,1026.7,Cloudy
10/3/2022 14:00,130,662,225346,485827,792,711173,MONDAY,0,0,12.2,55,27.7,1026.8,Cloudy
10/3/2022 15:00,150,959,184027,723943,1109,907970,MONDAY,0,0,12.8,52,35.3,1026.6,Cloudy
10/3/2022 16:00,178,1274,184376,1051800,1452,1236176,MONDAY,0,0,12.8,52,35.3,1026.6,Cloudy
10/3/2022 17:00,172,982,187947,685288,1154,873235,MONDAY,0,0,12.8,55,31.7,1026.1,Cloudy
10/3/2022 18:00,100,776,2426519,1566870,876,3993389,MONDAY,0,0,12.2,59,29.5,1026,Cloudy
10/3/2022 19:00,79,472,72608,316880,551,389488,MONDAY,0,0,12.2,59,29.5,1026,Cloudy
10/3/2022 20:00,59,373,51722,241560,432,293282,MONDAY,0,0,11.7,66,27.7,1024.9,Cloudy
10/3/2022 21:00,56,259,57565,174147,315,231712,MONDAY,0,0,11.7,64,25.9,1025.2,Cloudy
10/3/2022 22:00,65,158,78035,104709,223,182744,MONDAY,0,0,11.7,64,25.9,1025.2,Cloudy
10/3/2022 23:00,21,69,17698,42381,90,60079,MONDAY,0,0,11.7,66,29.5,1025.1,Cloudy
10/4/2022 0:00,15,35,2599116,52627,50,2651743,TUESDAY,0,0,11.7,66,27.7,1024.5,Cloudy
10/4/2022 1:00,2,19,1318,17003,21,18321,TUESDAY,0,0,11.7,66,27.7,1024.5,Cloudy
10/4/2022 2:00,2,11,4067,24741,13,28808,TUESDAY,0,0,11.7,61,29.5,1024.1,Cloudy
10/4/2022 3:00,5,17,4448,11838,22,16286,TUESDAY,0,0,11.7,61,27.7,1023.8,Cloudy
10/4/2022 4:00,13,80,12243,58605,93,70848,TUESDAY,0,0,11.7,64,24.1,1023,Cloudy
10/4/2022 5:00,38,217,65068,156963,255,222031,TUESDAY,0,0,11.7,64,24.1,1023,Cloudy
10/4/2022 6:00,98,725,1412924,540457,823,1953381,TUESDAY,0,0,12.2,64,27.7,1022.6,Cloudy
10/4/2022 7:00,145,1196,181630,1144823,1341,1326453,TUESDAY,0,0,12.2,69,25.9,1021.3,Cloudy
10/4/2022 8:00,93,698,99071,503154,791,602225,TUESDAY,0,0,12.2,69,25.9,1021.4,Cloudy
10/4/2022 9:00,95,452,402060,326813,547,728873,TUESDAY,0,0,12.2,72,29.5,1021.4,Cloudy
10/4/2022 10:00,100,513,136690,357889,613,494579,TUESDAY,0,0,12.2,72,29.5,1021.4,Rain
10/4/2022 11:00,96,571,175336,378702,667,554038,TUESDAY,0,0,12.8,72,29.5,1020.6,Rain
10/4/2022 12:00,104,571,151963,365752,675,517715,TUESDAY,0,0,12.8,72,29.5,1020.6,Cloudy
10/4/2022 13:00,131,585,195018,591868,716,786886,TUESDAY,0,0,13.3,72,31.7,1021.1,Cloudy
10/4/2022 14:00,130,699,160253,485661,829,645914,TUESDAY,0,0,13.9,72,33.5,1020.9,Cloudy
10/4/2022 15:00,135,862,943069,693956,997,1637025,TUESDAY,0,0,13.9,72,33.5,1020.9,Cloudy
10/4/2022 16:00,145,825,149015,592574,970,741589,TUESDAY,0,0,13.9,74,31.7,1019.8,Cloudy
10/4/2022 17:00,82,528,76894,377959,610,454853,TUESDAY,0,0,13.9,77,27.7,1018.9,Cloudy
10/4/2022 18:00,51,382,47866,304488,433,352354,TUESDAY,0,0,13.9,77,29.5,1018.9,Rain
10/4/2022 19:00,48,296,92662,214376,344,307038,TUESDAY,0,0,13.9,77,35.3,1018.3,Rain
10/4/2022 20:00,36,155,26680,98888,191,125568,TUESDAY,0,0,12.8,89,27.7,1017.9,Cloudy
10/4/2022 21:00,18,120,17505,82279,138,99784,TUESDAY,0,0,12.8,89,27.7,1017.9,Cloudy
10/4/2022 22:00,11,71,9347,38246,82,47593,TUESDAY,0,0,12.8,93,27.7,1017.6,Rain
10/4/2022 23:00,10,36,1356399,24477,46,1380876,TUESDAY,0,0,12.8,96,25.9,1017.7,Rain
10/5/2022 0:00,6,15,4766,7559,21,12325,WEDNESDAY,0,0,12.8,96,27.7,1017.7,Rain
10/5/2022 1:00,8,12,5459,7886,20,13345,WEDNESDAY,0,0,12.8,96,22.3,1017.7,Rain
10/5/2022 2:00,2,3,1664,14663,5,16327,WEDNESDAY,0,0,12.8,96,18.4,1017,Rain
10/5/2022 3:00,5,10,2825,9979,15,12804,WEDNESDAY,0,0,12.8,96,18.4,1017,Rain
10/5/2022 4:00,5,54,3431,34929,59,38360,WEDNESDAY,0,0,12.8,96,29.5,1016.4,Cloudy
10/5/2022 5:00,8,114,4470,72729,122,77199,WEDNESDAY,0,0,12.8,96,29.5,1015.5,Rain
10/5/2022 6:00,21,181,14291,122389,202,136680,WEDNESDAY,0,0,12.8,96,25.9,1015.3,Rain
10/5/2022 7:00,44,520,39282,347612,564,386894,WEDNESDAY,0,0,12.8,93,14.8,1014.8,Rain
10/5/2022 8:00,45,486,35847,310493,531,346340,WEDNESDAY,0,0,12.2,93,22.3,1014.7,Rain
10/5/2022 9:00,72,418,66213,263883,490,330096,WEDNESDAY,0,0,12.8,93,27.7,1014,Rain
10/5/2022 10:00,65,459,47808,314129,524,361937,WEDNESDAY,0,0,12.8,93,27.7,1014,Rain
10/5/2022 11:00,59,474,71962,303233,533,375195,WEDNESDAY,0,0,12.8,93,20.5,1014.5,Rain
10/5/2022 12:00,70,424,2592325,263403,494,2855728,WEDNESDAY,0,0,12.2,97,24.1,1014.8,Rain
10/5/2022 13:00,104,549,259332,2121923,653,2381255,WEDNESDAY,0,0,12.8,96,20.5,1014.8,Cloudy
10/5/2022 14:00,139,625,2947102,447855,764,3394957,WEDNESDAY,0,0,12.8,96,20.5,1014.8,Cloudy
10/5/2022 15:00,146,897,150834,709995,1043,860829,WEDNESDAY,0,0,13.3,93,25.9,1014.7,Cloudy
10/5/2022 16:00,166,998,542405,746206,1164,1288611,WEDNESDAY,0,0,13.9,93,22.3,1013.9,Cloudy
10/5/2022 17:00,103,696,401158,525992,799,927150,WEDNESDAY,0,0,14.4,90,29.5,1012.4,Rain
10/5/2022 18:00,94,538,182000,413352,632,595352,WEDNESDAY,0,0,14.4,90,22.3,1012.9,Rain
10/5/2022 19:00,78,370,91537,300294,448,391831,WEDNESDAY,0,0,14.4,90,22.3,1012.9,Rain
10/5/2022 20:00,50,330,2422981,230846,380,2653827,WEDNESDAY,0,0,14.4,90,22.3,1012.8,Cloudy
10/5/2022 21:00,44,255,51869,180617,299,232486,WEDNESDAY,0,0,14.4,90,22.3,1012.8,Rain
10/5/2022 22:00,24,108,24119,78438,132,102557,WEDNESDAY,0,0,13.9,96,16.6,1013.5,Rain
10/5/2022 23:00,8,50,6473,37431,58,43904,WEDNESDAY,0,0,14.4,97,18.4,1013.3,Rain
10/6/2022 0:00,14,31,11536,18733,45,30269,THURSDAY,0,0,14.4,97,18.4,1013.3,Cloudy
10/6/2022 1:00,8,16,11035,11160,24,22195,THURSDAY,0,0,15,93,20.5,1013.5,Cloudy
10/6/2022 2:00,3,9,6105,7212,12,13317,THURSDAY,0,0,14.4,97,11.2,1013.5,Rain
10/6/2022 3:00,2,11,2710,11532,13,14242,THURSDAY,0,0,14.4,97,11.2,1013.5,Rain
10/6/2022 4:00,16,76,21901,51741,92,73642,THURSDAY,0,0,14.4,97,11.2,1013.2,Rain
10/6/2022 5:00,47,266,40796,286841,313,327637,THURSDAY,0,0,15,96,13,1012.6,Rain
10/6/2022 6:00,91,690,113288,513771,781,627059,THURSDAY,0,0,15,96,13,1012.6,Cloudy
10/6/2022 7:00,160,1259,153672,897152,1419,1050824,THURSDAY,0,0,15,96,16.6,1012.1,Cloudy
10/6/2022 8:00,115,694,151323,580426,809,731749,THURSDAY,0,0,15,93,13,1012.2,Cloudy
10/6/2022 9:00,103,577,190741,403510,680,594251,THURSDAY,0,0,15,93,13,1012.2,Cloudy
10/6/2022 10:00,143,591,233774,436432,734,670206,THURSDAY,0,0,15,93,14.8,1012.1,Cloudy
10/6/2022 11:00,145,706,347816,549149,851,896965,THURSDAY,0,0,15.6,86,14.8,1013.1,Cloudy
10/6/2022 12:00,176,666,329767,457334,842,787101,THURSDAY,0,0,17.2,81,14.8,1013.4,Cloudy
10/6/2022 13:00,210,714,297997,615700,924,913697,THURSDAY,0,0,18.9,70,14.8,1013.8,Cloudy
10/6/2022 14:00,237,816,348498,671151,1053,1019649,THURSDAY,0,0,18.9,70,14.8,1013.8,Cloudy
10/6/2022 15:00,322,1202,1977677,985603,1524,2963280,THURSDAY,0,0,20.6,66,7.6,1013.7,Cloudy
10/6/2022 16:00,472,1622,851059,1633284,2094,2484343,THURSDAY,0,0,19.4,68,13,1013.6,Fair
10/6/2022 17:00,411,1344,3219624,1145297,1755,4364921,THURSDAY,0,0,19.4,68,13,1013.2,Fair
10/6/2022 18:00,244,877,371125,675711,1121,1046836,THURSDAY,0,0,19.4,68,13,1012.7,Fair
10/6/2022 19:00,173,695,348411,598315,868,946726,THURSDAY,0,0,19.4,68,13,1012.7,Fair
10/6/2022 20:00,147,551,1940098,401297,698,2341395,THURSDAY,0,0,18.9,68,11.2,1012.7,Fair
10/6/2022 21:00,117,362,114189,288128,479,402317,THURSDAY,0,0,17.2,75,7.6,1013,Fair
10/6/2022 22:00,55,206,48667,185317,261,233984,THURSDAY,0,0,16.1,81,13,1013.5,Fair
10/6/2022 23:00,38,127,36181,87474,165,123655,THURSDAY,0,0,16.1,87,13,1013.7,Fair
10/7/2022 0:00,41,70,112752,53487,111,166239,FRIDAY,0,0,16.1,87,13,1013.7,Fair
10/7/2022 1:00,13,28,13136,21077,41,34213,FRIDAY,0,0,15.6,86,7.6,1013.6,Fair
10/7/2022 2:00,12,17,21176,12513,29,33689,FRIDAY,0,0,17.2,78,7.6,1013.5,Fair
10/7/2022 3:00,6,15,5610,13647,21,19257,FRIDAY,0,0,15,90,13,1013.3,Fair
10/7/2022 4:00,26,63,18472,39160,89,57632,FRIDAY,0,0,15,90,13,1013.3,Cloudy
10/7/2022 5:00,29,204,26571,139481,233,166052,FRIDAY,0,0,13.9,93,13,1013.1,Cloudy
10/7/2022 6:00,79,508,198848,380043,587,578891,FRIDAY,0,0,14.4,87,13,1012.9,Cloudy
10/7/2022 7:00,131,893,146956,647786,1024,794742,FRIDAY,0,0,14.4,87,13,1012.7,Cloudy
10/7/2022 8:00,131,681,241268,506588,812,747856,FRIDAY,0,0,14.4,87,14.8,1012.8,Cloudy
10/7/2022 9:00,166,519,249418,394988,685,644406,FRIDAY,0,0,14.4,87,14.8,1012.8,Cloudy
10/7/2022 10:00,205,607,475438,480405,812,955843,FRIDAY,0,0,14.4,87,13,1012.9,Rain
10/7/2022 11:00,265,676,493034,545004,941,1038038,FRIDAY,0,0,14.4,87,18.4,1012.9,Cloudy
10/7/2022 12:00,301,764,907650,604489,1065,1512139,FRIDAY,0,0,17.2,72,14.8,1013.4,Cloudy
10/7/2022 13:00,356,789,3288559,659090,1145,3947649,FRIDAY,0,0,18.9,68,9.4,1013.2,Cloudy
10/7/2022 14:00,449,917,2745250,809674,1366,3554924,FRIDAY,0,0,18.9,68,9.4,1013.2,Cloudy
10/7/2022 15:00,434,1087,1959682,1447972,1521,3407654,FRIDAY,0,0,22.2,55,11.2,1012.6,Cloudy
10/7/2022 16:00,565,1405,945171,1289698,1970,2234869,FRIDAY,0,0,23.9,54,16.6,1011.9,Fair
10/7/2022 17:00,484,1168,1162179,1054742,1652,2216921,FRIDAY,0,0,24.4,52,20.5,1011.1,Fair
10/7/2022 18:00,288,840,397473,2186416,1128,2583889,FRIDAY,0,0,25.6,45,22.3,1010.5,Fair
10/7/2022 19:00,243,567,313810,462043,810,775853,FRIDAY,0,0,25.6,45,22.3,1010.5,Fair
10/7/2022 20:00,226,447,277891,349422,673,627313,FRIDAY,0,0,23.9,50,14.8,1010.3,Fair
10/7/2022 21:00,156,398,245238,312652,554,557890,FRIDAY,0,0,23.9,41,16.6,1010.8,Cloudy
10/7/2022 22:00,154,281,267274,267557,435,534831,FRIDAY,0,0,22.8,46,11.2,1011.2,Cloudy
10/7/2022 23:00,124,163,430412,137232,287,567644,FRIDAY,0,0,21.7,51,11.2,1012.3,Fair
10/8/2022 0:00,118,152,179313,138811,270,318124,SATURDAY,1,0,21.7,51,22.3,1012.3,Fair
10/8/2022 1:00,94,80,170623,66430,174,237053,SATURDAY,1,0,18.3,61,18.4,1013.9,Fair
10/8/2022 2:00,13,25,29210,15864,38,45074,SATURDAY,1,0,16.7,54,18.4,1014.8,Fair
10/8/2022 3:00,7,18,12336,11079,25,23415,SATURDAY,1,0,15,55,18.4,1015.3,Fair
10/8/2022 4:00,11,33,9475,23389,44,32864,SATURDAY,1,0,15,55,18.4,1015.3,Fair
10/8/2022 5:00,21,46,16416,31583,67,47999,SATURDAY,1,0,12.8,51,18.4,1016.1,Cloudy
10/8/2022 6:00,43,135,91483,115349,178,206832,SATURDAY,1,0,12.2,55,18.4,1016.2,Cloudy
10/8/2022 7:00,79,278,1498980,237381,357,1736361,SATURDAY,1,0,11.1,59,20.5,1016.9,Cloudy
10/8/2022 8:00,177,367,518565,321507,544,840072,SATURDAY,1,0,10.6,63,18.4,1016.8,Cloudy
10/8/2022 9:00,279,527,532568,418816,806,951384,SATURDAY,1,0,10.6,63,18.4,1016.8,Cloudy
10/8/2022 10:00,358,602,3019465,520065,960,3539530,SATURDAY,1,0,10,68,14.8,1018.4,Cloudy
10/8/2022 11:00,423,676,893267,691113,1099,1584380,SATURDAY,1,0,10,66,14.8,1018.8,Cloudy
10/8/2022 12:00,424,677,876140,780440,1101,1656580,SATURDAY,1,0,10.6,59,16.6,1019,Cloudy
10/8/2022 13:00,481,719,1448343,692844,1200,2141187,SATURDAY,1,0,11.7,52,16.6,1019.3,Cloudy
10/8/2022 14:00,570,756,2140814,708241,1326,2849055,SATURDAY,1,0,11.7,52,16.6,1019.3,Cloudy
10/8/2022 15:00,510,696,880646,972238,1206,1852884,SATURDAY,1,0,13.3,45,22.3,1019.1,Fair
10/8/2022 16:00,459,805,1686295,759369,1264,2445664,SATURDAY,1,0,13.9,44,20.5,1018.4,Fair
10/8/2022 17:00,357,667,4238140,567310,1024,4805450,SATURDAY,1,0,15.6,41,13,1017.7,Fair
10/8/2022 18:00,208,488,288595,441799,696,730394,SATURDAY,1,0,15.6,39,16.6,1017,Fair
10/8/2022 19:00,193,413,330450,332606,606,663056,SATURDAY,1,0,15.6,39,16.6,1017,Fair
10/8/2022 20:00,171,322,753861,232788,493,986649,SATURDAY,1,0,15,36,16.6,1016.7,Fair
10/8/2022 21:00,139,288,218954,246070,427,465024,SATURDAY,1,0,14.4,34,13,1017,Fair
10/8/2022 22:00,183,238,368847,218071,421,586918,SATURDAY,1,0,13.3,42,18.4,1017.4,Fair
10/8/2022 23:00,117,181,141475,126476,298,267951,SATURDAY,1,0,13.3,42,18.4,1017.4,Fair
10/9/2022 0:00,112,124,210017,91442,236,301459,SUNDAY,1,0,11.7,47,18.4,1018.3,Fair
10/9/2022 1:00,62,61,68545,1425978,123,1494523,SUNDAY,1,0,10.6,50,16.6,1018.8,Fair
10/9/2022 2:00,9,24,8174,11988,33,20162,SUNDAY,1,0,9.4,56,16.6,1019.1,Clear
10/9/2022 3:00,10,9,8372,8099,19,16471,SUNDAY,1,0,9.4,56,22.3,1019.1,Clear
10/9/2022 4:00,6,19,7734,10936,25,18670,SUNDAY,1,0,8.3,61,18.4,1019,Clear
10/9/2022 5:00,14,51,11491,29998,65,41489,SUNDAY,1,0,7.8,65,16.6,1019.2,Clear
10/9/2022 6:00,39,108,43227,74114,147,117341,SUNDAY,1,0,7.8,65,13,1019,Clear
10/9/2022 7:00,63,167,73174,341365,230,414539,SUNDAY,1,0,7.8,65,13,1019,Clear
10/9/2022 8:00,139,324,526184,2086650,463,2612834,SUNDAY,1,0,6.7,73,13,1018.6,Clear
10/9/2022 9:00,249,422,440955,346051,671,787006,SUNDAY,1,0,7.2,68,14.8,1018,Clear
10/9/2022 10:00,304,474,560403,425497,778,985900,SUNDAY,1,0,7.2,68,14.8,1018,Rain
10/9/2022 11:00,351,591,703473,606161,942,1309634,SUNDAY,1,0,7.2,65,18.4,1018.8,Fair
10/9/2022 12:00,408,617,849400,574250,1025,1423650,SUNDAY,1,0,9.4,56,24.1,1019.1,Fair
10/9/2022 13:00,435,627,867125,631441,1062,1498566,SUNDAY,1,0,11.1,52,22.3,1018.8,Fair
10/9/2022 14:00,463,622,1328059,559099,1085,1887158,SUNDAY,1,0,11.1,52,22.3,1018.8,Fair
10/9/2022 15:00,477,707,950530,646548,1184,1597078,SUNDAY,1,0,14.4,42,20.5,1017.5,Rain
10/9/2022 16:00,422,686,653615,571208,1108,1224823,SUNDAY,1,0,15.6,39,24.1,1016.7,Fair
10/9/2022 17:00,272,620,756359,493304,892,1249663,SUNDAY,1,0,16.1,36,24.1,1016,Fair
10/9/2022 18:00,227,492,296102,418662,719,714764,SUNDAY,1,0,16.7,34,22.3,1015.8,Fair
10/9/2022 19:00,142,340,299893,235233,482,535126,SUNDAY,1,0,16.7,34,22.3,1015.8,Fair
10/9/2022 20:00,124,284,315112,1230575,408,1545687,SUNDAY,1,0,16.1,39,16.6,1016.4,Fair
10/9/2022 21:00,142,223,270683,557115,365,827798,SUNDAY,1,0,15.6,39,18.4,1016.7,Fair
10/9/2022 22:00,84,130,182530,94879,214,277409,SUNDAY,1,0,15,42,13,1017.4,Fair
10/9/2022 23:00,87,95,159070,68392,182,227462,SUNDAY,1,0,15,42,13,1017.4,Fair
10/10/2022 0:00,59,52,108713,49097,111,157810,MONDAY,0,1,13.9,49,16.6,1018.6,Fair
10/10/2022 1:00,34,28,99935,22879,62,122814,MONDAY,0,1,13.3,53,16.6,1019.2,Fair
10/10/2022 2:00,15,14,192596,8441,29,201037,MONDAY,0,1,13.3,53,13,1020,Fair
10/10/2022 3:00,4,13,19514,10125,17,29639,MONDAY,0,1,11.7,61,9.4,1020.4,Fair
10/10/2022 4:00,9,46,14801,30241,55,45042,MONDAY,0,1,11.7,61,9.4,1020.4,Fair
10/10/2022 5:00,22,113,13549,68456,135,82005,MONDAY,0,1,10,63,0,1020.9,Fair
10/10/2022 6:00,51,285,39605,200231,336,239836,MONDAY,0,1,10,66,0,1020.9,Clear
10/10/2022 7:00,79,455,84641,346189,534,430830,MONDAY,0,1,10.6,77,0,1021.1,Fair
10/10/2022 8:00,121,463,196193,336428,584,532621,MONDAY,0,1,10.6,74,0,1021,Fair
10/10/2022 9:00,154,389,246331,326321,543,572652,MONDAY,0,1,10.6,74,0,1021,Fair
10/10/2022 10:00,242,440,565646,363310,682,928956,MONDAY,0,1,10,74,9.4,1021.8,Rain
10/10/2022 11:00,308,475,1752817,382708,783,2135525,MONDAY,0,1,10.6,77,9.4,1021.9,Fair
10/10/2022 12:00,314,538,2919387,409074,852,3328461,MONDAY,0,1,11.7,71,11.2,1022.2,Cloudy
10/10/2022 13:00,356,532,2855806,429599,888,3285405,MONDAY,0,1,11.7,71,11.2,1022.2,Cloudy
10/10/2022 14:00,394,575,1449776,424216,969,1873992,MONDAY,0,1,15.6,55,14.8,1021.8,Cloudy
10/10/2022 15:00,291,667,490177,506396,958,996573,MONDAY,0,1,16.7,52,18.4,1021.5,Cloudy
10/10/2022 16:00,209,601,236671,458670,810,695341,MONDAY,0,1,17.8,43,18.4,1021.1,Cloudy
10/10/2022 17:00,204,599,587182,411989,803,999171,MONDAY,0,1,17.8,41,20.5,1020.6,Cloudy
10/10/2022 18:00,196,497,182899,329666,693,512565,MONDAY,0,1,17.8,41,20.5,1020.6,Cloudy
10/10/2022 19:00,160,378,1141677,282402,538,1424079,MONDAY,0,1,18.3,42,11.2,1020.1,Cloudy
10/10/2022 20:00,125,282,121248,194612,407,315860,MONDAY,0,1,14.4,78,11.2,1021.4,Cloudy
10/10/2022 21:00,93,226,134034,158494,319,292528,MONDAY,0,1,13.9,69,11.2,1021.8,Cloudy
10/10/2022 22:00,97,139,166920,134602,236,301522,MONDAY,0,1,13.9,69,11.2,1021.8,Cloudy
10/10/2022 23:00,30,73,94076,47462,103,141538,MONDAY,0,1,12.8,77,5.4,1022.8,Cloudy
10/11/2022 0:00,14,31,26053,17458,45,43511,TUESDAY,0,0,12.2,80,7.6,1023.4,Fair
10/11/2022 1:00,9,17,10973,58474,26,69447,TUESDAY,0,0,12.8,77,5.4,1024.1,Fair
10/11/2022 2:00,9,8,28592,10308,17,38900,TUESDAY,0,0,12.8,80,5.4,1024.4,Fair
10/11/2022 3:00,2,8,1339,7918,10,9257,TUESDAY,0,0,12.8,80,5.4,1024.4,Fair
10/11/2022 4:00,16,71,16944,48302,87,65246,TUESDAY,0,0,11.1,86,7.6,1024.3,Fair
10/11/2022 5:00,41,210,27434,150681,251,178115,TUESDAY,0,0,10.6,92,7.6,1024.4,Fair
10/11/2022 6:00,101,684,112258,499019,785,611277,TUESDAY,0,0,10.6,89,7.6,1024.5,Fair
10/11/2022 7:00,158,1100,155826,839280,1258,995106,TUESDAY,0,0,10,89,5.4,1024.5,Fair
10/11/2022 8:00,147,671,212890,531611,818,744501,TUESDAY,0,0,10,89,5.4,1024.5,Fair
10/11/2022 9:00,140,408,201614,295566,548,497180,TUESDAY,0,0,9.4,90,9.4,1025.3,Fair
10/11/2022 10:00,126,463,199327,340877,589,540204,TUESDAY,0,0,8.9,89,7.6,1025.7,Rain
10/11/2022 11:00,162,490,225013,364118,652,589131,TUESDAY,0,0,10,80,5.4,1026.2,Fair
10/11/2022 12:00,207,539,358300,427887,746,786187,TUESDAY,0,0,12.8,66,0,1026.5,Fair
10/11/2022 13:00,184,605,1383477,467623,789,1851100,TUESDAY,0,0,12.8,66,0,1026.5,Fair
10/11/2022 14:00,257,758,2052349,627711,1015,2680060,TUESDAY,0,0,15,58,7.6,1026.3,Fair
10/11/2022 15:00,293,1014,1289088,812694,1307,2101782,TUESDAY,0,0,15.6,44,16.6,1026,Rain
10/11/2022 16:00,447,1487,940457,1274062,1934,2214519,TUESDAY,0,0,17.2,43,13,1025.3,Fair
10/11/2022 17:00,321,1208,1609690,3720364,1529,5330054,TUESDAY,0,0,17.8,35,13,1024.5,Fair
10/11/2022 18:00,203,794,236809,778946,997,1015755,TUESDAY,0,0,17.8,35,13,1024.5,Fair
10/11/2022 19:00,152,479,1271491,1729458,631,3000949,TUESDAY,0,0,18.3,34,11.2,1023.5,Rain
10/11/2022 20:00,95,400,90293,321764,495,412057,TUESDAY,0,0,18.3,33,11.2,1023.1,Fair
10/11/2022 21:00,85,236,88780,189042,321,277822,TUESDAY,0,0,17.8,37,16.6,1023.2,Fair
10/11/2022 22:00,58,136,303817,101356,194,405173,TUESDAY,0,0,17.8,37,16.6,1023.2,Fair
10/11/2022 23:00,36,63,491427,45384,99,536811,TUESDAY,0,0,15,53,9.4,1023.5,Fair
10/12/2022 0:00,22,18,68254,9934,40,78188,WEDNESDAY,0,0,14.4,57,11.2,1023.7,Fair
10/12/2022 1:00,4,20,2346,11965,24,14311,WEDNESDAY,0,0,14.4,62,14.8,1023.6,Clear
10/12/2022 2:00,9,7,27201,2756,16,29957,WEDNESDAY,0,0,13.3,69,14.8,1023.8,Clear
10/12/2022 3:00,2,10,1898,6828,12,8726,WEDNESDAY,0,0,13.3,69,14.8,1023.8,Clear
10/12/2022 4:00,18,72,13058,50212,90,63270,WEDNESDAY,0,0,13.9,69,11.2,1023.3,Clear
10/12/2022 5:00,33,255,26912,176517,288,203429,WEDNESDAY,0,0,12.2,77,13,1023.4,Clear
10/12/2022 6:00,108,723,101451,531881,831,633332,WEDNESDAY,0,0,12.2,77,9.4,1023,Clear
10/12/2022 7:00,195,1246,225354,914102,1441,1139456,WEDNESDAY,0,0,11.7,80,0,1022.9,Clear
10/12/2022 8:00,122,706,123307,593322,828,716629,WEDNESDAY,0,0,11.7,80,0,1022.9,Clear
10/12/2022 9:00,134,499,292118,367891,633,660009,WEDNESDAY,0,0,10.6,86,0,1023.6,Clear
10/12/2022 10:00,137,550,218075,436400,687,654475,WEDNESDAY,0,0,12.2,75,11.2,1023.6,Rain
10/12/2022 11:00,153,610,305525,450090,763,755615,WEDNESDAY,0,0,14.4,67,9.4,1023.7,Fair
10/12/2022 12:00,193,600,368951,423840,793,792791,WEDNESDAY,0,0,15.6,62,7.6,1023.8,Fair
10/12/2022 13:00,225,653,398455,497093,878,895548,WEDNESDAY,0,0,15.6,62,7.6,1023.8,Fair
10/12/2022 14:00,262,726,567035,544659,988,1111694,WEDNESDAY,0,0,20,49,7.6,1023.5,Fair
10/12/2022 15:00,315,1104,606833,874805,1419,1481638,WEDNESDAY,0,0,22.8,38,13,1023,Rain
10/12/2022 16:00,446,1455,1877754,1395260,1901,3273014,WEDNESDAY,0,0,23.3,36,14.8,1022.1,Fair
10/12/2022 17:00,361,1188,934161,946683,1549,1880844,WEDNESDAY,0,0,23.3,36,14.8,1022.1,Fair
10/12/2022 18:00,182,821,274031,626166,1003,900197,WEDNESDAY,0,0,23.3,33,22.3,1020.5,Fair
10/12/2022 19:00,145,541,1509160,606732,686,2115892,WEDNESDAY,0,0,22.2,35,22.3,1020.2,Rain
10/12/2022 20:00,118,434,115855,323364,552,439219,WEDNESDAY,0,0,21.7,36,22.3,1019.7,Cloudy
10/12/2022 21:00,105,280,191550,221164,385,412714,WEDNESDAY,0,0,18.9,45,18.4,1019.8,Cloudy
10/12/2022 22:00,42,130,50489,86636,172,137125,WEDNESDAY,0,0,18.9,45,18.4,1019.8,Cloudy
10/12/2022 23:00,27,55,22995,41863,82,64858,WEDNESDAY,0,0,16.1,65,18.4,1020.2,Cloudy
10/13/2022 0:00,9,40,12161,27484,49,39645,THURSDAY,0,0,15.6,69,18.4,1020.2,Cloudy
10/13/2022 1:00,10,20,51018,14071,30,65089,THURSDAY,0,0,14.4,81,16.6,1020.3,Cloudy
10/13/2022 2:00,7,12,9968,10119,19,20087,THURSDAY,0,0,13.9,87,14.8,1020.2,Cloudy
10/13/2022 3:00,6,18,6509,13988,24,20497,THURSDAY,0,0,13.9,87,14.8,1020.2,Cloudy
10/13/2022 4:00,16,71,21463,48954,87,70417,THURSDAY,0,0,13.3,87,11.2,1019.6,Cloudy
10/13/2022 5:00,38,233,28690,168877,271,197567,THURSDAY,0,0,13.3,93,9.4,1018.9,Cloudy
10/13/2022 6:00,124,676,125158,515746,800,640904,THURSDAY,0,0,13.3,93,9.4,1018.8,Cloudy
10/13/2022 7:00,191,1211,196957,921864,1402,1118821,THURSDAY,0,0,13.9,93,9.4,1018.3,Cloudy
10/13/2022 8:00,133,714,176309,543668,847,719977,THURSDAY,0,0,13.9,93,9.4,1018.3,Cloudy
10/13/2022 9:00,99,521,135277,346981,620,482258,THURSDAY,0,0,14.4,93,11.2,1017.3,Cloudy
10/13/2022 10:00,100,413,152662,1878220,513,2030882,THURSDAY,0,0,15,93,16.6,1016.9,Cloudy
10/13/2022 11:00,130,511,372997,351514,641,724511,THURSDAY,0,0,16.1,87,16.6,1016.7,Cloudy
10/13/2022 12:00,159,516,214640,377864,675,592504,THURSDAY,0,0,16.1,87,24.1,1016.7,Cloudy
10/13/2022 13:00,176,584,579591,517565,760,1097156,THURSDAY,0,0,18.9,65,31.7,1016.6,Cloudy
10/13/2022 14:00,216,674,378070,464495,890,842565,THURSDAY,0,0,18.3,65,20.5,1016.6,Cloudy
10/13/2022 15:00,191,752,491291,518983,943,1010274,THURSDAY,0,0,18.3,68,20.5,1016.3,Cloudy
10/13/2022 16:00,188,864,2033204,664338,1052,2697542,THURSDAY,0,0,17.8,75,18.4,1015.4,Cloudy
10/13/2022 17:00,145,705,124304,717782,850,842086,THURSDAY,0,0,17.8,75,18.4,1015.4,Rain
10/13/2022 18:00,109,460,908767,303276,569,1212043,THURSDAY,0,0,19.4,71,24.1,1014.2,Rain
10/13/2022 19:00,43,195,43258,131863,238,175121,THURSDAY,0,0,18.9,75,20.5,1013.8,Rain
10/13/2022 20:00,24,90,38170,67195,114,105365,THURSDAY,0,0,18.9,75,20.5,1013.8,Rain
10/13/2022 21:00,25,103,26742,109937,128,136679,THURSDAY,0,0,18.3,84,20.5,1013.4,Rain
10/13/2022 22:00,13,49,17990,32336,62,50326,THURSDAY,0,0,17.2,93,27.7,1013.2,Rain
10/13/2022 23:00,9,34,7140,21237,43,28377,THURSDAY,0,0,16.7,96,20.5,1012.9,Rain
10/14/2022 0:00,9,21,11176,10180,30,21356,FRIDAY,0,0,16.7,96,20.5,1012.9,Rain
10/14/2022 1:00,6,11,4900,6843,17,11743,FRIDAY,0,0,17.2,97,22.3,1012.6,Rain
10/14/2022 2:00,10,10,36443,5166,20,41609,FRIDAY,0,0,16.7,100,16.6,1012.8,Rain
10/14/2022 3:00,7,9,4070,7252,16,11322,FRIDAY,0,0,17.2,100,20.5,1012.1,Rain
10/14/2022 4:00,12,62,17277,46402,74,63679,FRIDAY,0,0,17.2,100,13,1011.1,Rain
10/14/2022 5:00,18,150,24024,117750,168,141774,FRIDAY,0,0,17.2,100,11.2,1010.9,Rain
10/14/2022 6:00,43,234,65839,155727,277,221566,FRIDAY,0,0,17.2,100,11.2,1010.9,Rain
10/14/2022 7:00,25,251,17395,179663,276,197058,FRIDAY,0,0,17.2,100,14.8,1010.4,Cloudy
10/14/2022 8:00,9,126,6021,74793,135,80814,FRIDAY,0,0,17.2,97,14.8,1009.5,Rain
10/14/2022 9:00,19,170,17037,103646,189,120683,FRIDAY,0,0,18.3,97,14.8,1009.6,Rain
10/14/2022 10:00,66,333,2059333,202765,399,2262098,FRIDAY,0,0,18.3,93,16.6,1008.9,Rain
10/14/2022 11:00,119,462,151623,320118,581,471741,FRIDAY,0,0,18.3,93,16.6,1008.9,Rain
10/14/2022 12:00,163,544,314848,358560,707,673408,FRIDAY,0,0,17.8,96,22.3,1008.6,Rain
10/14/2022 13:00,205,555,888873,662099,760,1550972,FRIDAY,0,0,18.3,97,31.7,1008.1,Rain
10/14/2022 14:00,282,714,371636,546680,996,918316,FRIDAY,0,0,17.2,97,16.6,1009,Rain
10/14/2022 15:00,280,847,798870,2136748,1127,2935618,FRIDAY,0,0,17.2,97,16.6,1009,Rain
10/14/2022 16:00,406,1120,1956764,941275,1526,2898039,FRIDAY,0,0,16.7,90,13,1010.6,Cloudy
10/14/2022 17:00,331,913,2215515,756571,1244,2972086,FRIDAY,0,0,16.7,90,13,1010.6,Rain
10/14/2022 18:00,270,678,423521,594235,948,1017756,FRIDAY,0,0,19.4,81,9.4,1010.4,Cloudy
10/14/2022 19:00,197,497,253670,363606,694,617276,FRIDAY,0,0,20,73,13,1010.9,Rain
10/14/2022 20:00,153,405,270808,308569,558,579377,FRIDAY,0,0,19.4,76,11.2,1011.7,Cloudy
10/14/2022 21:00,190,332,199440,266497,522,465937,FRIDAY,0,0,19.4,76,11.2,1011.7,Cloudy
10/14/2022 22:00,164,213,3165877,174688,377,3340565,FRIDAY,0,0,18.3,81,16.6,1013.2,Cloudy
10/14/2022 23:00,180,202,221681,2029509,382,2251190,FRIDAY,0,0,17.2,81,16.6,1014.1,Cloudy
10/15/2022 0:00,206,155,354322,125486,361,479808,SATURDAY,1,0,16.1,84,11.2,1014.1,Cloudy
10/15/2022 1:00,94,88,2016000,78575,182,2094575,SATURDAY,1,0,16.1,84,11.2,1014.1,Cloudy
10/15/2022 2:00,21,21,41669,30512,42,72181,SATURDAY,1,0,15.6,86,9.4,1014.7,Cloudy
10/15/2022 3:00,15,13,14251,10329,28,24580,SATURDAY,1,0,15,81,14.8,1014.9,Cloudy
10/15/2022 4:00,7,25,6370,55024,32,61394,SATURDAY,1,0,14.4,81,16.6,1015.1,Rain
10/15/2022 5:00,19,75,21213,56040,94,77253,SATURDAY,1,0,13.3,87,14.8,1015.4,Fair
10/15/2022 6:00,36,135,45724,87024,171,132748,SATURDAY,1,0,13.3,80,13,1015.5,Fair
10/15/2022 7:00,97,284,119101,214607,381,333708,SATURDAY,1,0,13.3,80,13,1015.5,Fair
10/15/2022 8:00,184,449,433119,356742,633,789861,SATURDAY,1,0,12.2,80,11.2,1015.3,Clear
10/15/2022 9:00,358,536,824560,722773,894,1547333,SATURDAY,1,0,12.2,77,11.2,1016.1,Fair
10/15/2022 10:00,453,612,963858,561273,1065,1525131,SATURDAY,1,0,11.7,77,11.2,1016.5,Rain
10/15/2022 11:00,552,667,3246749,625912,1219,3872661,SATURDAY,1,0,11.7,77,11.2,1016.5,Fair
10/15/2022 12:00,595,731,1284555,1892155,1326,3176710,SATURDAY,1,0,12.8,74,9.4,1016.8,Fair
10/15/2022 13:00,645,755,1789820,782279,1400,2572099,SATURDAY,1,0,15,64,13,1016.6,Fair
10/15/2022 14:00,691,818,3053237,769060,1509,3822297,SATURDAY,1,0,17.2,54,9.4,1016.7,Fair
10/15/2022 15:00,651,789,1450318,796867,1440,2247185,SATURDAY,1,0,18.9,42,13,1016.5,Rain
10/15/2022 16:00,678,841,1547031,795637,1519,2342668,SATURDAY,1,0,20.6,33,13,1015.4,Fair
10/15/2022 17:00,553,758,2174621,656429,1311,2831050,SATURDAY,1,0,20.6,33,13,1015.4,Fair
10/15/2022 18:00,346,551,522760,459290,897,982050,SATURDAY,1,0,21.7,30,11.2,1014.2,Fair
10/15/2022 19:00,277,381,581318,410606,658,991924,SATURDAY,1,0,21.1,31,13,1013.9,Rain
10/15/2022 20:00,260,359,1040693,302599,619,1343292,SATURDAY,1,0,20.6,32,11.2,1013.8,Fair
10/15/2022 21:00,218,303,1339684,237552,521,1577236,SATURDAY,1,0,20.6,32,14.8,1014.3,Fair
10/15/2022 22:00,240,251,853619,222634,491,1076253,SATURDAY,1,0,16.1,75,14.8,1014.3,Fair
10/15/2022 23:00,229,177,673310,120287,406,793597,SATURDAY,1,0,14.4,81,13,1014.9,Fair
10/16/2022 0:00,180,138,1476520,107822,318,1584342,SUNDAY,1,0,14.4,81,13,1015,Fair
10/16/2022 1:00,84,75,138053,62414,159,200467,SUNDAY,1,0,13.3,80,11.2,1015.5,Clear
10/16/2022 2:00,21,21,23262,12308,42,35570,SUNDAY,1,0,12.2,80,9.4,1015.7,Clear
10/16/2022 3:00,7,8,7702,8294,15,15996,SUNDAY,1,0,12.2,80,9.4,1015.7,Clear
10/16/2022 4:00,10,25,216656,27951,35,244607,SUNDAY,1,0,11.7,80,7.6,1015,Clear
10/16/2022 5:00,18,61,15985,41603,79,57588,SUNDAY,1,0,12.8,74,5.4,1014.9,Clear
10/16/2022 6:00,49,102,65199,83808,151,149007,SUNDAY,1,0,12.2,80,5.4,1014.7,Clear
10/16/2022 7:00,99,226,265583,189050,325,454633,SUNDAY,1,0,12.2,80,5.4,1014.7,Clear
10/16/2022 8:00,205,377,466102,312549,582,778651,SUNDAY,1,0,11.7,86,9.4,1014.4,Clear
10/16/2022 9:00,339,530,667529,449917,869,1117446,SUNDAY,1,0,11.1,86,13,1014.5,Clear
10/16/2022 10:00,455,592,1024709,542726,1047,1567435,SUNDAY,1,0,11.7,86,0,1014.1,Rain
10/16/2022 11:00,489,683,1270488,792188,1172,2062676,SUNDAY,1,0,12.8,83,5.4,1014.8,Fair
10/16/2022 12:00,469,703,2213201,826100,1172,3039301,SUNDAY,1,0,12.8,83,5.4,1014.8,Fair
10/16/2022 13:00,573,694,3082720,784581,1267,3867301,SUNDAY,1,0,16.1,62,0,1014.5,Fair
10/16/2022 14:00,540,713,1006312,654126,1253,1660438,SUNDAY,1,0,17.2,54,5.4,1014.2,Fair
10/16/2022 15:00,541,753,1473710,681417,1294,2155127,SUNDAY,1,0,17.2,54,5.4,1014.2,Rain
10/16/2022 16:00,441,809,2350623,802997,1250,3153620,SUNDAY,1,0,18.3,52,5.4,1013.7,Fair
10/16/2022 17:00,313,675,800758,580425,988,1381183,SUNDAY,1,0,18.9,54,5.4,1011.9,Fair
10/16/2022 18:00,197,467,284271,421683,664,705954,SUNDAY,1,0,19.4,57,11.2,1011.6,Cloudy
10/16/2022 19:00,121,358,144786,268334,479,413120,SUNDAY,1,0,16.7,72,13,1011.9,Rain
10/16/2022 20:00,95,255,103083,193083,350,296166,SUNDAY,1,0,15,83,16.6,1011.8,Cloudy
10/16/2022 21:00,87,203,84380,144738,290,229118,SUNDAY,1,0,15,83,16.6,1011.8,Cloudy
10/16/2022 22:00,59,121,70374,126662,180,197036,SUNDAY,1,0,14.4,87,14.8,1010.9,Cloudy
10/16/2022 23:00,31,58,37727,39730,89,77457,SUNDAY,1,0,13.9,90,9.4,1010.9,Fair
10/17/2022 0:00,17,25,26803,12630,42,39433,MONDAY,0,0,13.9,90,0,1010.6,Fair
10/17/2022 1:00,12,16,12749,9066,28,21815,MONDAY,0,0,12.8,89,5.4,1010.6,Fair
10/17/2022 2:00,1,14,678,7865,15,8543,MONDAY,0,0,12.8,89,5.4,1010.6,Fair
10/17/2022 3:00,6,11,7146,8366,17,15512,MONDAY,0,0,13.3,87,7.6,1010.4,Fair
10/17/2022 4:00,11,72,382693,48378,83,431071,MONDAY,0,0,12.2,90,9.4,1009.8,Fair
10/17/2022 5:00,27,215,25481,139093,242,164574,MONDAY,0,0,12.2,77,7.6,1009.8,Fair
10/17/2022 6:00,80,568,69374,605890,648,675264,MONDAY,0,0,11.7,77,5.4,1009.4,Cloudy
10/17/2022 7:00,139,982,297962,725596,1121,1023558,MONDAY,0,0,11.7,77,5.4,1009.4,Cloudy
10/17/2022 8:00,114,592,161811,439238,706,601049,MONDAY,0,0,10.6,80,5.4,1009.2,Cloudy
10/17/2022 9:00,131,407,230252,264755,538,495007,MONDAY,0,0,10.6,83,9.4,1009.3,Cloudy
10/17/2022 10:00,120,417,357577,261532,537,619109,MONDAY,0,0,10.6,86,5.4,1009.2,Cloudy
10/17/2022 11:00,146,457,187731,281189,603,468920,MONDAY,0,0,10.6,86,5.4,1009.2,Cloudy
10/17/2022 12:00,146,450,201881,316649,596,518530,MONDAY,0,0,11.7,80,0,1009.1,Cloudy
10/17/2022 13:00,104,439,300332,436273,543,736605,MONDAY,0,0,11.7,80,0,1009.1,Cloudy
10/17/2022 14:00,48,263,62426,167937,311,230363,MONDAY,0,0,12.8,80,0,1008.7,Cloudy
10/17/2022 15:00,136,685,243911,513737,821,757648,MONDAY,0,0,13.3,80,7.6,1008.6,Cloudy
10/17/2022 16:00,226,1091,312694,831441,1317,1144135,MONDAY,0,0,13.3,80,7.6,1008.6,Cloudy
10/17/2022 17:00,173,850,226096,730542,1023,956638,MONDAY,0,0,13.9,74,14.8,1007,Cloudy
10/17/2022 18:00,118,587,115835,383872,705,499707,MONDAY,0,0,13.9,74,14.8,1007,Cloudy
10/17/2022 19:00,107,400,137895,271131,507,409026,MONDAY,0,0,14.4,93,18.4,1005,Cloudy
10/17/2022 20:00,71,260,65957,173428,331,239385,MONDAY,0,0,14.4,97,7.6,1005,Rain
10/17/2022 21:00,63,189,61667,130844,252,192511,MONDAY,0,0,15,93,7.6,1005,Rain
10/17/2022 22:00,27,112,29293,68887,139,98180,MONDAY,0,0,15,96,7.6,1005,Cloudy
10/17/2022 23:00,16,73,15380,47161,89,62541,MONDAY,0,0,15.6,93,16.6,1004.6,Cloudy
10/18/2022 0:00,9,20,13892,14615,29,28507,TUESDAY,0,0,15.6,96,13,1004.2,Rain
10/18/2022 1:00,3,10,5080,16462,13,21542,TUESDAY,0,0,15.6,96,13,1004.2,Rain
10/18/2022 2:00,4,6,11745,4494,10,16239,TUESDAY,0,0,15.6,96,14.8,1003.6,Rain
10/18/2022 3:00,2,8,1888,5687,10,7575,TUESDAY,0,0,15.6,93,9.4,1002.4,Rain
10/18/2022 4:00,5,39,29308,23193,44,52501,TUESDAY,0,0,15.6,96,0,1002.2,Rain
10/18/2022 5:00,17,151,27215,106132,168,133347,TUESDAY,0,0,15.6,96,0,1001.8,Rain
10/18/2022 6:00,71,511,57485,369836,582,427321,TUESDAY,0,0,15.6,96,9.4,1001.9,Rain
10/18/2022 7:00,153,1050,240186,778451,1203,1018637,TUESDAY,0,0,15.6,96,9.4,1001.9,Rain
10/18/2022 8:00,101,674,139815,476348,775,616163,TUESDAY,0,0,15.6,96,7.6,1001.2,Rain
10/18/2022 9:00,104,449,203766,312027,553,515793,TUESDAY,0,0,15.6,96,9.4,1002,Rain
10/18/2022 10:00,120,457,1382435,306832,577,1689267,TUESDAY,0,0,15.6,96,9.4,1002,Rain
10/18/2022 11:00,133,578,183528,374155,711,557683,TUESDAY,0,0,15.6,96,13,1001.4,Rain
10/18/2022 12:00,137,512,202513,340069,649,542582,TUESDAY,0,0,16.1,97,18.4,1001.8,Rain
10/18/2022 13:00,196,544,961489,386908,740,1348397,TUESDAY,0,0,16.7,90,16.6,1001.6,Rain
10/18/2022 14:00,219,627,584351,2183558,846,2767909,TUESDAY,0,0,16.7,90,16.6,1001.6,Rain
10/18/2022 15:00,273,982,400168,759709,1255,1159877,TUESDAY,0,0,17.8,84,14.8,1001.8,Cloudy
10/18/2022 16:00,409,1404,558946,1769661,1813,2328607,TUESDAY,0,0,19.4,73,18.4,1001.8,Cloudy
10/18/2022 17:00,301,1142,1182343,839267,1443,2021610,TUESDAY,0,0,19.4,66,22.3,1001.7,Cloudy
10/18/2022 18:00,202,729,567122,655863,931,1222985,TUESDAY,0,0,18.9,65,20.5,1002.1,Cloudy
10/18/2022 19:00,127,475,257533,346782,602,604315,TUESDAY,0,0,18.3,63,24.1,1002.7,Rain
10/18/2022 20:00,81,321,92886,273290,402,366176,TUESDAY,0,0,17.2,60,22.3,1003.3,Cloudy
10/18/2022 21:00,150,263,197218,266716,413,463934,TUESDAY,0,0,17.2,60,22.3,1003.3,Cloudy
10/18/2022 22:00,48,149,88144,93253,197,181397,TUESDAY,0,0,15.6,62,11.2,1003.9,Cloudy
10/18/2022 23:00,17,65,16794,39758,82,56552,TUESDAY,0,0,14.4,62,11.2,1004,Cloudy
10/19/2022 0:00,6,35,3552,19025,41,22577,WEDNESDAY,0,0,14.4,62,11.2,1004,Fair
10/19/2022 1:00,7,16,6731,12377,23,19108,WEDNESDAY,0,0,12.8,57,16.6,1004.1,Fair
10/19/2022 2:00,3,8,1241,3250,11,4491,WEDNESDAY,0,0,12.8,57,16.6,1004.1,Fair
10/19/2022 3:00,4,12,3286,20275,16,23561,WEDNESDAY,0,0,11.1,57,13,1004.3,Fair
10/19/2022 4:00,15,60,17644,46788,75,64432,WEDNESDAY,0,0,10,61,9.4,1004.5,Fair
10/19/2022 5:00,33,234,69497,157799,267,227296,WEDNESDAY,0,0,10,58,14.8,1004.8,Fair
10/19/2022 6:00,95,643,88494,483446,738,571940,WEDNESDAY,0,0,10,58,14.8,1004.8,Clear
10/19/2022 7:00,171,1169,173531,836790,1340,1010321,WEDNESDAY,0,0,8.9,61,14.8,1005.2,Clear
10/19/2022 8:00,138,728,141009,531270,866,672279,WEDNESDAY,0,0,7.8,65,14.8,1005.7,Clear
10/19/2022 9:00,110,482,173185,350493,592,523678,WEDNESDAY,0,0,8.3,63,16.6,1006,Clear
10/19/2022 10:00,124,499,367441,377032,623,744473,WEDNESDAY,0,0,8.3,63,16.6,1006,Rain
10/19/2022 11:00,149,539,228201,357953,688,586154,WEDNESDAY,0,0,7.2,74,14.8,1007.2,Fair
10/19/2022 12:00,163,542,430768,383164,705,813932,WEDNESDAY,0,0,8.9,66,11.2,1007.7,Fair
10/19/2022 13:00,184,559,281362,451530,743,732892,WEDNESDAY,0,0,10,61,20.5,1008.3,Fair
10/19/2022 14:00,207,599,334532,437057,806,771589,WEDNESDAY,0,0,12.2,50,16.6,1008.6,Fair
10/19/2022 15:00,266,999,327693,731192,1265,1058885,WEDNESDAY,0,0,12.2,50,16.6,1008.6,Rain
10/19/2022 16:00,326,1372,414101,1058284,1698,1472385,WEDNESDAY,0,0,13.9,34,29.5,1008.3,Fair
10/19/2022 17:00,279,1001,965325,752998,1280,1718323,WEDNESDAY,0,0,13.3,35,20.5,1008.5,Fair
10/19/2022 18:00,156,716,1153733,1276333,872,2430066,WEDNESDAY,0,0,13.9,34,20.5,1008.3,Fair
10/19/2022 19:00,137,453,124566,363216,590,487782,WEDNESDAY,0,0,13.9,34,22.3,1008.5,Rain
10/19/2022 20:00,110,325,121922,236465,435,358387,WEDNESDAY,0,0,13.9,34,22.3,1008.5,Cloudy
10/19/2022 21:00,56,194,52501,131519,250,184020,WEDNESDAY,0,0,13.3,35,18.4,1008.2,Cloudy
10/19/2022 22:00,37,126,36485,101808,163,138293,WEDNESDAY,0,0,10.6,46,20.5,1009.8,Fair
10/19/2022 23:00,20,59,16598,37866,79,54464,WEDNESDAY,0,0,10,50,16.6,1010.6,Fair
10/20/2022 0:00,20,33,34236,25305,53,59541,THURSDAY,0,0,9.4,54,18.4,1010.9,Fair
10/20/2022 1:00,2,20,11152,13361,22,24513,THURSDAY,0,0,9.4,54,18.4,1010.9,Fair
10/20/2022 2:00,2,7,737,5580,9,6317,THURSDAY,0,0,8.9,56,22.3,1011.3,Fair
10/20/2022 3:00,2,11,3008,8052,13,11060,THURSDAY,0,0,8.3,56,20.5,1011.9,Fair
10/20/2022 4:00,11,65,9397,37685,76,47082,THURSDAY,0,0,8.9,54,22.3,1011.8,Clear
10/20/2022 5:00,41,214,248286,144759,255,393045,THURSDAY,0,0,7.2,63,16.6,1012.2,Clear
10/20/2022 6:00,87,585,124378,1984056,672,2108434,THURSDAY,0,0,7.2,60,22.3,1012.1,Clear
10/20/2022 7:00,169,1112,198184,830398,1281,1028582,THURSDAY,0,0,7.2,60,22.3,1012.1,Clear
10/20/2022 8:00,125,666,127014,460745,791,587759,THURSDAY,0,0,6.7,65,20.5,1012.6,Clear
10/20/2022 9:00,110,439,152510,328487,549,480997,THURSDAY,0,0,6.7,65,20.5,1013.1,Clear
10/20/2022 10:00,114,448,197737,311940,562,509677,THURSDAY,0,0,5.6,70,22.3,1013.4,Rain
10/20/2022 11:00,162,523,315148,630068,685,945216,THURSDAY,0,0,5.6,70,22.3,1013.4,Fair
10/20/2022 12:00,174,502,266554,605455,676,872009,THURSDAY,0,0,8.3,63,24.1,1014.6,Fair
10/20/2022 13:00,199,534,266896,614551,733,881447,THURSDAY,0,0,9.4,59,24.1,1015,Fair
10/20/2022 14:00,240,651,320887,477972,891,798859,THURSDAY,0,0,9.4,59,24.1,1015,Fair
10/20/2022 15:00,305,943,684422,815516,1248,1499938,THURSDAY,0,0,11.7,48,24.1,1014.6,Fair
10/20/2022 16:00,411,1293,629625,1034953,1704,1664578,THURSDAY,0,0,13.9,34,38.9,1013.7,Fair
10/20/2022 17:00,312,1011,505060,791277,1323,1296337,THURSDAY,0,0,13.9,34,33.5,1013.7,Fair
10/20/2022 18:00,192,659,1631595,573366,851,2204961,THURSDAY,0,0,14.4,28,29.5,1012.8,Fair
10/20/2022 19:00,137,483,455239,386198,620,841437,THURSDAY,0,0,14.4,33,27.7,1012.7,Rain
10/20/2022 20:00,91,353,93901,257917,444,351818,THURSDAY,0,0,14.4,33,33.5,1012.7,Fair
10/20/2022 21:00,127,269,132069,189228,396,321297,THURSDAY,0,0,13.9,33,33.5,1012.7,Fair
10/20/2022 22:00,82,142,149108,127755,224,276863,THURSDAY,0,0,11.7,45,20.5,1014.4,Fair
10/20/2022 23:00,40,88,1448929,57655,128,1506584,THURSDAY,0,0,11.7,45,20.5,1014.4,Fair
10/21/2022 0:00,31,53,1487605,32193,84,1519798,FRIDAY,0,0,10,56,16.6,1016.1,Fair
10/21/2022 1:00,11,21,15328,13278,32,28606,FRIDAY,0,0,10,56,16.6,1016.1,Clear
10/21/2022 2:00,9,10,5963,24760,19,30723,FRIDAY,0,0,9.4,63,14.8,1017.3,Clear
10/21/2022 3:00,9,15,6888,10404,24,17292,FRIDAY,0,0,9.4,66,18.4,1017.1,Clear
10/21/2022 4:00,14,61,15512,48910,75,64422,FRIDAY,0,0,8.9,71,13,1017.1,Clear
10/21/2022 5:00,31,171,59110,137817,202,196927,FRIDAY,0,0,8.9,71,9.4,1017.8,Clear
10/21/2022 6:00,75,457,118457,369253,532,487710,FRIDAY,0,0,8.9,73,9.4,1017.6,Clear
10/21/2022 7:00,163,819,255752,602517,982,858269,FRIDAY,0,0,8.9,73,9.4,1017.6,Clear
10/21/2022 8:00,165,636,312078,456603,801,768681,FRIDAY,0,0,7.8,76,16.6,1017.7,Clear
10/21/2022 9:00,185,449,449721,314936,634,764657,FRIDAY,0,0,8.3,71,16.6,1018.6,Clear
10/21/2022 10:00,227,526,497908,369025,753,866933,FRIDAY,0,0,9.4,56,13,1019.1,Rain
10/21/2022 11:00,244,619,1352805,486346,863,1839151,FRIDAY,0,0,9.4,56,13,1019.1,Fair
10/21/2022 12:00,287,649,399225,1218624,936,1617849,FRIDAY,0,0,11.1,52,7.6,1021,Fair
10/21/2022 13:00,338,677,632715,533642,1015,1166357,FRIDAY,0,0,12.8,41,5.4,1021.2,Fair
10/21/2022 14:00,445,742,815453,575137,1187,1390590,FRIDAY,0,0,13.9,34,0,1021.1,Fair
10/21/2022 15:00,427,924,1424159,761543,1351,2185702,FRIDAY,0,0,13.9,34,0,1021.1,Rain
10/21/2022 16:00,458,1168,741843,959684,1626,1701527,FRIDAY,0,0,14.4,39,9.4,1020.9,Fair
10/21/2022 17:00,408,914,571784,722236,1322,1294020,FRIDAY,0,0,16.1,39,11.2,1020.1,Fair
10/21/2022 18:00,271,632,2570020,493446,903,3063466,FRIDAY,0,0,15,47,11.2,1019.7,Fair
10/21/2022 19:00,232,395,397080,292199,627,689279,FRIDAY,0,0,14.4,60,20.5,1019.5,Rain
10/21/2022 20:00,215,374,459820,277504,589,737324,FRIDAY,0,0,14.4,60,20.5,1019.5,Fair
10/21/2022 21:00,204,325,242225,234035,529,476260,FRIDAY,0,0,15,53,22.3,1019.6,Fair
10/21/2022 22:00,171,213,629237,152195,384,781432,FRIDAY,0,0,15,53,22.3,1019.6,Fair
10/21/2022 23:00,161,173,311139,125489,334,436628,FRIDAY,0,0,13.9,59,20.5,1020.3,Fair
10/22/2022 0:00,157,155,242687,126196,312,368883,SATURDAY,1,0,13.9,62,20.5,1021,Fair
10/22/2022 1:00,84,73,200600,57912,157,258512,SATURDAY,1,0,12.2,72,14.8,1021.9,Clear
10/22/2022 2:00,26,17,43808,8961,43,52769,SATURDAY,1,0,12.2,72,14.8,1021.9,Clear
10/22/2022 3:00,8,9,7067,8046,17,15113,SATURDAY,1,0,11.7,77,14.8,1022.4,Clear
10/22/2022 4:00,6,19,4085,15315,25,19400,SATURDAY,1,0,10.6,83,9.4,1022.6,Clear
10/22/2022 5:00,37,68,40093,54207,105,94300,SATURDAY,1,0,10.6,83,9.4,1022.6,Clear
10/22/2022 6:00,62,116,247075,88909,178,335984,SATURDAY,1,0,10,86,13,1023.1,Clear
10/22/2022 7:00,146,270,807547,228779,416,1036326,SATURDAY,1,0,10,86,13,1022.9,Clear
10/22/2022 8:00,276,395,1120195,368360,671,1488555,SATURDAY,1,0,9.4,90,9.4,1023.2,Clear
10/22/2022 9:00,414,508,1074611,472723,922,1547334,SATURDAY,1,0,8.9,93,5.4,1023.7,Clear
10/22/2022 10:00,542,637,1322241,950160,1179,2272401,SATURDAY,1,0,8.9,93,5.4,1023.7,Rain
10/22/2022 11:00,709,732,1882232,1327978,1441,3210210,SATURDAY,1,0,10.6,86,11.2,1024.5,Clear
10/22/2022 12:00,833,761,2343198,873148,1594,3216346,SATURDAY,1,0,11.7,83,11.2,1025.2,Fair
10/22/2022 13:00,914,790,2318653,824062,1704,3142715,SATURDAY,1,0,14.4,67,11.2,1025.4,Fair
10/22/2022 14:00,911,770,2977180,808532,1681,3785712,SATURDAY,1,0,16.1,54,13,1025.6,Fair
10/22/2022 15:00,823,824,2589979,791961,1647,3381940,SATURDAY,1,0,16.1,54,13,1025.6,Rain
10/22/2022 16:00,753,789,2670186,682675,1542,3352861,SATURDAY,1,0,18.9,37,18.4,1024.8,Fair
10/22/2022 17:00,487,651,733557,534009,1138,1267566,SATURDAY,1,0,20,35,16.6,1024.8,Fair
10/22/2022 18:00,420,519,1022737,548801,939,1571538,SATURDAY,1,0,20,37,16.6,1024.6,Fair
10/22/2022 19:00,276,393,480668,298691,669,779359,SATURDAY,1,0,19.4,42,13,1024.5,Rain
10/22/2022 20:00,221,288,1245952,226209,509,1472161,SATURDAY,1,0,19.4,42,13,1024.5,Fair
10/22/2022 21:00,253,288,392924,219291,541,612215,SATURDAY,1,0,18.3,47,13,1024.5,Fair
10/22/2022 22:00,218,248,1364493,203096,466,1567589,SATURDAY,1,0,16.7,54,14.8,1024.9,Fair
10/22/2022 23:00,201,167,1866557,131897,368,1998454,SATURDAY,1,0,15,62,9.4,1025.1,Fair
10/23/2022 0:00,232,138,779293,162096,370,941389,SUNDAY,1,0,14.4,65,11.2,1025.9,Fair
10/23/2022 1:00,119,79,842096,105315,198,947411,SUNDAY,1,0,13.3,75,0,1026.4,Fair
10/23/2022 2:00,25,28,24289,15331,53,39620,SUNDAY,1,0,13.3,75,0,1026.4,Fair
10/23/2022 3:00,12,15,12893,9973,27,22866,SUNDAY,1,0,13.3,75,5.4,1026.6,Fair
10/23/2022 4:00,13,24,15500,22319,37,37819,SUNDAY,1,0,11.7,86,14.8,1026.9,Cloudy
10/23/2022 5:00,23,48,42147,30113,71,72260,SUNDAY,1,0,11.1,89,5.4,1026.6,Cloudy
10/23/2022 6:00,68,99,305690,94668,167,400358,SUNDAY,1,0,11.1,86,5.4,1026.7,Cloudy
10/23/2022 7:00,136,204,344399,155991,340,500390,SUNDAY,1,0,10.6,89,7.6,1026.6,Cloudy
10/23/2022 8:00,223,263,490930,236453,486,727383,SUNDAY,1,0,10.6,86,0,1026.7,Cloudy
10/23/2022 9:00,366,404,1054102,344110,770,1398212,SUNDAY,1,0,11.7,80,5.4,1026.6,Cloudy
10/23/2022 10:00,492,533,1964671,494166,1025,2458837,SUNDAY,1,0,11.7,80,5.4,1026.6,Rain
10/23/2022 11:00,506,668,1374173,564103,1174,1938276,SUNDAY,1,0,11.1,80,7.6,1027.5,Cloudy
10/23/2022 12:00,426,642,950602,605071,1068,1555673,SUNDAY,1,0,11.7,80,0,1028.2,Cloudy
10/23/2022 13:00,434,641,1850188,532547,1075,2382735,SUNDAY,1,0,12.2,75,5.4,1028.4,Cloudy
10/23/2022 14:00,303,416,473052,296567,719,769619,SUNDAY,1,0,12.2,75,5.4,1028.4,Cloudy
10/23/2022 15:00,167,319,802255,250764,486,1053019,SUNDAY,1,0,13.9,77,13,1028.2,Cloudy
10/23/2022 16:00,81,236,84036,161299,317,245335,SUNDAY,1,0,13.9,77,13,1028.2,Cloudy
10/23/2022 17:00,74,287,71880,197399,361,269279,SUNDAY,1,0,13.9,77,13,1027.7,Cloudy
10/23/2022 18:00,79,291,92076,180947,370,273023,SUNDAY,1,0,14.4,78,16.6,1027,Cloudy
10/23/2022 19:00,44,211,40702,129923,255,170625,SUNDAY,1,0,14.4,78,16.6,1027,Cloudy
10/23/2022 20:00,45,190,43287,138262,235,181549,SUNDAY,1,0,13.3,75,13,1027.1,Cloudy
10/23/2022 21:00,40,154,92245,101062,194,193307,SUNDAY,1,0,12.8,77,16.6,1026.6,Cloudy
10/23/2022 22:00,33,111,51837,77038,144,128875,SUNDAY,1,0,12.8,80,16.6,1026.8,Rain
10/23/2022 23:00,35,42,46072,22765,77,68837,SUNDAY,1,0,12.8,80,16.6,1026.4,Rain
10/24/2022 0:00,26,25,63807,19776,51,83583,MONDAY,0,0,12.8,80,16.6,1026.4,Rain
10/24/2022 1:00,3,6,2103,2518,9,4621,MONDAY,0,0,12.2,75,24.1,1025.5,Rain
10/24/2022 2:00,0,4,0,4080,4,4080,MONDAY,0,0,12.2,77,14.8,1025.5,Rain
10/24/2022 3:00,4,6,631343,5826,10,637169,MONDAY,0,0,12.2,77,14.8,1025.5,Rain
10/24/2022 4:00,8,41,6327,32165,49,38492,MONDAY,0,0,12.2,77,18.4,1024.8,Rain
10/24/2022 5:00,26,162,19998,105337,188,125335,MONDAY,0,0,11.7,89,16.6,1024.8,Cloudy
10/24/2022 6:00,52,360,44243,252914,412,297157,MONDAY,0,0,11.7,100,13,1024,Cloudy
10/24/2022 7:00,132,788,107241,572972,920,680213,MONDAY,0,0,11.7,96,13,1024.1,Cloudy
10/24/2022 8:00,116,469,133713,346413,585,480126,MONDAY,0,0,11.1,97,14.8,1024.6,Cloudy
10/24/2022 9:00,80,379,113926,261925,459,375851,MONDAY,0,0,11.1,97,14.8,1024.6,Rain
10/24/2022 10:00,85,359,109792,244389,444,354181,MONDAY,0,0,11.7,96,14.8,1024.2,Rain
10/24/2022 11:00,78,366,109548,238580,444,348128,MONDAY,0,0,12.2,97,13,1024.7,Cloudy
10/24/2022 12:00,75,332,111448,219717,407,331165,MONDAY,0,0,12.8,100,13,1024.5,Cloudy
10/24/2022 13:00,102,448,143818,307710,550,451528,MONDAY,0,0,12.8,100,13,1024.5,Cloudy
10/24/2022 14:00,123,424,150449,276478,547,426927,MONDAY,0,0,13.9,93,14.8,1024.4,Cloudy
10/24/2022 15:00,100,475,339978,355802,575,695780,MONDAY,0,0,14.4,97,9.4,1024.5,Rain
10/24/2022 16:00,156,872,634518,670085,1028,1304603,MONDAY,0,0,15,93,11.2,1023.7,Cloudy
10/24/2022 17:00,132,789,264240,556015,921,820255,MONDAY,0,0,15.6,93,7.6,1023.5,Cloudy
10/24/2022 18:00,104,542,107550,356622,646,464172,MONDAY,0,0,15.6,93,11.2,1023.5,Rain
10/24/2022 19:00,89,317,103187,211011,406,314198,MONDAY,0,0,15.6,93,11.2,1023.5,Rain
10/24/2022 20:00,64,296,66979,211108,360,278087,MONDAY,0,0,14.4,100,7.6,1022.9,Cloudy
10/24/2022 21:00,49,183,61414,125260,232,186674,MONDAY,0,0,14.4,100,7.6,1022.9,Cloudy
10/24/2022 22:00,36,98,32330,65415,134,97745,MONDAY,0,0,13.9,100,9.4,1022.7,Cloudy
10/24/2022 23:00,27,61,30151,42244,88,72395,MONDAY,0,0,14.4,97,11.2,1023.5,Cloudy
10/25/2022 0:00,39,37,110832,22057,76,132889,TUESDAY,0,0,14.4,97,11.2,1023.5,Cloudy
10/25/2022 1:00,6,10,5367,5183,16,10550,TUESDAY,0,0,14.4,97,11.2,1023.2,Cloudy
10/25/2022 2:00,6,10,10686,5302,16,15988,TUESDAY,0,0,13.9,100,7.6,1023.4,Cloudy
10/25/2022 3:00,2,7,920,6194,9,7114,TUESDAY,0,0,13.9,100,7.6,1023.4,Cloudy
10/25/2022 4:00,14,74,13634,52817,88,66451,TUESDAY,0,0,14.4,97,7.6,1023.4,Cloudy
10/25/2022 5:00,30,213,21803,146747,243,168550,TUESDAY,0,0,14.4,100,5.4,1023,Rain
10/25/2022 6:00,97,520,79105,398452,617,477557,TUESDAY,0,0,13.9,100,0,1022.5,Cloudy
10/25/2022 7:00,137,1059,160100,1124589,1196,1284689,TUESDAY,0,0,13.9,100,5.4,1022.3,Cloudy
10/25/2022 8:00,112,624,238545,463759,736,702304,TUESDAY,0,0,13.9,100,5.4,1022.3,Cloudy
10/25/2022 9:00,89,424,140277,292196,513,432473,TUESDAY,0,0,13.9,100,5.4,1022.5,Cloudy
10/25/2022 10:00,112,391,192813,362391,503,555204,TUESDAY,0,0,13.9,100,5.4,1022.5,Cloudy
10/25/2022 11:00,125,520,178120,371840,645,549960,TUESDAY,0,0,13.9,100,5.4,1022.6,Cloudy
10/25/2022 12:00,122,484,194168,380282,606,574450,TUESDAY,0,0,15,100,7.6,1022.9,Cloudy
10/25/2022 13:00,150,480,216427,333982,630,550409,TUESDAY,0,0,15,100,7.6,1022.9,Cloudy
10/25/2022 14:00,161,608,193012,678724,769,871736,TUESDAY,0,0,15,100,7.6,1022.9,Cloudy
10/25/2022 15:00,120,559,138835,402939,679,541774,TUESDAY,0,0,15,100,9.4,1022.9,Cloudy
10/25/2022 16:00,232,1031,265298,858310,1263,1123608,TUESDAY,0,0,15.6,100,9.4,1021.7,Cloudy
10/25/2022 17:00,167,830,195336,628013,997,823349,TUESDAY,0,0,15.6,100,9.4,1021.7,Cloudy
10/25/2022 18:00,118,531,269389,391773,649,661162,TUESDAY,0,0,15.6,100,7.6,1021,Cloudy
10/25/2022 19:00,42,338,38681,370430,380,409111,TUESDAY,0,0,16.1,100,9.4,1020,Cloudy
10/25/2022 20:00,72,223,77550,161095,295,238645,TUESDAY,0,0,15.6,100,9.4,1019.8,Cloudy
10/25/2022 21:00,45,164,45951,117213,209,163164,TUESDAY,0,0,16.1,100,13,1019.3,Cloudy
10/25/2022 22:00,11,30,6975,19767,41,26742,TUESDAY,0,0,16.1,100,13,1019.3,Cloudy
10/25/2022 23:00,19,43,21157,26391,62,47548,TUESDAY,0,0,16.1,100,11.2,1019.1,Cloudy
10/26/2022 0:00,12,24,15068,22084,36,37152,WEDNESDAY,0,0,16.1,100,13,1019.1,Cloudy
10/26/2022 1:00,9,10,7817,8135,19,15952,WEDNESDAY,0,0,15.6,100,11.2,1018.6,Cloudy
10/26/2022 2:00,2,8,2343,6881,10,9224,WEDNESDAY,0,0,15,100,11.2,1017.8,Cloudy
10/26/2022 3:00,4,9,2762,8272,13,11034,WEDNESDAY,0,0,15,100,11.2,1017.8,Cloudy
10/26/2022 4:00,10,67,8961,54565,77,63526,WEDNESDAY,0,0,15,100,11.2,1017.3,Cloudy
10/26/2022 5:00,21,205,19907,280482,226,300389,WEDNESDAY,0,0,15,100,9.4,1016.6,Cloudy
10/26/2022 6:00,68,511,58994,405110,579,464104,WEDNESDAY,0,0,15,100,11.2,1015.3,Cloudy
10/26/2022 7:00,105,905,91928,777445,1010,869373,WEDNESDAY,0,0,15,100,11.2,1015.3,Cloudy
10/26/2022 8:00,72,492,113747,334919,564,448666,WEDNESDAY,0,0,15,100,14.8,1014.8,Cloudy
10/26/2022 9:00,23,136,47646,94718,159,142364,WEDNESDAY,0,0,15,100,11.2,1014.4,Cloudy
10/26/2022 10:00,26,153,18544,97982,179,116526,WEDNESDAY,0,0,15,100,9.4,1013.3,Cloudy
10/26/2022 11:00,65,385,81821,257393,450,339214,WEDNESDAY,0,0,15,100,9.4,1012.9,Cloudy
10/26/2022 12:00,83,378,125928,246758,461,372686,WEDNESDAY,0,0,15,100,9.4,1012.5,Cloudy
10/26/2022 13:00,83,366,312044,241278,449,553322,WEDNESDAY,0,0,15,100,9.4,1012.5,Rain
10/26/2022 14:00,102,478,700024,328745,580,1028769,WEDNESDAY,0,0,15.6,100,5.4,1012.2,Rain
10/26/2022 15:00,151,727,233959,541320,878,775279,WEDNESDAY,0,0,15.6,100,11.2,1010.1,Rain
10/26/2022 16:00,207,1160,314510,940870,1367,1255380,WEDNESDAY,0,0,16.7,100,14.8,1009.1,Cloudy
10/26/2022 17:00,166,994,155976,746651,1160,902627,WEDNESDAY,0,0,16.7,100,14.8,1009.1,Rain
10/26/2022 18:00,163,657,187007,508092,820,695099,WEDNESDAY,0,0,17.2,100,9.4,1008.4,Cloudy
10/26/2022 19:00,76,444,76254,365491,520,441745,WEDNESDAY,0,0,18.3,97,0,1006.9,Cloudy
10/26/2022 20:00,72,356,442269,405799,428,848068,WEDNESDAY,0,0,17.2,97,5.4,1006.3,Cloudy
10/26/2022 21:00,64,233,69582,180454,297,250036,WEDNESDAY,0,0,17.2,97,5.4,1006.3,Cloudy
10/26/2022 22:00,38,127,109855,93686,165,203541,WEDNESDAY,0,0,15,100,9.4,1006.2,Cloudy
10/26/2022 23:00,26,59,447107,40740,85,487847,WEDNESDAY,0,0,15,100,9.4,1006.2,Cloudy
10/27/2022 0:00,14,35,14432,25399,49,39831,THURSDAY,0,0,15,100,7.6,1006.3,Cloudy
10/27/2022 1:00,4,18,2726,18833,22,21559,THURSDAY,0,0,15.6,100,5.4,1006.7,Cloudy
10/27/2022 2:00,3,12,4194,11445,15,15639,THURSDAY,0,0,15.6,100,5.4,1006.7,Cloudy
10/27/2022 3:00,2,13,2797,17078,15,19875,THURSDAY,0,0,17.2,100,7.6,1006.6,Cloudy
10/27/2022 4:00,12,65,8125,44452,77,52577,THURSDAY,0,0,16.1,100,13,1006.3,Cloudy
10/27/2022 5:00,28,232,24280,182595,260,206875,THURSDAY,0,0,17.2,97,20.5,1007,Cloudy
10/27/2022 6:00,123,626,161897,449802,749,611699,THURSDAY,0,0,16.7,96,14.8,1007.5,Cloudy
10/27/2022 7:00,165,1102,200302,851068,1267,1051370,THURSDAY,0,0,17.2,90,20.5,1008.4,Cloudy
10/27/2022 8:00,136,699,180736,643795,835,824531,THURSDAY,0,0,17.2,84,20.5,1009.3,Fair
10/27/2022 9:00,116,546,186670,379058,662,565728,THURSDAY,0,0,17.2,84,22.3,1009.3,Fair
10/27/2022 10:00,138,505,179252,365123,643,544375,THURSDAY,0,0,16.1,78,18.4,1011,Rain
10/27/2022 11:00,185,597,860551,576669,782,1437220,THURSDAY,0,0,16.7,78,20.5,1012.2,Fair
10/27/2022 12:00,152,559,193848,540240,711,734088,THURSDAY,0,0,16.7,86,22.3,1013.6,Fair
10/27/2022 13:00,229,588,388050,519246,817,907296,THURSDAY,0,0,16.7,86,22.3,1013.6,Fair
10/27/2022 14:00,248,698,424314,537105,946,961419,THURSDAY,0,0,18.9,63,22.3,1015.3,Fair
10/27/2022 15:00,332,940,1105824,799437,1272,1905261,THURSDAY,0,0,19.4,52,25.9,1016.2,Rain
10/27/2022 16:00,425,1370,666941,1144879,1795,1811820,THURSDAY,0,0,19.4,52,29.5,1016.2,Fair
10/27/2022 17:00,308,1052,397495,873663,1360,1271158,THURSDAY,0,0,18.9,40,31.7,1017.6,Fair
10/27/2022 18:00,224,712,718168,515279,936,1233447,THURSDAY,0,0,18.9,40,31.7,1017.6,Fair
10/27/2022 19:00,157,497,215873,474253,654,690126,THURSDAY,0,0,17.8,34,31.7,1019.6,Rain
10/27/2022 20:00,135,387,686244,299279,522,985523,THURSDAY,0,0,17.2,35,29.5,1020.8,Fair
10/27/2022 21:00,104,278,96167,212287,382,308454,THURSDAY,0,0,15.6,39,18.4,1022.2,Fair
10/27/2022 22:00,68,185,74294,162017,253,236311,THURSDAY,0,0,15.6,39,18.4,1022.2,Fair
10/27/2022 23:00,41,110,30775,132782,151,163557,THURSDAY,0,0,15,41,18.4,1024,Fair
10/28/2022 0:00,38,48,54904,36029,86,90933,FRIDAY,0,0,12.2,47,20.5,1026.1,Clear
10/28/2022 1:00,25,39,32722,35160,64,67882,FRIDAY,0,0,10.6,46,20.5,1027.1,Clear
10/28/2022 2:00,7,19,10009,13249,26,23258,FRIDAY,0,0,10,50,16.6,1028,Clear
10/28/2022 3:00,3,11,3230,8411,14,11641,FRIDAY,0,0,10,50,16.6,1028,Clear
10/28/2022 4:00,7,49,5953,39537,56,45490,FRIDAY,0,0,7.8,60,14.8,1029.6,Clear
10/28/2022 5:00,32,170,26679,124134,202,150813,FRIDAY,0,0,7.2,63,13,1030.5,Clear
10/28/2022 6:00,64,407,94031,300092,471,394123,FRIDAY,0,0,6.7,62,14.8,1031.1,Clear
10/28/2022 7:00,128,774,328919,579867,902,908786,FRIDAY,0,0,6.1,65,13,1031.4,Clear
10/28/2022 8:00,123,607,164161,416954,730,581115,FRIDAY,0,0,5.6,67,11.2,1032.1,Clear
10/28/2022 9:00,132,417,278178,269392,549,547570,FRIDAY,0,0,5.6,67,11.2,1032.1,Clear
10/28/2022 10:00,135,435,250525,289445,570,539970,FRIDAY,0,0,5.6,64,16.6,1033.1,Rain
10/28/2022 11:00,171,533,440703,345204,704,785907,FRIDAY,0,0,6.1,65,14.8,1033.8,Fair
10/28/2022 12:00,249,574,755182,402501,823,1157683,FRIDAY,0,0,7.8,63,14.8,1034.7,Fair
10/28/2022 13:00,247,580,390293,441000,827,831293,FRIDAY,0,0,7.8,63,14.8,1034.7,Fair
10/28/2022 14:00,267,645,535558,463801,912,999359,FRIDAY,0,0,10.6,59,18.4,1035.1,Cloudy
10/28/2022 15:00,332,838,490216,749840,1170,1240056,FRIDAY,0,0,10.6,61,20.5,1035.4,Rain
10/28/2022 16:00,380,991,873139,813241,1371,1686380,FRIDAY,0,0,11.1,57,16.6,1034.9,Cloudy
10/28/2022 17:00,269,807,758160,622731,1076,1380891,FRIDAY,0,0,10,61,20.5,1034.5,Cloudy
10/28/2022 18:00,192,575,464309,527001,767,991310,FRIDAY,0,0,10,61,20.5,1034.5,Cloudy
10/28/2022 19:00,134,390,556147,277508,524,833655,FRIDAY,0,0,10,58,14.8,1034.5,Rain
10/28/2022 20:00,128,298,133757,716036,426,849793,FRIDAY,0,0,9.4,61,13,1034.5,Cloudy
10/28/2022 21:00,145,253,337680,200187,398,537867,FRIDAY,0,0,8.3,63,13,1034.5,Cloudy
10/28/2022 22:00,139,218,1368728,148882,357,1517610,FRIDAY,0,0,8.3,65,11.2,1034.3,Cloudy
10/28/2022 23:00,160,182,209170,682150,342,891320,FRIDAY,0,0,8.3,65,11.2,1034.3,Cloudy
10/29/2022 0:00,245,154,343185,172155,399,515340,SATURDAY,1,0,7.2,74,7.6,1034.2,Cloudy
10/29/2022 1:00,101,76,473017,59369,177,532386,SATURDAY,1,0,8.3,74,9.4,1034.5,Cloudy
10/29/2022 2:00,17,23,17556,12562,40,30118,SATURDAY,1,0,7.8,83,9.4,1034.1,Cloudy
10/29/2022 3:00,11,19,281983,12027,30,294010,SATURDAY,1,0,7.8,79,9.4,1033.5,Cloudy
10/29/2022 4:00,5,21,3880,14412,26,18292,SATURDAY,1,0,7.8,79,9.4,1033.5,Cloudy
10/29/2022 5:00,21,51,26753,31882,72,58635,SATURDAY,1,0,6.7,79,13,1033.5,Cloudy
10/29/2022 6:00,20,116,17331,74676,136,92007,SATURDAY,1,0,6.1,79,13,1033.6,Cloudy
10/29/2022 7:00,80,178,114453,132533,258,246986,SATURDAY,1,0,5.6,82,13,1033.4,Cloudy
10/29/2022 8:00,133,327,323564,348111,460,671675,SATURDAY,1,0,5.6,82,9.4,1032.8,Cloudy
10/29/2022 9:00,196,442,346687,370285,638,716972,SATURDAY,1,0,5.6,82,9.4,1032.8,Fair
10/29/2022 10:00,336,577,982195,482838,913,1465033,SATURDAY,1,0,5,79,11.2,1032.4,Rain
10/29/2022 11:00,422,651,1905318,571484,1073,2476802,SATURDAY,1,0,5,79,16.6,1032.6,Fair
10/29/2022 12:00,506,654,1591134,637009,1160,2228143,SATURDAY,1,0,7.2,80,13,1033,Fair
10/29/2022 13:00,495,692,980238,710174,1187,1690412,SATURDAY,1,0,7.2,80,13,1033,Fair
10/29/2022 14:00,583,638,1131381,602858,1221,1734239,SATURDAY,1,0,11.7,66,13,1033.3,Fair
10/29/2022 15:00,447,702,970928,631396,1149,1602324,SATURDAY,1,0,12.2,64,11.2,1032.9,Rain
10/29/2022 16:00,397,765,1954844,691031,1162,2645875,SATURDAY,1,0,12.2,66,9.4,1032.1,Fair
10/29/2022 17:00,280,601,467254,472138,881,939392,SATURDAY,1,0,12.2,66,11.2,1031.4,Fair
10/29/2022 18:00,279,489,673617,366388,768,1040005,SATURDAY,1,0,12.2,66,11.2,1031.4,Fair
10/29/2022 19:00,203,372,255442,289723,575,545165,SATURDAY,1,0,11.7,66,13,1030.1,Rain
10/29/2022 20:00,172,329,184015,253095,501,437110,SATURDAY,1,0,11.1,71,11.2,1029.7,Fair
10/29/2022 21:00,168,276,429348,229322,444,658670,SATURDAY,1,0,10.6,74,9.4,1029.7,Fair
10/29/2022 22:00,158,161,216925,126031,319,342956,SATURDAY,1,0,10.6,71,0,1030,Fair
10/29/2022 23:00,170,192,177246,149353,362,326599,SATURDAY,1,0,10.6,71,0,1030,Fair
10/30/2022 0:00,357,200,1742180,171596,557,1913776,SUNDAY,1,0,10,80,0,1029,Clear
10/30/2022 1:00,162,123,274198,97996,285,372194,SUNDAY,1,0,8.3,97,9.4,1028.6,Clear
10/30/2022 2:00,25,36,63355,40958,61,104313,SUNDAY,1,0,8.3,83,7.6,1028.2,Clear
10/30/2022 3:00,19,16,42596,13448,35,56044,SUNDAY,1,0,8.3,83,7.6,1028.2,Clear
10/30/2022 4:00,9,20,11181,17058,29,28239,SUNDAY,1,0,7.2,86,0,1027.2,Clear
10/30/2022 5:00,8,40,5705,26135,48,31840,SUNDAY,1,0,6.1,86,11.2,1026.6,Clear
10/30/2022 6:00,33,67,49112,61620,100,110732,SUNDAY,1,0,6.7,79,0,1026.5,Clear
10/30/2022 7:00,79,164,136439,135917,243,272356,SUNDAY,1,0,5,89,0,1026,Clear
10/30/2022 8:00,118,232,209155,200641,350,409796,SUNDAY,1,0,5,89,0,1026,Clear
10/30/2022 9:00,206,414,359321,349646,620,708967,SUNDAY,1,0,5.6,85,7.6,1025.7,Clear
10/30/2022 10:00,315,481,672843,404081,796,1076924,SUNDAY,1,0,6.1,82,0,1025.5,Rain
10/30/2022 11:00,423,569,894695,541148,992,1435843,SUNDAY,1,0,5.6,85,0,1025.4,Clear
10/30/2022 12:00,482,670,1178786,614456,1152,1793242,SUNDAY,1,0,7.8,83,0,1025.3,Fair
10/30/2022 13:00,475,595,932233,549842,1070,1482075,SUNDAY,1,0,7.8,83,0,1025.3,Fair
10/30/2022 14:00,489,680,1392404,670355,1169,2062759,SUNDAY,1,0,12.2,61,5.4,1024.8,Fair
10/30/2022 15:00,473,757,1314638,683760,1230,1998398,SUNDAY,1,0,13.9,51,5.4,1024.7,Fair
10/30/2022 16:00,362,656,525892,575833,1018,1101725,SUNDAY,1,0,16.7,39,0,1023.7,Fair
10/30/2022 17:00,220,619,269024,475984,839,745008,SUNDAY,1,0,16.7,39,0,1023.7,Fair
10/30/2022 18:00,122,391,187761,281592,513,469353,SUNDAY,1,0,16.1,53,11.2,1022.4,Fair
10/30/2022 19:00,139,324,177820,233803,463,411623,SUNDAY,1,0,14.4,62,20.5,1021.9,Rain
10/30/2022 20:00,121,290,348973,373229,411,722202,SUNDAY,1,0,13.9,62,18.4,1021.2,Fair
10/30/2022 21:00,131,181,191498,154695,312,346193,SUNDAY,1,0,13.3,77,13,1021,Fair
10/30/2022 22:00,52,126,59998,78007,178,138005,SUNDAY,1,0,13.3,77,13,1021,Fair
10/30/2022 23:00,36,49,45642,32340,85,77982,SUNDAY,1,0,12.2,53,9.4,1020.8,Fair
10/31/2022 0:00,21,33,65177,19179,54,84356,MONDAY,0,0,12.2,49,7.6,1021.2,Fair
10/31/2022 1:00,7,18,4929,8297,25,13226,MONDAY,0,0,10,58,9.4,1021.2,Fair
10/31/2022 2:00,4,12,2359,8189,16,10548,MONDAY,0,0,8.3,68,7.6,1021.2,Fair
10/31/2022 3:00,5,7,2939,4606,12,7545,MONDAY,0,0,8.3,68,7.6,1021.2,Fair
10/31/2022 4:00,11,79,21805,56943,90,78748,MONDAY,0,0,8.3,93,9.4,1020.5,Fair
10/31/2022 5:00,25,188,16274,130784,213,147058,MONDAY,0,0,8.3,93,9.4,1020.5,Fair
10/31/2022 6:00,76,501,67338,387023,577,454361,MONDAY,0,0,8.9,96,7.6,1019.7,Cloudy
10/31/2022 7:00,124,886,141606,627638,1010,769244,MONDAY,0,0,9.4,100,11.2,1019.4,Cloudy
10/31/2022 8:00,86,616,132662,454723,702,587385,MONDAY,0,0,9.4,100,11.2,1019.4,Cloudy
10/31/2022 9:00,109,430,205639,317212,539,522851,MONDAY,0,0,9.4,100,7.6,1018.8,Cloudy
10/31/2022 10:00,131,416,269747,302505,547,572252,MONDAY,0,0,8.9,96,13,1019,Cloudy
10/31/2022 11:00,158,552,336934,381271,710,718205,MONDAY,0,0,9.4,100,9.4,1019.1,Cloudy
10/31/2022 12:00,160,485,290794,339215,645,630009,MONDAY,0,0,9.4,100,9.4,1019.1,Cloudy
10/31/2022 13:00,171,570,293731,432876,741,726607,MONDAY,0,0,12.8,100,11.2,1018.8,Cloudy
10/31/2022 14:00,208,650,362823,465761,858,828584,MONDAY,0,0,12.8,100,11.2,1018.8,Cloudy
10/31/2022 15:00,267,938,399284,726168,1205,1125452,MONDAY,0,0,17.2,67,22.3,1017.8,Rain
10/31/2022 16:00,326,1203,622480,942781,1529,1565261,MONDAY,0,0,18.9,61,22.3,1016.9,Cloudy
10/31/2022 17:00,233,895,334426,669167,1128,1003593,MONDAY,0,0,18.9,61,22.3,1016.9,Cloudy
10/31/2022 18:00,172,703,1073449,511596,875,1585045,MONDAY,0,0,20,61,22.3,1015.2,Cloudy
10/31/2022 19:00,164,488,351037,352144,652,703181,MONDAY,0,0,19.4,63,25.9,1014.8,Cloudy
10/31/2022 20:00,100,362,180419,287839,462,468258,MONDAY,0,0,18.9,65,20.5,1014.7,Cloudy
10/31/2022 21:00,70,225,73693,165246,295,238939,MONDAY,0,0,16.7,80,13,1014.9,Cloudy
10/31/2022 22:00,62,134,288947,88118,196,377065,MONDAY,0,0,16.7,80,13,1014.9,Cloudy
10/31/2022 23:00,30,60,37998,39839,90,77837,MONDAY,0,0,15.6,90,16.6,1015.4,Cloudy
11/1/2022 0:00,27,35,40106,20823,62,60929,TUESDAY,0,0,15.6,86,9.4,1015.5,Cloudy
11/1/2022 1:00,17,24,36114,40439,41,76553,TUESDAY,0,0,15.6,86,9.4,1015.5,Cloudy
11/1/2022 2:00,5,7,27617,9661,12,37278,TUESDAY,0,0,15.6,86,11.2,1015.3,Cloudy
11/1/2022 3:00,2,11,893,7806,13,8699,TUESDAY,0,0,15.6,86,11.2,1015.3,Cloudy
11/1/2022 4:00,5,63,5330,40271,68,45601,TUESDAY,0,0,15,90,13,1014.8,Cloudy
11/1/2022 5:00,19,109,14755,70080,128,84835,TUESDAY,0,0,15,90,11.2,1014.9,Cloudy
11/1/2022 6:00,65,470,76143,346260,535,422403,TUESDAY,0,0,15.6,80,11.2,1014.9,Cloudy
11/1/2022 7:00,133,1049,118460,768851,1182,887311,TUESDAY,0,0,14.4,90,7.6,1014.8,Cloudy
11/1/2022 8:00,90,680,94686,789336,770,884022,TUESDAY,0,0,14.4,90,7.6,1014.8,Cloudy
11/1/2022 9:00,70,444,97514,1481768,514,1579282,TUESDAY,0,0,14.4,90,13,1015.1,Cloudy
11/1/2022 10:00,94,436,374285,293290,530,667575,TUESDAY,0,0,13.9,96,7.6,1015.1,Rain
11/1/2022 11:00,132,488,225381,309055,620,534436,TUESDAY,0,0,14.4,97,9.4,1015.6,Cloudy
11/1/2022 12:00,123,474,179719,316355,597,496074,TUESDAY,0,0,15,93,13,1016,Cloudy
11/1/2022 13:00,133,504,173126,358031,637,531157,TUESDAY,0,0,15,93,13,1016,Cloudy
11/1/2022 14:00,157,569,966603,421679,726,1388282,TUESDAY,0,0,16.7,93,14.8,1016,Cloudy
11/1/2022 15:00,225,885,464812,800535,1110,1265347,TUESDAY,0,0,16.7,90,13,1015.9,Cloudy
11/1/2022 16:00,258,1281,332369,956532,1539,1288901,TUESDAY,0,0,16.7,90,11.2,1015.5,Cloudy
11/1/2022 17:00,212,963,467091,736511,1175,1203602,TUESDAY,0,0,17.8,84,11.2,1013.8,Cloudy
11/1/2022 18:00,161,712,198510,492085,873,690595,TUESDAY,0,0,17.8,84,13,1013.5,Cloudy
11/1/2022 19:00,100,436,106674,299092,536,405766,TUESDAY,0,0,17.8,84,13,1013.5,Cloudy
11/1/2022 20:00,75,329,103297,238782,404,342079,TUESDAY,0,0,17.8,87,11.2,1013.2,Cloudy
11/1/2022 21:00,51,209,52363,220815,260,273178,TUESDAY,0,0,17.8,84,11.2,1014.1,Cloudy
11/1/2022 22:00,59,117,129017,76925,176,205942,TUESDAY,0,0,17.2,84,11.2,1014.6,Cloudy
11/1/2022 23:00,24,59,27720,41874,83,69594,TUESDAY,0,0,17.2,84,11.2,1014.6,Cloudy
11/2/2022 0:00,16,22,12356,12682,38,25038,WEDNESDAY,0,0,16.7,90,18.4,1015.2,Cloudy
11/2/2022 1:00,7,9,5833,6629,16,12462,WEDNESDAY,0,0,16.1,84,16.6,1015.6,Cloudy
11/2/2022 2:00,3,13,2054,14622,16,16676,WEDNESDAY,0,0,15.6,90,18.4,1015.7,Fair
11/2/2022 3:00,7,8,11313,7831,15,19144,WEDNESDAY,0,0,15.6,83,13,1015.9,Fair
11/2/2022 4:00,9,74,29587,56239,83,85826,WEDNESDAY,0,0,15.6,83,13,1015.9,Fair
11/2/2022 5:00,27,233,25348,165049,260,190397,WEDNESDAY,0,0,15,83,14.8,1017.5,Fair
11/2/2022 6:00,93,610,82240,441943,703,524183,WEDNESDAY,0,0,15.6,86,16.6,1018.2,Clear
11/2/2022 7:00,160,1198,162557,872958,1358,1035515,WEDNESDAY,0,0,15,78,20.5,1019,Clear
11/2/2022 8:00,118,686,178880,522112,804,700992,WEDNESDAY,0,0,13.3,77,16.6,1020,Clear
11/2/2022 9:00,93,474,119496,378383,567,497879,WEDNESDAY,0,0,13.3,77,16.6,1020,Clear
11/2/2022 10:00,113,448,183703,320649,561,504352,WEDNESDAY,0,0,12.8,83,14.8,1021.8,Rain
11/2/2022 11:00,121,567,153105,416034,688,569139,WEDNESDAY,0,0,13.3,75,16.6,1023.1,Fair
11/2/2022 12:00,142,532,1049889,421509,674,1471398,WEDNESDAY,0,0,14.4,72,14.8,1024.3,Fair
11/2/2022 13:00,179,589,2731430,768888,768,3500318,WEDNESDAY,0,0,14.4,72,14.8,1024.3,Fair
11/2/2022 14:00,226,619,484656,499429,845,984085,WEDNESDAY,0,0,17.2,54,7.6,1025.5,Fair
11/2/2022 15:00,284,1027,423787,810455,1311,1234242,WEDNESDAY,0,0,18.9,47,11.2,1025.6,Fair
11/2/2022 16:00,337,1381,908898,1095740,1718,2004638,WEDNESDAY,0,0,20,40,13,1024.9,Fair
11/2/2022 17:00,215,1046,1833915,772364,1261,2606279,WEDNESDAY,0,0,20.6,38,5.4,1024.5,Fair
11/2/2022 18:00,194,721,198236,618027,915,816263,WEDNESDAY,0,0,20.6,38,5.4,1024.5,Fair
11/2/2022 19:00,108,451,112354,321644,559,433998,WEDNESDAY,0,0,18.3,48,7.6,1024.9,Fair
11/2/2022 20:00,78,356,542881,284434,434,827315,WEDNESDAY,0,0,18.3,48,7.6,1024.9,Fair
11/2/2022 21:00,71,247,159939,173415,318,333354,WEDNESDAY,0,0,13.3,75,11.2,1025.7,Fair
11/2/2022 22:00,26,135,18708,106902,161,125610,WEDNESDAY,0,0,12.2,90,5.4,1026.3,Fair
11/2/2022 23:00,31,46,268308,34310,77,302618,WEDNESDAY,0,0,12.2,90,5.4,1026.3,Fair
11/3/2022 0:00,10,39,7977,35061,49,43038,THURSDAY,0,0,11.7,86,5.4,1027.3,Fair
11/3/2022 1:00,9,15,19977,12091,24,32068,THURSDAY,0,0,11.7,83,0,1027.9,Clear
11/3/2022 2:00,0,9,0,12353,9,12353,THURSDAY,0,0,12.8,74,7.6,1028.3,Clear
11/3/2022 3:00,5,8,3928,5752,13,9680,THURSDAY,0,0,12.2,74,9.4,1028.3,Clear
11/3/2022 4:00,6,79,17543,56740,85,74283,THURSDAY,0,0,12.2,55,9.4,1028.3,Clear
11/3/2022 5:00,25,213,18040,149319,238,167359,THURSDAY,0,0,9.4,69,0,1028.7,Clear
11/3/2022 6:00,93,532,86182,1480527,625,1566709,THURSDAY,0,0,9.4,59,7.6,1028.7,Clear
11/3/2022 7:00,140,1129,126141,813759,1269,939900,THURSDAY,0,0,9.4,59,7.6,1028.9,Clear
11/3/2022 8:00,121,641,223298,459044,762,682342,THURSDAY,0,0,9.4,59,7.6,1028.9,Clear
11/3/2022 9:00,106,494,135554,388049,600,523603,THURSDAY,0,0,8.9,66,7.6,1029.8,Clear
11/3/2022 10:00,147,487,229865,2700943,634,2930808,THURSDAY,0,0,8.3,71,9.4,1030.1,Clear
11/3/2022 11:00,165,578,244972,399192,743,644164,THURSDAY,0,0,9.4,69,5.4,1030.5,Fair
11/3/2022 12:00,136,531,187784,404732,667,592516,THURSDAY,0,0,10.6,66,0,1030.7,Fair
11/3/2022 13:00,183,529,303606,413501,712,717107,THURSDAY,0,0,10.6,66,0,1030.7,Fair
11/3/2022 14:00,232,671,734690,518370,903,1253060,THURSDAY,0,0,13.3,69,5.4,1030.4,Fair
11/3/2022 15:00,259,979,1315169,784317,1238,2099486,THURSDAY,0,0,14.4,67,9.4,1029.9,Fair
11/3/2022 16:00,357,1376,1042080,1162561,1733,2204641,THURSDAY,0,0,15.6,57,11.2,1028.9,Fair
11/3/2022 17:00,233,1013,484317,760629,1246,1244946,THURSDAY,0,0,15.6,57,13,1028.2,Fair
11/3/2022 18:00,188,684,204693,486911,872,691604,THURSDAY,0,0,15.6,67,13,1028.2,Fair
11/3/2022 19:00,111,517,872287,2628930,628,3501217,THURSDAY,0,0,15.6,67,16.6,1027.4,Fair
11/3/2022 20:00,97,405,122955,278164,502,401119,THURSDAY,0,0,15,75,7.6,1027.2,Fair
11/3/2022 21:00,80,296,75239,221703,376,296942,THURSDAY,0,0,15,64,9.4,1026.8,Fair
11/3/2022 22:00,46,145,73388,91684,191,165072,THURSDAY,0,0,15,49,20.5,1027,Fair
11/3/2022 23:00,53,101,66302,70300,154,136602,THURSDAY,0,0,15,49,20.5,1027,Fair
11/4/2022 0:00,22,50,27575,31161,72,58736,FRIDAY,0,0,13.3,72,22.3,1027.2,Clear
11/4/2022 1:00,14,26,41596,41114,40,82710,FRIDAY,0,0,13.3,72,22.3,1027.2,Clear
11/4/2022 2:00,10,10,10050,7418,20,17468,FRIDAY,0,0,11.7,80,14.8,1027.6,Clear
11/4/2022 3:00,6,14,14407,11781,20,26188,FRIDAY,0,0,11.7,80,14.8,1027.6,Clear
11/4/2022 4:00,8,63,7677,39583,71,47260,FRIDAY,0,0,11.7,83,22.3,1028,Clear
11/4/2022 5:00,24,183,24556,141297,207,165853,FRIDAY,0,0,11.7,83,22.3,1028,Clear
11/4/2022 6:00,63,430,52341,398654,493,450995,FRIDAY,0,0,10.6,89,18.4,1027.5,Clear
11/4/2022 7:00,136,864,128738,611557,1000,740295,FRIDAY,0,0,10.6,92,18.4,1027.2,Clear
11/4/2022 8:00,115,668,177945,519288,783,697233,FRIDAY,0,0,10.6,92,18.4,1027.2,Clear
11/4/2022 9:00,152,490,284588,323190,642,607778,FRIDAY,0,0,10.6,92,14.8,1027.1,Clear
11/4/2022 10:00,152,514,261308,495254,666,756562,FRIDAY,0,0,11.1,93,14.8,1027.3,Clear
11/4/2022 11:00,223,569,378331,437785,792,816116,FRIDAY,0,0,11.1,93,14.8,1027.3,Fair
11/4/2022 12:00,197,591,287214,411166,788,698380,FRIDAY,0,0,12.8,89,9.4,1028.3,Fair
11/4/2022 13:00,234,610,368117,511994,844,880111,FRIDAY,0,0,12.8,89,20.5,1028.3,Fair
11/4/2022 14:00,346,745,1922235,587091,1091,2509326,FRIDAY,0,0,16.7,86,22.3,1028.1,Fair
11/4/2022 15:00,427,970,789142,822250,1397,1611392,FRIDAY,0,0,18.9,75,18.4,1027.2,Fair
11/4/2022 16:00,482,1276,1741915,1064126,1758,2806041,FRIDAY,0,0,21.1,53,18.4,1026.1,Fair
11/4/2022 17:00,316,906,645313,731268,1222,1376581,FRIDAY,0,0,21.7,47,24.1,1025.5,Fair
11/4/2022 18:00,288,668,384758,510254,956,895012,FRIDAY,0,0,21.7,47,24.1,1025.5,Cloudy
11/4/2022 19:00,222,410,2818272,319038,632,3137310,FRIDAY,0,0,21.7,51,24.1,1024.8,Cloudy
11/4/2022 20:00,193,336,255917,250653,529,506570,FRIDAY,0,0,21.1,51,24.1,1024.9,Cloudy
11/4/2022 21:00,245,341,683563,294556,586,978119,FRIDAY,0,0,19.4,57,14.8,1025.2,Cloudy
11/4/2022 22:00,219,229,269142,227805,448,496947,FRIDAY,0,0,19.4,57,14.8,1025.2,Fair
11/4/2022 23:00,167,159,363630,123580,326,487210,FRIDAY,0,0,17.2,75,16.6,1025.8,Fair
11/5/2022 0:00,166,132,328691,103008,298,431699,SATURDAY,1,0,16.7,86,16.6,1025.7,Fair
11/5/2022 1:00,110,68,237517,54646,178,292163,SATURDAY,1,0,16.1,87,18.4,1025.6,Fair
11/5/2022 2:00,51,27,152497,19923,78,172420,SATURDAY,1,0,16.1,84,16.6,1025.5,Fair
11/5/2022 3:00,18,21,71074,13352,39,84426,SATURDAY,1,0,15.6,86,16.6,1025.3,Fair
11/5/2022 4:00,15,24,53488,17489,39,70977,SATURDAY,1,0,15.6,86,16.6,1025.3,Clear
11/5/2022 5:00,13,75,8279,52085,88,60364,SATURDAY,1,0,15,93,13,1024.7,Fair
11/5/2022 6:00,37,122,54251,92151,159,146402,SATURDAY,1,0,15.6,93,13,1024.8,Fair
11/5/2022 7:00,110,250,190095,192657,360,382752,SATURDAY,1,0,15.6,93,18.4,1024.4,Fair
11/5/2022 8:00,211,415,560567,370621,626,931188,SATURDAY,1,0,15.6,93,18.4,1024.4,Fair
11/5/2022 9:00,334,576,805273,1398048,910,2203321,SATURDAY,1,0,15,93,7.6,1024.4,Fair
11/5/2022 10:00,461,671,1107507,602139,1132,1709646,SATURDAY,1,0,14.4,93,7.6,1024.4,Cloudy
11/5/2022 11:00,582,785,1146941,785230,1367,1932171,SATURDAY,1,0,14.4,93,7.6,1024.4,Cloudy
11/5/2022 12:00,676,748,1414439,784076,1424,2198515,SATURDAY,1,0,16.1,97,9.4,1024.7,Cloudy
11/5/2022 13:00,793,796,3998949,836493,1589,4835442,SATURDAY,1,0,16.1,97,9.4,1024.7,Cloudy
11/5/2022 14:00,773,758,3648703,739189,1531,4387892,SATURDAY,1,0,21.1,82,18.4,1024.7,Fair
11/5/2022 15:00,743,784,2505676,829114,1527,3334790,SATURDAY,1,0,23.3,71,20.5,1024.2,Fair
11/5/2022 16:00,592,801,948607,818143,1393,1766750,SATURDAY,1,0,23.9,62,20.5,1023.3,Fair
11/5/2022 17:00,411,678,2263622,629644,1089,2893266,SATURDAY,1,0,24.4,60,27.7,1022.6,Cloudy
11/5/2022 18:00,321,528,1376913,405691,849,1782604,SATURDAY,1,0,24.4,60,25.9,1022.6,Cloudy
11/5/2022 19:00,235,423,405702,348028,658,753730,SATURDAY,1,0,22.8,64,18.4,1022.4,Cloudy
11/5/2022 20:00,232,336,1876892,319529,568,2196421,SATURDAY,1,0,22.8,61,18.4,1022.6,Cloudy
11/5/2022 21:00,213,253,3377464,203211,466,3580675,SATURDAY,1,0,22.8,61,25.9,1022.6,Cloudy
11/5/2022 22:00,187,250,1403534,192887,437,1596421,SATURDAY,1,0,20.6,78,22.3,1023.1,Cloudy
11/5/2022 23:00,183,173,459720,134628,356,594348,SATURDAY,1,0,18.3,87,22.3,1024,Cloudy
11/6/2022 0:00,207,133,1744715,128080,340,1872795,SUNDAY,1,0,18.9,84,20.5,1024.2,Cloudy
11/6/2022 1:00,118,105,470771,90819,223,561590,SUNDAY,1,0,18.3,90,18.4,1024.3,Cloudy
11/6/2022 2:00,45,43,86088,34815,88,120903,SUNDAY,1,0,18.9,84,18.4,1024.3,Cloudy
11/6/2022 3:00,20,19,42069,18802,39,60871,SUNDAY,1,0,18.9,84,18.4,1024.3,Cloudy
11/6/2022 4:00,6,12,5478,10178,18,15656,SUNDAY,1,0,18.9,84,22.3,1023.8,Cloudy
11/6/2022 5:00,19,32,27363,32180,51,59543,SUNDAY,1,0,20,78,27.7,1023.3,Cloudy
11/6/2022 6:00,58,136,103666,150733,194,254399,SUNDAY,1,0,19.4,81,24.1,1023,Cloudy
11/6/2022 7:00,144,174,937452,193270,318,1130722,SUNDAY,1,0,19.4,81,24.1,1023,Cloudy
11/6/2022 8:00,213,363,380457,349515,576,729972,SUNDAY,1,0,19.4,87,20.5,1022.2,Cloudy
11/6/2022 9:00,304,483,514387,413564,787,927951,SUNDAY,1,0,19.4,87,24.1,1022.2,Cloudy
11/6/2022 10:00,356,597,741699,483269,953,1224968,SUNDAY,1,0,18.9,93,24.1,1022.6,Cloudy
11/6/2022 11:00,440,647,912769,608759,1087,1521528,SUNDAY,1,0,18.9,93,25.9,1023.2,Cloudy
11/6/2022 12:00,511,712,2223818,681042,1223,2904860,SUNDAY,1,0,20.6,84,22.3,1023.9,Cloudy
11/6/2022 13:00,522,760,1383741,700898,1282,2084639,SUNDAY,1,0,20.6,84,22.3,1023.9,Cloudy
11/6/2022 14:00,484,660,2391879,588492,1144,2980371,SUNDAY,1,0,22.2,79,20.5,1023.3,Cloudy
11/6/2022 15:00,508,635,982973,627236,1143,1610209,SUNDAY,1,0,23.9,69,25.9,1022.5,Cloudy
11/6/2022 16:00,521,719,1432850,901584,1240,2334434,SUNDAY,1,0,23.9,62,29.5,1021.8,Cloudy
11/6/2022 17:00,335,614,1423240,509866,949,1933106,SUNDAY,1,0,23.9,62,38.9,1021.8,Cloudy
11/6/2022 18:00,222,590,1555283,433678,812,1988961,SUNDAY,1,0,24.4,58,25.9,1021,Cloudy
11/6/2022 19:00,237,416,567707,360325,653,928032,SUNDAY,1,0,23.9,60,31.7,1021.1,Cloudy
11/6/2022 20:00,122,338,250269,233543,460,483812,SUNDAY,1,0,23.3,60,27.7,1021.2,Cloudy
11/6/2022 21:00,115,280,365558,203368,395,568926,SUNDAY,1,0,22.8,64,24.1,1021.1,Cloudy
11/6/2022 22:00,103,209,189819,152073,312,341892,SUNDAY,1,0,22.8,64,24.1,1021.1,Cloudy
11/6/2022 23:00,74,133,1215256,95374,207,1310630,SUNDAY,1,0,20.6,84,18.4,1021.4,Cloudy
11/7/2022 0:00,33,70,63671,108856,103,172527,MONDAY,0,0,19.4,91,25.9,1021,Cloudy
11/7/2022 1:00,13,40,15954,28174,53,44128,MONDAY,0,0,19.4,91,22.3,1021.1,Cloudy
11/7/2022 2:00,8,21,11877,13236,29,25113,MONDAY,0,0,19.4,91,22.3,1021.1,Cloudy
11/7/2022 3:00,3,11,8026,8633,14,16659,MONDAY,0,0,19.4,91,25.9,1020.6,Cloudy
11/7/2022 4:00,5,15,2632,14187,20,16819,MONDAY,0,0,19.4,91,25.9,1020.6,Cloudy
11/7/2022 5:00,9,88,7538,66338,97,73876,MONDAY,0,0,19.4,87,22.3,1020,Cloudy
11/7/2022 6:00,44,262,53773,199430,306,253203,MONDAY,0,0,19.4,87,22.3,1019.9,Cloudy
11/7/2022 7:00,81,557,69485,402696,638,472181,MONDAY,0,0,19.4,91,22.3,1019.5,Cloudy
11/7/2022 8:00,121,926,139538,718373,1047,857911,MONDAY,0,0,19.4,91,22.3,1019.5,Cloudy
11/7/2022 9:00,94,596,157998,520999,690,678997,MONDAY,0,0,19.4,87,16.6,1018.8,Cloudy
11/7/2022 10:00,118,450,384159,487344,568,871503,MONDAY,0,0,19.4,87,16.6,1018.8,Cloudy
11/7/2022 11:00,136,444,266300,391615,580,657915,MONDAY,0,0,19.4,87,18.4,1018.9,Cloudy
11/7/2022 12:00,172,522,333704,396452,694,730156,MONDAY,0,0,19.4,87,18.4,1018.9,Cloudy
11/7/2022 13:00,186,539,509878,388565,725,898443,MONDAY,0,0,20.6,81,20.5,1019.3,Cloudy
11/7/2022 14:00,183,535,291406,409701,718,701107,MONDAY,0,0,21.7,76,18.4,1018.8,Cloudy
11/7/2022 15:00,252,724,405649,563830,976,969479,MONDAY,0,0,22.8,59,29.5,1018.6,Cloudy
11/7/2022 16:00,317,981,1082050,773526,1298,1855576,MONDAY,0,0,23.3,56,25.9,1017.8,Fair
11/7/2022 17:00,238,1081,286014,1716427,1319,2002441,MONDAY,0,0,23.3,56,25.9,1017.8,Fair
11/7/2022 18:00,209,851,1592333,1534284,1060,3126617,MONDAY,0,0,23.9,29,29.5,1017.4,Fair
11/7/2022 19:00,139,609,135561,457083,748,592644,MONDAY,0,0,23.3,29,29.5,1017.4,Fair
11/7/2022 20:00,122,460,381631,316969,582,698600,MONDAY,0,0,22.2,30,27.7,1017.1,Fair
11/7/2022 21:00,89,335,469558,288006,424,757564,MONDAY,0,0,22.2,30,24.1,1017.1,Fair
11/7/2022 22:00,79,187,111600,114624,266,226224,MONDAY,0,0,20.6,19,20.5,1019.8,Fair
11/7/2022 23:00,33,113,25493,69378,146,94871,MONDAY,0,0,18.3,16,33.5,1021.1,Clear
11/8/2022 0:00,30,50,31684,29531,80,61215,TUESDAY,0,0,17.2,17,22.3,1022.1,Clear
11/8/2022 1:00,16,23,27255,20482,39,47737,TUESDAY,0,0,15.6,21,20.5,1023.2,Clear
11/8/2022 2:00,3,12,2584,11328,15,13912,TUESDAY,0,0,15.6,21,20.5,1023.2,Clear
11/8/2022 3:00,1,8,1733,4807,9,6540,TUESDAY,0,0,13.3,38,16.6,1025,Clear
11/8/2022 4:00,6,15,10937,14496,21,25433,TUESDAY,0,0,12.8,40,14.8,1025.5,Clear
11/8/2022 5:00,16,93,13689,58566,109,72255,TUESDAY,0,0,11.7,43,14.8,1026.4,Clear
11/8/2022 6:00,40,246,66981,160797,286,227778,TUESDAY,0,0,11.1,41,18.4,1027,Clear
11/8/2022 7:00,96,675,88370,506219,771,594589,TUESDAY,0,0,11.1,41,18.4,1027,Clear
11/8/2022 8:00,159,1110,238148,912412,1269,1150560,TUESDAY,0,0,10,37,18.4,1027.8,Clear
11/8/2022 9:00,95,566,1812630,423295,661,2235925,TUESDAY,0,0,9.4,39,18.4,1028.5,Clear
11/8/2022 10:00,108,421,556613,298906,529,855519,TUESDAY,0,0,8.3,44,16.6,1029.2,Clear
11/8/2022 11:00,127,457,159387,835823,584,995210,TUESDAY,0,0,8.3,44,14.8,1030.1,Fair
11/8/2022 12:00,127,516,153962,1790067,643,1944029,TUESDAY,0,0,8.3,44,14.8,1030.1,Fair
11/8/2022 13:00,120,500,334461,315351,620,649812,TUESDAY,0,0,10,41,20.5,1031.1,Fair
11/8/2022 14:00,135,495,182856,338079,630,520935,TUESDAY,0,0,11.1,36,27.7,1031.6,Fair
11/8/2022 15:00,172,579,230749,409468,751,640217,TUESDAY,0,0,11.7,35,25.9,1031.6,Fair
11/8/2022 16:00,176,862,210376,626876,1038,837252,TUESDAY,0,0,11.7,35,25.9,1031.6,Fair
11/8/2022 17:00,177,1059,202339,816184,1236,1018523,TUESDAY,0,0,12.2,24,24.1,1031.3,Fair
11/8/2022 18:00,170,814,759674,565479,984,1325153,TUESDAY,0,0,11.7,24,24.1,1031.7,Fair
11/8/2022 19:00,105,526,173062,338978,631,512040,TUESDAY,0,0,11.1,26,25.9,1032.6,Fair
11/8/2022 20:00,83,350,75790,236288,433,312078,TUESDAY,0,0,10.6,26,25.9,1033.1,Fair
11/8/2022 21:00,59,260,546829,174685,319,721514,TUESDAY,0,0,10.6,26,31.7,1033.1,Fair
11/8/2022 22:00,29,149,33097,179953,178,213050,TUESDAY,0,0,8.9,29,22.3,1034.6,Fair
11/8/2022 23:00,36,92,75553,56344,128,131897,TUESDAY,0,0,8.3,31,22.3,1035.2,Fair
11/9/2022 0:00,13,42,13572,20954,55,34526,WEDNESDAY,0,0,7.2,34,24.1,1035.3,Clear
11/9/2022 1:00,7,7,6770,3720,14,10490,WEDNESDAY,0,0,6.1,38,18.4,1036.1,Clear
11/9/2022 2:00,3,16,2396,9124,19,11520,WEDNESDAY,0,0,6.1,38,18.4,1036.1,Clear
11/9/2022 3:00,4,8,2240,5048,12,7288,WEDNESDAY,0,0,5,45,16.6,1037.2,Clear
11/9/2022 4:00,0,17,0,39860,17,39860,WEDNESDAY,0,0,4.4,48,13,1037.4,Clear
11/9/2022 5:00,4,65,1948,47643,69,49591,WEDNESDAY,0,0,3.9,50,16.6,1037.6,Clear
11/9/2022 6:00,23,210,19762,140151,233,159913,WEDNESDAY,0,0,3.9,50,20.5,1038,Clear
11/9/2022 7:00,67,585,60042,410862,652,470904,WEDNESDAY,0,0,3.9,50,20.5,1038,Clear
11/9/2022 8:00,139,1080,134128,779706,1219,913834,WEDNESDAY,0,0,2.8,54,18.4,1038.2,Clear
11/9/2022 9:00,88,588,122099,395741,676,517840,WEDNESDAY,0,0,2.2,56,11.2,1038.4,Clear
11/9/2022 10:00,87,414,419380,319575,501,738955,WEDNESDAY,0,0,2.2,56,13,1038.2,Clear
11/9/2022 11:00,100,420,142113,283905,520,426018,WEDNESDAY,0,0,2.8,57,11.2,1038,Clear
11/9/2022 12:00,124,491,178915,341885,615,520800,WEDNESDAY,0,0,2.8,57,11.2,1038,Fair
11/9/2022 13:00,104,474,139199,325811,578,465010,WEDNESDAY,0,0,6.1,49,9.4,1038.3,Fair
11/9/2022 14:00,139,496,684583,335522,635,1020105,WEDNESDAY,0,0,7.8,49,7.6,1038.2,Fair
11/9/2022 15:00,155,550,248103,393249,705,641352,WEDNESDAY,0,0,7.8,49,7.6,1038.2,Fair
11/9/2022 16:00,178,852,947275,3092928,1030,4040203,WEDNESDAY,0,0,8.3,54,5.4,1037.6,Fair
11/9/2022 17:00,204,1063,672659,830950,1267,1503609,WEDNESDAY,0,0,8.3,56,11.2,1036.6,Fair
11/9/2022 18:00,177,877,257822,691311,1054,949133,WEDNESDAY,0,0,8.9,58,11.2,1036,Fair
11/9/2022 19:00,126,589,163673,424062,715,587735,WEDNESDAY,0,0,8.9,58,13,1035.5,Fair
11/9/2022 20:00,80,363,122448,280698,443,403146,WEDNESDAY,0,0,8.3,63,14.8,1034.9,Fair
11/9/2022 21:00,64,327,53220,216160,391,269380,WEDNESDAY,0,0,8.3,63,14.8,1034.9,Fair
11/9/2022 22:00,79,236,198334,173677,315,372011,WEDNESDAY,0,0,7.2,71,14.8,1034.2,Fair
11/9/2022 23:00,53,145,42358,1940553,198,1982911,WEDNESDAY,0,0,7.2,76,14.8,1033.7,Fair
11/10/2022 0:00,21,49,23639,27719,70,51358,THURSDAY,0,0,7.8,60,14.8,1033.2,Fair
11/10/2022 1:00,5,32,5805,18728,37,24533,THURSDAY,0,0,7.8,60,14.8,1033.2,Clear
11/10/2022 2:00,1,7,256,4807,8,5063,THURSDAY,0,0,7.2,65,20.5,1032.5,Clear
11/10/2022 3:00,4,9,2783,9989,13,12772,THURSDAY,0,0,7.2,74,16.6,1032.3,Clear
11/10/2022 4:00,3,11,9330,7656,14,16986,THURSDAY,0,0,6.7,79,13,1032,Clear
11/10/2022 5:00,13,59,14964,42873,72,57837,THURSDAY,0,0,6.7,82,16.6,1030.7,Clear
11/10/2022 6:00,30,198,20592,127623,228,148215,THURSDAY,0,0,6.7,82,16.6,1030.7,Clear
11/10/2022 7:00,77,562,66098,512822,639,578920,THURSDAY,0,0,7.2,82,20.5,1029.3,Clear
11/10/2022 8:00,142,1084,159515,1109207,1226,1268722,THURSDAY,0,0,7.2,86,20.5,1028.7,Clear
11/10/2022 9:00,104,627,162905,467913,731,630818,THURSDAY,0,0,7.2,86,24.1,1028.2,Clear
11/10/2022 10:00,116,457,173415,466739,573,640154,THURSDAY,0,0,7.2,86,22.3,1027.6,Clear
11/10/2022 11:00,104,460,141956,325433,564,467389,THURSDAY,0,0,7.8,89,22.3,1027.5,Fair
11/10/2022 12:00,137,526,243210,362818,663,606028,THURSDAY,0,0,7.8,89,24.1,1027.5,Fair
11/10/2022 13:00,141,501,195384,378876,642,574260,THURSDAY,0,0,9.4,80,20.5,1027.3,Fair
11/10/2022 14:00,148,536,569982,417891,684,987873,THURSDAY,0,0,14.4,56,33.5,1026,Fair
11/10/2022 15:00,238,654,338699,513473,892,852172,THURSDAY,0,0,16.1,44,35.3,1024.8,Fair
11/10/2022 16:00,289,904,1906982,707002,1193,2613984,THURSDAY,0,0,16.1,44,31.7,1024.8,Fair
11/10/2022 17:00,304,1137,396951,925132,1441,1322083,THURSDAY,0,0,19.4,40,24.1,1023.2,Fair
11/10/2022 18:00,226,1002,344487,733387,1228,1077874,THURSDAY,0,0,20.6,38,22.3,1022.6,Fair
11/10/2022 19:00,194,645,337591,476387,839,813978,THURSDAY,0,0,20,40,24.1,1022.3,Fair
11/10/2022 20:00,133,456,175877,351827,589,527704,THURSDAY,0,0,19.4,45,20.5,1022.1,Fair
11/10/2022 21:00,144,400,169832,297330,544,467162,THURSDAY,0,0,19.4,45,20.5,1022.1,Fair
11/10/2022 22:00,143,302,473277,243986,445,717263,THURSDAY,0,0,17.8,50,20.5,1022,Fair
11/10/2022 23:00,104,161,1588821,125852,265,1714673,THURSDAY,0,0,16.7,60,20.5,1022.1,Fair
11/11/2022 0:00,71,111,1812146,103461,182,1915607,FRIDAY,0,1,15,67,20.5,1022.1,Fair
11/11/2022 1:00,70,79,91648,56319,149,147967,FRIDAY,0,1,15,69,24.1,1021.8,Fair
11/11/2022 2:00,46,30,55017,36435,76,91452,FRIDAY,0,1,15,69,24.1,1021.8,Fair
11/11/2022 3:00,3,14,12889,15875,17,28764,FRIDAY,0,1,13.9,81,20.5,1021.4,Fair
11/11/2022 4:00,4,14,3414,8598,18,12012,FRIDAY,0,1,14.4,81,25.9,1021.4,Fair
11/11/2022 5:00,14,62,9886,43353,76,53239,FRIDAY,0,1,14.4,81,25.9,1020.9,Clear
11/11/2022 6:00,24,169,50949,125583,193,176532,FRIDAY,0,1,14.4,81,25.9,1020.9,Fair
11/11/2022 7:00,57,342,81767,342313,399,424080,FRIDAY,0,1,14.4,84,22.3,1020.7,Fair
11/11/2022 8:00,105,579,143809,405833,684,549642,FRIDAY,0,1,13.9,87,18.4,1020.7,Fair
11/11/2022 9:00,130,499,245507,339266,629,584773,FRIDAY,0,1,13.9,87,16.6,1020.7,Fair
11/11/2022 10:00,174,457,362184,316410,631,678594,FRIDAY,0,1,13.3,90,13,1020.5,Cloudy
11/11/2022 11:00,253,524,740303,1063630,777,1803933,FRIDAY,0,1,13.3,90,13,1020.5,Cloudy
11/11/2022 12:00,303,589,2102791,489948,892,2592739,FRIDAY,0,1,14.4,87,5.4,1020.9,Cloudy
11/11/2022 13:00,302,599,1055422,466797,901,1522219,FRIDAY,0,1,16.1,84,11.2,1020.6,Cloudy
11/11/2022 14:00,376,597,667149,419217,973,1086366,FRIDAY,0,1,16.1,87,5.4,1019.8,Cloudy
11/11/2022 15:00,365,700,1145703,1031829,1065,2177532,FRIDAY,0,1,16.1,87,5.4,1019.8,Cloudy
11/11/2022 16:00,223,598,727174,498581,821,1225755,FRIDAY,0,1,18.3,81,0,1019.1,Cloudy
11/11/2022 17:00,209,642,247871,468753,851,716624,FRIDAY,0,1,21.1,64,16.6,1017,Cloudy
11/11/2022 18:00,156,600,299652,427480,756,727132,FRIDAY,0,1,21.1,64,18.4,1016,Rain
11/11/2022 19:00,94,356,90952,240008,450,330960,FRIDAY,0,1,20,68,13,1015.4,Rain
11/11/2022 20:00,55,146,57571,248570,201,306141,FRIDAY,0,1,20,68,18.4,1014.7,Rain
11/11/2022 21:00,59,190,1837363,127480,249,1964843,FRIDAY,0,1,20,68,18.4,1014.7,Rain
11/11/2022 22:00,39,92,66418,129870,131,196288,FRIDAY,0,1,17.8,87,16.6,1012.9,Rain
11/11/2022 23:00,48,136,49581,111351,184,160932,FRIDAY,0,1,17.8,87,16.6,1012.9,Rain
11/12/2022 0:00,82,118,365168,82336,200,447504,SATURDAY,1,0,17.8,90,24.1,1011.5,Rain
11/12/2022 1:00,116,93,253326,73737,209,327063,SATURDAY,1,0,17.2,97,22.3,1009.7,Rain
11/12/2022 2:00,83,59,305041,47277,142,352318,SATURDAY,1,0,19.4,97,25.9,1006.3,Rain
11/12/2022 3:00,19,12,34485,9405,31,43890,SATURDAY,1,0,19.4,97,37.1,1006.3,Rain
11/12/2022 4:00,6,13,5405,6944,19,12349,SATURDAY,1,0,20.6,96,33.5,1004.4,Rain
11/12/2022 5:00,5,11,6613,7799,16,14412,SATURDAY,1,0,20.6,93,33.5,1003.4,Rain
11/12/2022 6:00,13,52,5102,31645,65,36747,SATURDAY,1,0,20.6,93,31.7,1003.4,Rain
11/12/2022 7:00,27,64,45166,41652,91,86818,SATURDAY,1,0,20,96,31.7,1002.3,Rain
11/12/2022 8:00,23,155,25050,103789,178,128839,SATURDAY,1,0,20.6,93,22.3,999.8,Rain
11/12/2022 9:00,82,255,80077,181000,337,261077,SATURDAY,1,0,20.6,93,22.3,998.9,Rain
11/12/2022 10:00,202,417,339213,309209,619,648422,SATURDAY,1,0,21.1,90,22.3,997.6,Rain
11/12/2022 11:00,385,615,714902,530022,1000,1244924,SATURDAY,1,0,21.1,90,27.7,997.6,Rain
11/12/2022 12:00,520,730,1245272,648079,1250,1893351,SATURDAY,1,0,20.6,93,27.7,995.2,Rain
11/12/2022 13:00,603,711,1297305,643605,1314,1940910,SATURDAY,1,0,21.1,90,25.9,994.3,Rain
11/12/2022 14:00,728,756,1429854,863545,1484,2293399,SATURDAY,1,0,21.1,90,25.9,994.3,Cloudy
11/12/2022 15:00,675,750,1699365,737647,1425,2437012,SATURDAY,1,0,20.6,90,37.1,994.5,Cloudy
11/12/2022 16:00,499,783,2659999,725237,1282,3385236,SATURDAY,1,0,23.3,64,27.7,996.8,Cloudy
11/12/2022 17:00,361,615,695716,489941,976,1185657,SATURDAY,1,0,24.4,56,27.7,997.8,Cloudy
11/12/2022 18:00,272,561,1661425,461478,833,2122903,SATURDAY,1,0,23.9,55,25.9,999.2,Cloudy
11/12/2022 19:00,267,437,1559951,338701,704,1898652,SATURDAY,1,0,21.1,61,24.1,1000.9,Cloudy
11/12/2022 20:00,181,298,258049,209304,479,467353,SATURDAY,1,0,21.1,61,24.1,1000.9,Fair
11/12/2022 21:00,198,280,806447,210136,478,1016583,SATURDAY,1,0,18.3,65,14.8,1003.2,Fair
11/12/2022 22:00,170,282,380931,232814,452,613745,SATURDAY,1,0,17.2,67,16.6,1004.7,Fair
11/12/2022 23:00,190,188,2129829,146739,378,2276568,SATURDAY,1,0,16.7,65,14.8,1005.3,Fair
11/13/2022 0:00,181,161,1153692,125262,342,1278954,SUNDAY,1,0,16.1,67,14.8,1006.1,Fair
11/13/2022 1:00,251,131,797426,99941,382,897367,SUNDAY,1,0,16.1,67,14.8,1006.1,Fair
11/13/2022 2:00,91,66,1181076,57795,157,1238871,SUNDAY,1,0,13.9,72,14.8,1007.5,Fair
11/13/2022 3:00,32,19,28446,14520,51,42966,SUNDAY,1,0,13.3,72,13,1007.4,Cloudy
11/13/2022 4:00,16,11,13609,9422,27,23031,SUNDAY,1,0,13.3,69,11.2,1007.9,Cloudy
11/13/2022 5:00,15,29,44975,20470,44,65445,SUNDAY,1,0,13.3,69,11.2,1007.9,Cloudy
11/13/2022 6:00,16,69,17488,50134,85,67622,SUNDAY,1,0,13.3,67,7.6,1008.1,Cloudy
11/13/2022 7:00,17,51,23197,48141,68,71338,SUNDAY,1,0,12.2,75,11.2,1008.3,Cloudy
11/13/2022 8:00,40,128,88587,100135,168,188722,SUNDAY,1,0,12.2,77,7.6,1008.1,Cloudy
11/13/2022 9:00,38,142,58108,87499,180,145607,SUNDAY,1,0,12.2,77,13,1008.3,Cloudy
11/13/2022 10:00,110,234,222989,178625,344,401614,SUNDAY,1,0,12.2,77,13,1008.3,Cloudy
11/13/2022 11:00,108,304,126284,326077,412,452361,SUNDAY,1,0,12.2,80,7.6,1008.4,Cloudy
11/13/2022 12:00,82,301,71511,224361,383,295872,SUNDAY,1,0,11.1,89,11.2,1008.6,Rain
11/13/2022 13:00,105,300,187096,191847,405,378943,SUNDAY,1,0,11.1,89,11.2,1008.6,Rain
11/13/2022 14:00,124,309,248396,238991,433,487387,SUNDAY,1,0,11.1,93,5.4,1007.9,Rain
11/13/2022 15:00,140,425,942348,285602,565,1227950,SUNDAY,1,0,11.1,93,5.4,1007.9,Rain
11/13/2022 16:00,138,435,240938,307759,573,548697,SUNDAY,1,0,10.6,89,14.8,1006.6,Rain
11/13/2022 17:00,124,423,266751,525724,547,792475,SUNDAY,1,0,10,89,18.4,1006.2,Rain
11/13/2022 18:00,88,367,225221,1944424,455,2169645,SUNDAY,1,0,10,89,18.4,1006.2,Rain
11/13/2022 19:00,65,311,438597,200642,376,639239,SUNDAY,1,0,10,89,18.4,1006.1,Cloudy
11/13/2022 20:00,61,233,46666,183923,294,230589,SUNDAY,1,0,10,89,18.4,1006.1,Cloudy
11/13/2022 21:00,58,160,54612,104734,218,159346,SUNDAY,1,0,10.6,80,24.1,1008,Cloudy
11/13/2022 22:00,39,154,34459,95567,193,130026,SUNDAY,1,0,9.4,69,25.9,1009.2,Cloudy
11/13/2022 23:00,20,89,14742,44511,109,59253,SUNDAY,1,0,8.9,68,27.7,1010.1,Cloudy
11/14/2022 0:00,24,44,31127,28345,68,59472,MONDAY,0,0,8.9,68,27.7,1010.1,Cloudy
11/14/2022 1:00,19,17,31251,11696,36,42947,MONDAY,0,0,7.2,58,24.1,1012.4,Cloudy
11/14/2022 2:00,2,17,3091,20101,19,23192,MONDAY,0,0,6.7,55,22.3,1013.2,Fair
11/14/2022 3:00,1,11,135,6649,12,6784,MONDAY,0,0,5.6,57,22.3,1013.8,Fair
11/14/2022 4:00,3,13,1383,11031,16,12414,MONDAY,0,0,5.6,55,24.1,1015,Fair
11/14/2022 5:00,8,52,4715,33297,60,38012,MONDAY,0,0,5.6,55,24.1,1015,Fair
11/14/2022 6:00,18,179,10478,141890,197,152368,MONDAY,0,0,4.4,55,16.6,1016.6,Clear
11/14/2022 7:00,42,465,63135,327760,507,390895,MONDAY,0,0,3.9,55,16.6,1017.3,Clear
11/14/2022 8:00,95,810,87639,594435,905,682074,MONDAY,0,0,3.9,52,18.4,1018.2,Clear
11/14/2022 9:00,57,497,63316,359326,554,422642,MONDAY,0,0,3.3,50,24.1,1019,Clear
11/14/2022 10:00,61,350,145231,244055,411,389286,MONDAY,0,0,3.3,50,24.1,1019,Fair
11/14/2022 11:00,87,362,158309,251172,449,409481,MONDAY,0,0,2.8,52,20.5,1020.9,Fair
11/14/2022 12:00,83,396,106198,247551,479,353749,MONDAY,0,0,3.3,52,20.5,1022,Fair
11/14/2022 13:00,98,403,119563,273629,501,393192,MONDAY,0,0,3.9,50,22.3,1022.7,Fair
11/14/2022 14:00,86,402,1042060,260498,488,1302558,MONDAY,0,0,3.9,50,22.3,1022.7,Fair
11/14/2022 15:00,99,420,107576,305988,519,413564,MONDAY,0,0,4.4,41,29.5,1023.8,Fair
11/14/2022 16:00,100,649,112907,1068812,749,1181719,MONDAY,0,0,4.4,41,29.5,1023.8,Fair
11/14/2022 17:00,111,820,173128,630554,931,803682,MONDAY,0,0,6.1,38,20.5,1023.8,Fair
11/14/2022 18:00,104,685,80863,1840462,789,1921325,MONDAY,0,0,6.7,36,18.4,1023.9,Fair
11/14/2022 19:00,64,503,64123,304220,567,368343,MONDAY,0,0,6.1,36,18.4,1024.6,Fair
11/14/2022 20:00,64,320,67013,205652,384,272665,MONDAY,0,0,6.1,36,18.4,1024.6,Fair
11/14/2022 21:00,37,197,90506,128089,234,218595,MONDAY,0,0,5,39,14.8,1026.2,Fair
11/14/2022 22:00,40,166,47398,283713,206,331111,MONDAY,0,0,4.4,39,13,1027.1,Fair
11/14/2022 23:00,22,95,22577,55502,117,78079,MONDAY,0,0,4.4,39,14.8,1027.9,Fair
11/15/2022 0:00,11,48,9717,26759,59,36476,TUESDAY,0,0,4.4,39,14.8,1027.9,Clear
11/15/2022 1:00,10,22,6987,13953,32,20940,TUESDAY,0,0,3.9,41,16.6,1029.2,Clear
11/15/2022 2:00,3,13,2409,9891,16,12300,TUESDAY,0,0,3.3,44,11.2,1029.8,Clear
11/15/2022 3:00,2,5,1212,22153,7,23365,TUESDAY,0,0,2.2,48,14.8,1030.1,Clear
11/15/2022 4:00,0,13,0,12797,13,12797,TUESDAY,0,0,1.7,52,9.4,1030.3,Clear
11/15/2022 5:00,3,51,7500,39395,54,46895,TUESDAY,0,0,1.7,52,9.4,1030.3,Clear
11/15/2022 6:00,20,181,11350,129852,201,141202,TUESDAY,0,0,1.1,54,11.2,1030.9,Clear
11/15/2022 7:00,59,508,56694,385833,567,442527,TUESDAY,0,0,1.1,54,11.2,1031.3,Clear
11/15/2022 8:00,95,924,95759,658390,1019,754149,TUESDAY,0,0,1.1,54,13,1031.2,Clear
11/15/2022 9:00,59,498,93165,480938,557,574103,TUESDAY,0,0,0.6,56,13,1031.9,Clear
11/15/2022 10:00,53,360,81498,1370573,413,1452071,TUESDAY,0,0,0.6,56,13,1031.9,Clear
11/15/2022 11:00,56,330,67191,216614,386,283805,TUESDAY,0,0,0.6,58,11.2,1032.9,Fair
11/15/2022 12:00,76,381,95074,265860,457,360934,TUESDAY,0,0,1.7,54,13,1033.4,Fair
11/15/2022 13:00,74,416,103381,273916,490,377297,TUESDAY,0,0,1.7,54,14.8,1033.3,Cloudy
11/15/2022 14:00,87,401,123630,266430,488,390060,TUESDAY,0,0,3.3,48,9.4,1033.1,Cloudy
11/15/2022 15:00,104,472,135261,324314,576,459575,TUESDAY,0,0,3.3,48,9.4,1033.1,Cloudy
11/15/2022 16:00,100,745,91539,628142,845,719681,TUESDAY,0,0,5,43,0,1031.8,Cloudy
11/15/2022 17:00,122,933,116647,766362,1055,883009,TUESDAY,0,0,5.6,41,9.4,1030.8,Cloudy
11/15/2022 18:00,115,695,259229,511657,810,770886,TUESDAY,0,0,5,48,9.4,1030.5,Cloudy
11/15/2022 19:00,82,528,94132,351352,610,445484,TUESDAY,0,0,5,46,5.4,1030.1,Cloudy
11/15/2022 20:00,47,372,44030,285897,419,329927,TUESDAY,0,0,5,46,5.4,1030.1,Cloudy
11/15/2022 21:00,47,262,71497,194532,309,266029,TUESDAY,0,0,4.4,46,7.6,1029.7,Cloudy
11/15/2022 22:00,31,180,27035,113481,211,140516,TUESDAY,0,0,5,48,13,1028.8,Cloudy
11/15/2022 23:00,11,63,11415,35938,74,47353,TUESDAY,0,0,5,51,11.2,1027.9,Cloudy
11/16/2022 0:00,8,26,12896,13472,34,26368,WEDNESDAY,0,0,5,51,11.2,1027.9,Cloudy
11/16/2022 1:00,3,9,2256,5403,12,7659,WEDNESDAY,0,0,6.1,47,9.4,1027.8,Cloudy
11/16/2022 2:00,3,10,1314,8105,13,9419,WEDNESDAY,0,0,5.6,55,13,1029.1,Rain
11/16/2022 3:00,1,3,1720,2265,4,3985,WEDNESDAY,0,0,3.9,67,14.8,1027.6,Rain
11/16/2022 4:00,1,11,398,7233,12,7631,WEDNESDAY,0,0,2.8,85,13,1027.1,Rain
11/16/2022 5:00,0,19,0,10767,19,10767,WEDNESDAY,0,0,2.8,85,13,1027.1,Rain
11/16/2022 6:00,5,55,3339,31400,60,34739,WEDNESDAY,0,0,3.9,93,16.6,1023.5,Rain
11/16/2022 7:00,14,136,8914,82651,150,91565,WEDNESDAY,0,0,6.1,82,27.7,1022.3,Rain
11/16/2022 8:00,31,354,72142,243023,385,315165,WEDNESDAY,0,0,6.7,85,27.7,1019.9,Rain
11/16/2022 9:00,25,247,15427,138912,272,154339,WEDNESDAY,0,0,6.7,85,27.7,1019.9,Rain
11/16/2022 10:00,20,176,12375,105995,196,118370,WEDNESDAY,0,0,10,93,33.5,1015.1,Rain
11/16/2022 11:00,30,226,27563,146354,256,173917,WEDNESDAY,0,0,10.6,96,31.7,1013.6,Rain
11/16/2022 12:00,33,277,36628,184206,310,220834,WEDNESDAY,0,0,11.1,97,29.5,1012,Rain
11/16/2022 13:00,43,323,45213,221607,366,266820,WEDNESDAY,0,0,11.7,96,27.7,1010.2,Rain
11/16/2022 14:00,67,351,88980,246037,418,335017,WEDNESDAY,0,0,11.7,96,27.7,1010.2,Rain
11/16/2022 15:00,64,409,59308,295292,473,354600,WEDNESDAY,0,0,12.8,96,5.4,1006.1,Rain
11/16/2022 16:00,112,703,125122,581664,815,706786,WEDNESDAY,0,0,12.8,96,5.4,1006.1,Cloudy
11/16/2022 17:00,133,859,201823,619218,992,821041,WEDNESDAY,0,0,13.9,96,9.4,1003.1,Rain
11/16/2022 18:00,120,664,115927,490399,784,606326,WEDNESDAY,0,0,10,93,9.4,1003.5,Cloudy
11/16/2022 19:00,78,472,87690,325988,550,413678,WEDNESDAY,0,0,10,93,38.9,1003.5,Cloudy
11/16/2022 20:00,43,341,38485,231151,384,269636,WEDNESDAY,0,0,8.3,80,27.7,1006.4,Cloudy
11/16/2022 21:00,48,248,36286,170762,296,207048,WEDNESDAY,0,0,8.3,80,27.7,1006.4,Cloudy
11/16/2022 22:00,29,159,28444,103724,188,132168,WEDNESDAY,0,0,6.7,76,22.3,1008.3,Cloudy
11/16/2022 23:00,30,108,27750,90191,138,117941,WEDNESDAY,0,0,6.7,76,22.3,1008.3,Cloudy
11/17/2022 0:00,14,40,14338,24556,54,38894,THURSDAY,0,0,6.1,73,25.9,1009.1,Cloudy
11/17/2022 1:00,7,21,21038,15374,28,36412,THURSDAY,0,0,6.1,65,24.1,1009.2,Fair
11/17/2022 2:00,3,13,3106,7303,16,10409,THURSDAY,0,0,5.6,67,24.1,1009.4,Fair
11/17/2022 3:00,2,10,2347,6847,12,9194,THURSDAY,0,0,5,73,18.4,1009.3,Fair
11/17/2022 4:00,1,8,258,10026,9,10284,THURSDAY,0,0,5,73,18.4,1009.3,Cloudy
11/17/2022 5:00,4,49,3436,38625,53,42061,THURSDAY,0,0,5,67,20.5,1009.2,Cloudy
11/17/2022 6:00,18,196,9207,125388,214,134595,THURSDAY,0,0,3.9,73,22.3,1009.1,Cloudy
11/17/2022 7:00,58,472,52021,333908,530,385929,THURSDAY,0,0,3.9,76,22.3,1009.2,Fair
11/17/2022 8:00,110,943,83703,1061794,1053,1145497,THURSDAY,0,0,3.3,83,24.1,1009.2,Fair
11/17/2022 9:00,69,536,66670,376868,605,443538,THURSDAY,0,0,3.3,83,24.1,1009.2,Fair
11/17/2022 10:00,82,439,81121,298279,521,379400,THURSDAY,0,0,3.9,76,24.1,1008.8,Clear
11/17/2022 11:00,63,350,92343,254620,413,346963,THURSDAY,0,0,3.9,73,18.4,1009.1,Fair
11/17/2022 12:00,71,451,81909,272528,522,354437,THURSDAY,0,0,4.4,70,16.6,1009.2,Fair
11/17/2022 13:00,74,362,102640,238878,436,341518,THURSDAY,0,0,5.6,64,18.4,1008.8,Fair
11/17/2022 14:00,84,420,121301,285632,504,406933,THURSDAY,0,0,5.6,64,18.4,1008.8,Fair
11/17/2022 15:00,99,444,426300,288150,543,714450,THURSDAY,0,0,6.1,55,20.5,1008.6,Fair
11/17/2022 16:00,110,677,112445,509528,787,621973,THURSDAY,0,0,7.8,49,20.5,1008.2,Cloudy
11/17/2022 17:00,155,888,221265,664144,1043,885409,THURSDAY,0,0,7.8,49,24.1,1008.2,Cloudy
11/17/2022 18:00,121,777,173849,543461,898,717310,THURSDAY,0,0,7.2,47,14.8,1008.6,Cloudy
11/17/2022 19:00,74,476,124269,317236,550,441505,THURSDAY,0,0,7.2,47,14.8,1008.6,Cloudy
11/17/2022 20:00,51,343,51046,210972,394,262018,THURSDAY,0,0,6.7,41,22.3,1009.6,Fair
11/17/2022 21:00,52,262,580828,179260,314,760088,THURSDAY,0,0,6.1,45,18.4,1010.4,Fair
11/17/2022 22:00,58,183,44097,128756,241,172853,THURSDAY,0,0,6.1,45,18.4,1010.4,Fair
11/17/2022 23:00,30,127,19844,78419,157,98263,THURSDAY,0,0,5,53,25.9,1011.5,Fair
11/18/2022 0:00,21,68,21239,40994,89,62233,FRIDAY,0,0,4.4,53,29.5,1012.2,Fair
11/18/2022 1:00,16,44,16977,36711,60,53688,FRIDAY,0,0,3.9,52,40.7,1012.9,Fair
11/18/2022 2:00,14,19,11367,12639,33,24006,FRIDAY,0,0,3.3,48,35.3,1013.9,Fair
11/18/2022 3:00,2,8,847,3942,10,4789,FRIDAY,0,0,3.3,48,27.7,1013.9,Fair
11/18/2022 4:00,4,5,3921,4117,9,8038,FRIDAY,0,0,2.2,52,18.4,1014.7,Fair
11/18/2022 5:00,5,49,6490,27099,54,33589,FRIDAY,0,0,2.2,52,18.4,1014.7,Fair
11/18/2022 6:00,15,135,29675,77466,150,107141,FRIDAY,0,0,1.7,56,20.5,1015.5,Cloudy
11/18/2022 7:00,35,351,31370,256316,386,287686,FRIDAY,0,0,1.1,59,18.4,1015.7,Fair
11/18/2022 8:00,74,634,67345,448109,708,515454,FRIDAY,0,0,1.1,61,11.2,1015.9,Fair
11/18/2022 9:00,59,453,92895,299085,512,391980,FRIDAY,0,0,1.1,61,11.2,1015.9,Fair
11/18/2022 10:00,69,370,102693,245706,439,348399,FRIDAY,0,0,0.6,63,18.4,1016.9,Fair
11/18/2022 11:00,76,390,85857,262897,466,348754,FRIDAY,0,0,0.6,63,18.4,1017.2,Fair
11/18/2022 12:00,106,391,165925,265686,497,431611,FRIDAY,0,0,1.7,61,20.5,1017.6,Fair
11/18/2022 13:00,123,454,139610,314053,577,453663,FRIDAY,0,0,3.3,55,18.4,1017.4,Fair
11/18/2022 14:00,144,431,422793,394817,575,817610,FRIDAY,0,0,3.3,55,18.4,1017.4,Fair
11/18/2022 15:00,143,543,231067,559289,686,790356,FRIDAY,0,0,6.1,43,16.6,1016.4,Fair
11/18/2022 16:00,145,657,148467,503603,802,652070,FRIDAY,0,0,6.7,40,25.9,1015.6,Fair
11/18/2022 17:00,174,763,248274,562726,937,811000,FRIDAY,0,0,6.7,38,20.5,1015.1,Fair
11/18/2022 18:00,139,635,233908,473891,774,707799,FRIDAY,0,0,7.2,38,22.3,1014.9,Fair
11/18/2022 19:00,92,430,128000,337861,522,465861,FRIDAY,0,0,7.2,38,22.3,1014.9,Fair
11/18/2022 20:00,91,289,110749,216667,380,327416,FRIDAY,0,0,5.6,39,16.6,1015.4,Fair
11/18/2022 21:00,72,192,91631,173235,264,264866,FRIDAY,0,0,5.6,39,16.6,1015.5,Fair
11/18/2022 22:00,91,211,90277,189480,302,279757,FRIDAY,0,0,5.6,39,16.6,1015.5,Fair
11/18/2022 23:00,71,164,127164,117182,235,244346,FRIDAY,0,0,5,38,25.9,1016,Fair
11/19/2022 0:00,48,113,134150,73712,161,207862,SATURDAY,1,0,4.4,39,22.3,1016.6,Fair
11/19/2022 1:00,114,112,197054,89607,226,286661,SATURDAY,1,0,3.9,39,24.1,1017.2,Fair
11/19/2022 2:00,45,54,46944,42141,99,89085,SATURDAY,1,0,3.3,44,22.3,1017.9,Fair
11/19/2022 3:00,12,12,10891,8884,24,19775,SATURDAY,1,0,2.8,46,18.4,1018.4,Fair
11/19/2022 4:00,3,10,3445,7617,13,11062,SATURDAY,1,0,2.2,50,16.6,1018.9,Fair
11/19/2022 5:00,4,19,6523,11639,23,18162,SATURDAY,1,0,2.2,50,22.3,1019.4,Fair
11/19/2022 6:00,11,39,13041,27895,50,40936,SATURDAY,1,0,1.1,54,22.3,1020.1,Clear
11/19/2022 7:00,18,80,22353,51732,98,74085,SATURDAY,1,0,0.6,56,16.6,1020.6,Clear
11/19/2022 8:00,48,188,45159,123461,236,168620,SATURDAY,1,0,1.1,56,14.8,1020.4,Clear
11/19/2022 9:00,92,275,105383,175170,367,280553,SATURDAY,1,0,1.1,59,18.4,1020.9,Clear
11/19/2022 10:00,138,368,212399,276587,506,488986,SATURDAY,1,0,1.1,59,18.4,1020.9,Clear
11/19/2022 11:00,156,401,274151,333087,557,607238,SATURDAY,1,0,0,66,11.2,1021.5,Fair
11/19/2022 12:00,195,484,584773,400300,679,985073,SATURDAY,1,0,1.1,67,14.8,1022.6,Fair
11/19/2022 13:00,214,460,431217,392049,674,823266,SATURDAY,1,0,2.8,57,13,1022.6,Fair
11/19/2022 14:00,200,433,290605,355670,633,646275,SATURDAY,1,0,2.8,57,13,1022.6,Fair
11/19/2022 15:00,242,515,322318,802847,757,1125165,SATURDAY,1,0,5,41,16.6,1021.8,Fair
11/19/2022 16:00,189,452,244432,498548,641,742980,SATURDAY,1,0,5,43,16.6,1020.6,Fair
11/19/2022 17:00,147,354,173918,374073,501,547991,SATURDAY,1,0,6.1,41,22.3,1019.4,Fair
11/19/2022 18:00,91,288,179578,205705,379,385283,SATURDAY,1,0,6.1,38,14.8,1018.7,Fair
11/19/2022 19:00,85,306,558703,217753,391,776456,SATURDAY,1,0,6.1,38,14.8,1018.7,Fair
11/19/2022 20:00,46,176,43221,126149,222,169370,SATURDAY,1,0,5,36,16.6,1017.6,Fair
11/19/2022 21:00,67,153,207017,105094,220,312111,SATURDAY,1,0,4.4,43,22.3,1017.6,Fair
11/19/2022 22:00,58,176,104902,128564,234,233466,SATURDAY,1,0,3.9,48,20.5,1017.9,Fair
11/19/2022 23:00,61,126,210549,86966,187,297515,SATURDAY,1,0,3.9,48,20.5,1017.9,Fair
11/20/2022 0:00,52,81,330958,47482,133,378440,SUNDAY,1,0,2.2,50,24.1,1018.3,Fair
11/20/2022 1:00,75,70,190554,50189,145,240743,SUNDAY,1,0,1.7,49,18.4,1018.1,Fair
11/20/2022 2:00,39,41,86635,32922,80,119557,SUNDAY,1,0,1.1,47,20.5,1017.9,Fair
11/20/2022 3:00,9,16,6638,14028,25,20666,SUNDAY,1,0,1.1,47,20.5,1017.9,Fair
11/20/2022 4:00,2,11,4922,14045,13,18967,SUNDAY,1,0,1.1,47,14.8,1017.4,Fair
11/20/2022 5:00,12,14,13904,11263,26,25167,SUNDAY,1,0,0,51,13,1015.9,Clear
11/20/2022 6:00,6,29,189700,17981,35,207681,SUNDAY,1,0,0,54,14.8,1014.8,Clear
11/20/2022 7:00,14,59,9370,34817,73,44187,SUNDAY,1,0,0,54,14.8,1013.8,Clear
11/20/2022 8:00,31,127,47824,91591,158,139415,SUNDAY,1,0,0,56,7.6,1013.2,Fair
11/20/2022 9:00,62,195,71624,223622,257,295246,SUNDAY,1,0,0.6,58,11.2,1012.1,Fair
11/20/2022 10:00,83,291,110981,214078,374,325059,SUNDAY,1,0,0.6,58,11.2,1012.1,Rain
11/20/2022 11:00,84,285,110589,235790,369,346379,SUNDAY,1,0,1.1,54,20.5,1012.2,Fair
11/20/2022 12:00,107,366,201469,301954,473,503423,SUNDAY,1,0,1.7,49,18.4,1013,Fair
11/20/2022 13:00,117,339,483616,258177,456,741793,SUNDAY,1,0,2.8,42,22.3,1013.5,Fair
11/20/2022 14:00,75,297,97429,238877,372,336306,SUNDAY,1,0,2.8,42,22.3,1013.5,Fair
11/20/2022 15:00,79,327,92553,309299,406,401852,SUNDAY,1,0,3.3,37,33.5,1013.8,Fair
11/20/2022 16:00,55,301,1000042,224405,356,1224447,SUNDAY,1,0,3.3,29,33.5,1013.8,Fair
11/20/2022 17:00,42,244,41634,168284,286,209918,SUNDAY,1,0,3.3,20,35.3,1013.6,Fair
11/20/2022 18:00,59,263,127409,177124,322,304533,SUNDAY,1,0,3.3,20,42.5,1013.6,Fair
11/20/2022 19:00,25,200,20645,132571,225,153216,SUNDAY,1,0,2.8,21,42.5,1015.2,Fair
11/20/2022 20:00,19,143,54444,85893,162,140337,SUNDAY,1,0,1.7,23,35.3,1016.3,Fair
11/20/2022 21:00,24,117,18201,72115,141,90316,SUNDAY,1,0,1.1,27,24.1,1017.6,Fair
11/20/2022 22:00,22,86,134956,57896,108,192852,SUNDAY,1,0,1.1,27,24.1,1017.6,Fair
11/20/2022 23:00,15,59,18778,36832,74,55610,SUNDAY,1,0,0,33,33.5,1019,Fair
11/21/2022 0:00,8,31,4356,14627,39,18983,MONDAY,0,0,-0.6,38,18.4,1020.5,Fair
11/21/2022 1:00,4,12,1898,8953,16,10851,MONDAY,0,0,-1.1,39,18.4,1021.2,Clear
11/21/2022 2:00,2,6,2147,4312,8,6459,MONDAY,0,0,-1.1,41,18.4,1022.6,Clear
11/21/2022 3:00,3,6,4734,3940,9,8674,MONDAY,0,0,-1.7,45,38.9,1022.9,Fair
11/21/2022 4:00,0,6,0,4588,6,4588,MONDAY,0,0,-1.7,45,29.5,1022.9,Fair
11/21/2022 5:00,8,36,7279,25305,44,32584,MONDAY,0,0,-2.2,40,33.5,1024.7,Clear
11/21/2022 6:00,4,109,2701,69146,113,71847,MONDAY,0,0,-2.8,39,33.5,1025.8,Clear
11/21/2022 7:00,27,338,19092,240664,365,259756,MONDAY,0,0,-2.8,37,16.6,1026.9,Clear
11/21/2022 8:00,39,602,53837,436100,641,489937,MONDAY,0,0,-3.3,38,20.5,1027.8,Clear
11/21/2022 9:00,31,386,28349,282595,417,310944,MONDAY,0,0,-3.3,38,20.5,1027.8,Clear
11/21/2022 10:00,40,293,64591,180302,333,244893,MONDAY,0,0,-3.3,40,11.2,1029.7,Clear
11/21/2022 11:00,51,267,47190,184306,318,231496,MONDAY,0,0,-3.3,42,9.4,1030.9,Fair
11/21/2022 12:00,42,320,46143,279419,362,325562,MONDAY,0,0,-2.2,44,14.8,1031.1,Fair
11/21/2022 13:00,86,308,98672,207097,394,305769,MONDAY,0,0,-2.2,44,14.8,1031.1,Fair
11/21/2022 14:00,69,304,860011,194197,373,1054208,MONDAY,0,0,0,43,20.5,1030.6,Fair
11/21/2022 15:00,60,342,74275,228881,402,303156,MONDAY,0,0,1.1,40,24.1,1029.8,Fair
11/21/2022 16:00,75,486,75207,340105,561,415312,MONDAY,0,0,2.2,40,22.3,1028.3,Fair
11/21/2022 17:00,87,619,113360,679716,706,793076,MONDAY,0,0,2.8,37,20.5,1027.1,Fair
11/21/2022 18:00,65,501,64195,340809,566,405004,MONDAY,0,0,2.8,37,20.5,1027.1,Fair
11/21/2022 19:00,52,320,196612,216896,372,413508,MONDAY,0,0,3.3,39,24.1,1024.7,Fair
11/21/2022 20:00,28,246,22726,149113,274,171839,MONDAY,0,0,2.8,48,24.1,1024,Cloudy
11/21/2022 21:00,17,173,18355,139195,190,157550,MONDAY,0,0,2.2,54,25.9,1023.6,Cloudy
11/21/2022 22:00,14,132,10904,93093,146,103997,MONDAY,0,0,1.7,52,25.9,1022.5,Cloudy
11/21/2022 23:00,12,66,51496,41908,78,93404,MONDAY,0,0,1.7,52,25.9,1022.5,Cloudy
11/22/2022 0:00,9,33,8075,17691,42,25766,TUESDAY,0,0,3.3,52,25.9,1021.4,Cloudy
11/22/2022 1:00,8,20,7921,10014,28,17935,TUESDAY,0,0,3.3,57,29.5,1021.2,Cloudy
11/22/2022 2:00,1,14,458,10863,15,11321,TUESDAY,0,0,3.3,59,27.7,1021.3,Cloudy
11/22/2022 3:00,1,7,309,5004,8,5313,TUESDAY,0,0,3.3,52,22.3,1021.1,Cloudy
11/22/2022 4:00,3,6,2115,7083,9,9198,TUESDAY,0,0,3.3,52,22.3,1021.1,Fair
11/22/2022 5:00,7,42,15693,30057,49,45750,TUESDAY,0,0,3.9,39,27.7,1021.4,Fair
11/22/2022 6:00,7,130,3446,89454,137,92900,TUESDAY,0,0,3.3,40,24.1,1021.9,Fair
11/22/2022 7:00,22,371,18059,262972,393,281031,TUESDAY,0,0,3.3,42,22.3,1022.6,Clear
11/22/2022 8:00,56,713,56880,549505,769,606385,TUESDAY,0,0,3.3,42,22.3,1022.6,Clear
11/22/2022 9:00,55,450,58086,324212,505,382298,TUESDAY,0,0,2.2,48,20.5,1024,Clear
11/22/2022 10:00,48,314,50686,216993,362,267679,TUESDAY,0,0,1.7,52,18.4,1024.9,Clear
11/22/2022 11:00,47,340,58344,215485,387,273829,TUESDAY,0,0,2.2,50,14.8,1025.7,Fair
11/22/2022 12:00,102,351,142118,220885,453,363003,TUESDAY,0,0,2.8,52,16.6,1026.5,Fair
11/22/2022 13:00,101,357,103407,246791,458,350198,TUESDAY,0,0,2.8,52,16.6,1026.5,Fair
11/22/2022 14:00,113,382,494970,363959,495,858929,TUESDAY,0,0,6.7,41,13,1026.7,Fair
11/22/2022 15:00,146,458,588597,1009400,604,1597997,TUESDAY,0,0,7.8,38,14.8,1026.1,Fair
11/22/2022 16:00,141,581,182216,448412,722,630628,TUESDAY,0,0,8.3,39,9.4,1025.3,Fair
11/22/2022 17:00,108,703,106166,542752,811,648918,TUESDAY,0,0,8.9,35,9.4,1024.6,Fair
11/22/2022 18:00,99,516,118133,379054,615,497187,TUESDAY,0,0,8.9,35,9.4,1024.6,Fair
11/22/2022 19:00,72,393,73598,250286,465,323884,TUESDAY,0,0,8.3,37,16.6,1023.7,Fair
11/22/2022 20:00,33,242,45543,172915,275,218458,TUESDAY,0,0,7.8,40,13,1023.2,Fair
11/22/2022 21:00,35,186,39871,118497,221,158368,TUESDAY,0,0,7.2,40,11.2,1023,Fair
11/22/2022 22:00,21,117,26186,80493,138,106679,TUESDAY,0,0,7.2,40,11.2,1023,Fair
11/22/2022 23:00,21,76,74107,41872,97,115979,TUESDAY,0,0,5.6,49,11.2,1023,Fair
11/23/2022 0:00,15,41,13769,32182,56,45951,WEDNESDAY,0,0,5,51,11.2,1022.5,Fair
11/23/2022 1:00,13,22,11971,14035,35,26006,WEDNESDAY,0,0,5,51,16.6,1022.1,Cloudy
11/23/2022 2:00,3,13,2271,8494,16,10765,WEDNESDAY,0,0,5,51,18.4,1021.7,Cloudy
11/23/2022 3:00,4,9,18894,7279,13,26173,WEDNESDAY,0,0,5,51,18.4,1021.7,Fair
11/23/2022 4:00,3,9,3818,8867,12,12685,WEDNESDAY,0,0,4.4,55,18.4,1021.3,Fair
11/23/2022 5:00,4,34,3226,21222,38,24448,WEDNESDAY,0,0,4.4,57,16.6,1020.2,Fair
11/23/2022 6:00,13,96,7629,57404,109,65033,WEDNESDAY,0,0,4.4,57,18.4,1019.8,Fair
11/23/2022 7:00,17,244,17476,161841,261,179317,WEDNESDAY,0,0,4.4,57,16.6,1019.3,Clear
11/23/2022 8:00,63,439,74954,307418,502,382372,WEDNESDAY,0,0,4.4,57,16.6,1019.3,Clear
11/23/2022 9:00,68,344,91124,208848,412,299972,WEDNESDAY,0,0,6.7,41,22.3,1019.4,Clear
11/23/2022 10:00,46,272,76974,175088,318,252062,WEDNESDAY,0,0,6.1,43,16.6,1019.6,Clear
11/23/2022 11:00,77,311,266800,205162,388,471962,WEDNESDAY,0,0,6.1,43,16.6,1019.6,Fair
11/23/2022 12:00,98,390,171439,279748,488,451187,WEDNESDAY,0,0,6.7,41,16.6,1020.6,Fair
11/23/2022 13:00,120,440,261718,307842,560,569560,WEDNESDAY,0,0,6.7,41,16.6,1020.6,Fair
11/23/2022 14:00,139,394,330029,276157,533,606186,WEDNESDAY,0,0,9.4,41,14.8,1020.9,Fair
11/23/2022 15:00,152,430,272188,343503,582,615691,WEDNESDAY,0,0,9.4,41,24.1,1020.9,Fair
11/23/2022 16:00,102,470,145427,346888,572,492315,WEDNESDAY,0,0,10,41,18.4,1021.1,Fair
11/23/2022 17:00,91,428,846030,315984,519,1162014,WEDNESDAY,0,0,10,41,22.3,1021.1,Fair
11/23/2022 18:00,77,376,96502,249415,453,345917,WEDNESDAY,0,0,10,41,22.3,1021.1,Fair
11/23/2022 19:00,52,244,253969,199866,296,453835,WEDNESDAY,0,0,9.4,41,22.3,1021.9,Fair
11/23/2022 20:00,31,184,41987,131112,215,173099,WEDNESDAY,0,0,8.9,40,16.6,1022.7,Fair
11/23/2022 21:00,22,126,42811,411427,148,454238,WEDNESDAY,0,0,8.3,42,9.4,1023.5,Fair
11/23/2022 22:00,40,123,103289,80914,163,184203,WEDNESDAY,0,0,8.3,42,9.4,1023.5,Fair
11/23/2022 23:00,42,66,64821,44163,108,108984,WEDNESDAY,0,0,7.2,45,11.2,1025.1,Fair
11/24/2022 0:00,24,37,26937,21025,61,47962,THURSDAY,0,1,6.1,51,13,1025.8,Fair
11/24/2022 1:00,20,32,181380,61497,52,242877,THURSDAY,0,1,3.9,62,13,1026.8,Fair
11/24/2022 2:00,6,21,9454,500463,27,509917,THURSDAY,0,1,3.9,62,13,1026.8,Fair
11/24/2022 3:00,10,7,16784,6347,17,23131,THURSDAY,0,1,3.9,62,7.6,1027.6,Fair
11/24/2022 4:00,0,6,0,3277,6,3277,THURSDAY,0,1,2.2,64,11.2,1028.4,Fair
11/24/2022 5:00,4,20,27006,20022,24,47028,THURSDAY,0,1,2.2,62,13,1028.7,Fair
11/24/2022 6:00,5,34,6608,17796,39,24404,THURSDAY,0,1,1.1,67,13,1029.3,Fair
11/24/2022 7:00,10,72,16874,49712,82,66586,THURSDAY,0,1,0,72,14.8,1029.3,Fair
11/24/2022 8:00,16,82,16301,68375,98,84676,THURSDAY,0,1,0,72,14.8,1029.3,Fair
11/24/2022 9:00,42,116,281740,91916,158,373656,THURSDAY,0,1,0.6,69,11.2,1029.9,Fair
11/24/2022 10:00,54,161,97809,125536,215,223345,THURSDAY,0,1,0,69,11.2,1030.2,Fair
11/24/2022 11:00,85,199,163797,172153,284,335950,THURSDAY,0,1,0,69,7.6,1030.4,Fair
11/24/2022 12:00,96,194,161476,175088,290,336564,THURSDAY,0,1,0,69,7.6,1030.4,Fair
11/24/2022 13:00,135,227,263233,201183,362,464416,THURSDAY,0,1,2.8,59,5.4,1030.6,Fair
11/24/2022 14:00,148,221,328727,192485,369,521212,THURSDAY,0,1,5,55,0,1030.4,Fair
11/24/2022 15:00,120,199,330658,188617,319,519275,THURSDAY,0,1,5.6,57,7.6,1029.7,Fair
11/24/2022 16:00,85,189,470680,168336,274,639016,THURSDAY,0,1,6.7,51,14.8,1028.5,Fair
11/24/2022 17:00,62,163,260496,197753,225,458249,THURSDAY,0,1,7.2,51,11.2,1027.4,Fair
11/24/2022 18:00,52,144,84752,111858,196,196610,THURSDAY,0,1,7.2,51,11.2,1027.4,Fair
11/24/2022 19:00,40,89,301510,73127,129,374637,THURSDAY,0,1,8.3,49,18.4,1025.9,Fair
11/24/2022 20:00,28,63,71956,51698,91,123654,THURSDAY,0,1,7.2,53,16.6,1025.9,Fair
11/24/2022 21:00,22,62,23422,50989,84,74411,THURSDAY,0,1,6.7,58,14.8,1025.1,Cloudy
11/24/2022 22:00,33,73,59440,47936,106,107376,THURSDAY,0,1,6.7,58,14.8,1025.1,Fair
11/24/2022 23:00,17,72,15446,55940,89,71386,THURSDAY,0,1,5,73,11.2,1024.7,Fair
11/25/2022 0:00,19,32,33634,23558,51,57192,FRIDAY,0,0,5.6,70,16.6,1024.5,Cloudy
11/25/2022 1:00,9,21,9898,11809,30,21707,FRIDAY,0,0,5,76,11.2,1023.7,Cloudy
11/25/2022 2:00,8,13,11221,11406,21,22627,FRIDAY,0,0,4.4,79,5.4,1023.2,Cloudy
11/25/2022 3:00,0,1,0,298,1,298,FRIDAY,0,0,4.4,79,5.4,1023.2,Cloudy
11/25/2022 4:00,2,6,2983,5229,8,8212,FRIDAY,0,0,6.1,82,16.6,1021.9,Cloudy
11/25/2022 5:00,5,17,47329,11463,22,58792,FRIDAY,0,0,6.1,82,13,1021,Cloudy
11/25/2022 6:00,5,51,2874,39280,56,42154,FRIDAY,0,0,6.1,86,11.2,1020.7,Cloudy
11/25/2022 7:00,12,87,7763,58925,99,66688,FRIDAY,0,0,5.6,89,11.2,1019.3,Cloudy
11/25/2022 8:00,20,87,38676,66967,107,105643,FRIDAY,0,0,5.6,89,11.2,1019.3,Cloudy
11/25/2022 9:00,37,139,51431,103136,176,154567,FRIDAY,0,0,5.6,89,11.2,1018.1,Cloudy
11/25/2022 10:00,67,178,148977,120090,245,269067,FRIDAY,0,0,7.2,86,11.2,1015.5,Cloudy
11/25/2022 11:00,60,176,90903,129112,236,220015,FRIDAY,0,0,8.3,86,14.8,1014.7,Cloudy
11/25/2022 12:00,74,228,112480,174090,302,286570,FRIDAY,0,0,8.3,86,14.8,1014.7,Cloudy
11/25/2022 13:00,54,188,70686,128169,242,198855,FRIDAY,0,0,9.4,83,20.5,1013.1,Cloudy
11/25/2022 14:00,64,194,85539,145738,258,231277,FRIDAY,0,0,10,80,20.5,1011.3,Cloudy
11/25/2022 15:00,85,242,113220,184607,327,297827,FRIDAY,0,0,10,80,20.5,1011.3,Cloudy
11/25/2022 16:00,93,271,873770,217100,364,1090870,FRIDAY,0,0,10.6,80,20.5,1006.8,Cloudy
11/25/2022 17:00,62,262,76669,218647,324,295316,FRIDAY,0,0,10.6,80,20.5,1006.8,Cloudy
11/25/2022 18:00,66,253,152028,188694,319,340722,FRIDAY,0,0,10,89,20.5,1004.9,Cloudy
11/25/2022 19:00,51,147,45420,97379,198,142799,FRIDAY,0,0,10,89,20.5,1004.9,Cloudy
11/25/2022 20:00,51,144,70359,105603,195,175962,FRIDAY,0,0,10.6,80,18.4,1004.1,Cloudy
11/25/2022 21:00,30,95,31854,62257,125,94111,FRIDAY,0,0,10.6,80,18.4,1004.1,Cloudy
11/25/2022 22:00,41,97,286294,68802,138,355096,FRIDAY,0,0,10,56,22.3,1004.2,Cloudy
11/25/2022 23:00,42,66,92668,51997,108,144665,FRIDAY,0,0,8.9,56,24.1,1004.4,Cloudy
11/26/2022 0:00,25,56,31352,37272,81,68624,SATURDAY,1,0,7.8,60,24.1,1005,Cloudy
11/26/2022 1:00,32,33,123371,28601,65,151972,SATURDAY,1,0,7.2,65,27.7,1005.4,Cloudy
11/26/2022 2:00,29,18,47560,14459,47,62019,SATURDAY,1,0,6.7,68,18.4,1006.2,Fair
11/26/2022 3:00,3,6,3436,4911,9,8347,SATURDAY,1,0,6.7,68,18.4,1006.2,Fair
11/26/2022 4:00,4,2,4016,978,6,4994,SATURDAY,1,0,6.1,55,27.7,1007,Fair
11/26/2022 5:00,5,9,2887,9228,14,12115,SATURDAY,1,0,6.1,51,27.7,1007.7,Fair
11/26/2022 6:00,4,32,3915,23192,36,27107,SATURDAY,1,0,5.6,50,27.7,1008.2,Fair
11/26/2022 7:00,12,45,18488,30548,57,49036,SATURDAY,1,0,5.6,50,27.7,1008.2,Clear
11/26/2022 8:00,28,92,51066,79177,120,130243,SATURDAY,1,0,5,51,13,1009.5,Clear
11/26/2022 9:00,49,165,53410,102377,214,155787,SATURDAY,1,0,5,51,13,1009.5,Clear
11/26/2022 10:00,87,242,151843,344514,329,496357,SATURDAY,1,0,4.4,53,16.6,1010.7,Clear
11/26/2022 11:00,108,264,190116,233952,372,424068,SATURDAY,1,0,4.4,53,16.6,1010.7,Fair
11/26/2022 12:00,119,294,229182,231653,413,460835,SATURDAY,1,0,3.9,52,20.5,1011.9,Fair
11/26/2022 13:00,181,350,291564,318934,531,610498,SATURDAY,1,0,5.6,49,25.9,1013.1,Fair
11/26/2022 14:00,167,294,403508,260023,461,663531,SATURDAY,1,0,6.7,45,31.7,1013.3,Fair
11/26/2022 15:00,153,336,237688,347124,489,584812,SATURDAY,1,0,8.3,40,25.9,1013,Fair
11/26/2022 16:00,133,340,191902,283263,473,475165,SATURDAY,1,0,8.9,39,22.3,1012.2,Fair
11/26/2022 17:00,80,297,104971,245560,377,350531,SATURDAY,1,0,8.9,39,22.3,1012.2,Fair
11/26/2022 18:00,70,221,77695,164677,291,242372,SATURDAY,1,0,11.1,35,14.8,1010.9,Fair
11/26/2022 19:00,67,213,95604,160892,280,256496,SATURDAY,1,0,11.7,32,18.4,1011,Fair
11/26/2022 20:00,45,142,196201,113658,187,309859,SATURDAY,1,0,11.1,36,20.5,1011,Fair
11/26/2022 21:00,46,130,145674,93533,176,239207,SATURDAY,1,0,11.1,36,20.5,1011,Fair
11/26/2022 22:00,55,107,93715,85479,162,179194,SATURDAY,1,0,9.4,46,14.8,1011.2,Fair
11/26/2022 23:00,46,83,182440,57729,129,240169,SATURDAY,1,0,9.4,46,22.3,1010.8,Fair
11/27/2022 0:00,52,74,95211,52095,126,147306,SUNDAY,1,0,8.3,49,18.4,1010.9,Fair
11/27/2022 1:00,65,48,107502,46012,113,153514,SUNDAY,1,0,8.3,49,18.4,1011.4,Fair
11/27/2022 2:00,26,31,65962,30897,57,96859,SUNDAY,1,0,7.8,51,20.5,1010.4,Clear
11/27/2022 3:00,4,6,7685,6774,10,14459,SUNDAY,1,0,7.8,51,20.5,1010.4,Clear
11/27/2022 4:00,5,7,6754,5116,12,11870,SUNDAY,1,0,8.9,46,20.5,1010.9,Clear
11/27/2022 5:00,5,20,6247,15717,25,21964,SUNDAY,1,0,7.8,49,13,1010.5,Clear
11/27/2022 6:00,7,39,6839,23427,46,30266,SUNDAY,1,0,6.7,55,14.8,1010.7,Clear
11/27/2022 7:00,12,40,17489,29077,52,46566,SUNDAY,1,0,6.7,55,14.8,1010.7,Clear
11/27/2022 8:00,25,111,36320,78110,136,114430,SUNDAY,1,0,7.2,51,18.4,1010.1,Clear
11/27/2022 9:00,46,180,75758,128172,226,203930,SUNDAY,1,0,6.7,53,16.6,1010,Clear
11/27/2022 10:00,73,279,104730,210423,352,315153,SUNDAY,1,0,6.7,51,16.6,1010.1,Clear
11/27/2022 11:00,97,330,235127,254524,427,489651,SUNDAY,1,0,7.2,49,16.6,1010.3,Fair
11/27/2022 12:00,148,399,265080,313820,547,578900,SUNDAY,1,0,7.2,49,16.6,1010.3,Cloudy
11/27/2022 13:00,113,431,170960,421050,544,592010,SUNDAY,1,0,9.4,42,13,1009.3,Cloudy
11/27/2022 14:00,117,348,309478,263539,465,573017,SUNDAY,1,0,10,42,13,1009.1,Cloudy
11/27/2022 15:00,47,161,56781,160163,208,216944,SUNDAY,1,0,11.7,39,14.8,1008.6,Cloudy
11/27/2022 16:00,28,104,33880,82789,132,116669,SUNDAY,1,0,11.7,39,14.8,1008.6,Cloudy
11/27/2022 17:00,10,60,12516,100000,70,112516,SUNDAY,1,0,11.7,39,16.6,1006.7,Rain
11/27/2022 18:00,18,117,14216,85977,135,100193,SUNDAY,1,0,11.1,43,11.2,1005.8,Rain
11/27/2022 19:00,14,100,81449,73718,114,155167,SUNDAY,1,0,11.1,46,11.2,1004.8,Rain
11/27/2022 20:00,29,111,178345,73121,140,251466,SUNDAY,1,0,9.4,66,9.4,1004,Rain
11/27/2022 21:00,10,42,9709,24232,52,33941,SUNDAY,1,0,9.4,66,9.4,1004,Rain
11/27/2022 22:00,9,43,6292,29939,52,36231,SUNDAY,1,0,8.9,93,13,1001.4,Rain
11/27/2022 23:00,13,46,12452,29117,59,41569,SUNDAY,1,0,10.6,96,20.5,998.7,Rain
11/28/2022 0:00,12,29,13631,14607,41,28238,MONDAY,0,0,10.6,96,20.5,998.7,Rain
11/28/2022 1:00,10,25,60301,20417,35,80718,MONDAY,0,0,11.1,93,20.5,996.6,Rain
11/28/2022 2:00,1,11,1338,9330,12,10668,MONDAY,0,0,12.8,96,24.1,991.6,Rain
11/28/2022 3:00,2,5,8513,2056,7,10569,MONDAY,0,0,12.8,96,24.1,991.6,Rain
11/28/2022 4:00,1,9,2590,9882,10,12472,MONDAY,0,0,13.9,93,16.6,989.1,Rain
11/28/2022 5:00,3,63,6751,38782,66,45533,MONDAY,0,0,13.3,93,16.6,990.7,Rain
11/28/2022 6:00,14,164,9914,97073,178,106987,MONDAY,0,0,13.3,72,33.5,990.7,Rain
11/28/2022 7:00,39,438,27952,329204,477,357156,MONDAY,0,0,12.2,75,25.9,992.2,Rain
11/28/2022 8:00,84,755,76374,590573,839,666947,MONDAY,0,0,11.7,74,20.5,992.7,Cloudy
11/28/2022 9:00,46,466,50140,352622,512,402762,MONDAY,0,0,11.1,74,20.5,993.3,Cloudy
11/28/2022 10:00,40,317,53530,248706,357,302236,MONDAY,0,0,10.6,77,27.7,994,Cloudy
11/28/2022 11:00,45,317,55975,207341,362,263316,MONDAY,0,0,10.6,77,27.7,994,Cloudy
11/28/2022 12:00,52,373,90940,257111,425,348051,MONDAY,0,0,11.1,77,22.3,996.6,Cloudy
11/28/2022 13:00,81,367,105587,249503,448,355090,MONDAY,0,0,11.7,69,22.3,998.1,Cloudy
11/28/2022 14:00,76,379,115252,273490,455,388742,MONDAY,0,0,11.1,63,25.9,1000.5,Cloudy
11/28/2022 15:00,89,428,114665,314319,517,428984,MONDAY,0,0,11.1,63,25.9,1000.5,Cloudy
11/28/2022 16:00,99,646,99553,465274,745,564827,MONDAY,0,0,11.1,52,33.5,1001.6,Cloudy
11/28/2022 17:00,83,721,93799,555847,804,649646,MONDAY,0,0,11.7,48,25.9,1003.1,Cloudy
11/28/2022 18:00,75,584,62772,414795,659,477567,MONDAY,0,0,10.6,50,25.9,1004.4,Cloudy
11/28/2022 19:00,66,438,77310,359868,504,437178,MONDAY,0,0,10.6,48,25.9,1005.5,Cloudy
11/28/2022 20:00,33,283,27327,191123,316,218450,MONDAY,0,0,8.9,51,24.1,1007.1,Cloudy
11/28/2022 21:00,31,239,42375,173512,270,215887,MONDAY,0,0,8.9,51,24.1,1007.1,Cloudy
11/28/2022 22:00,23,139,24307,95468,162,119775,MONDAY,0,0,7.2,56,24.1,1010.1,Fair
11/28/2022 23:00,10,56,8909,40232,66,49141,MONDAY,0,0,7.2,56,24.1,1010.1,Fair
11/29/2022 0:00,9,35,9089,44619,44,53708,TUESDAY,0,0,6.1,57,25.9,1012.9,Fair
11/29/2022 1:00,3,16,3582,7656,19,11238,TUESDAY,0,0,5.6,57,25.9,1014.2,Fair
11/29/2022 2:00,1,15,516,8717,16,9233,TUESDAY,0,0,5.6,57,24.1,1014.2,Fair
11/29/2022 3:00,3,4,3229,2317,7,5546,TUESDAY,0,0,5,60,16.6,1015.1,Fair
11/29/2022 4:00,2,7,1610,6812,9,8422,TUESDAY,0,0,3.9,57,20.5,1017.2,Fair
11/29/2022 5:00,7,56,4338,32764,63,37102,TUESDAY,0,0,2.8,59,14.8,1017.8,Clear
11/29/2022 6:00,21,162,14627,98632,183,113259,TUESDAY,0,0,2.8,59,14.8,1017.8,Clear
11/29/2022 7:00,54,470,40454,359999,524,400453,TUESDAY,0,0,2.2,62,20.5,1019.7,Clear
11/29/2022 8:00,70,866,60331,637407,936,697738,TUESDAY,0,0,1.7,61,18.4,1021,Clear
11/29/2022 9:00,65,473,56455,322569,538,379024,TUESDAY,0,0,1.7,61,18.4,1021,Clear
11/29/2022 10:00,44,294,60212,229151,338,289363,TUESDAY,0,0,0.6,66,14.8,1022.6,Fair
11/29/2022 11:00,28,278,49879,552614,306,602493,TUESDAY,0,0,0.6,66,14.8,1022.6,Fair
11/29/2022 12:00,58,349,90336,219574,407,309910,TUESDAY,0,0,1.7,61,14.8,1024.4,Fair
11/29/2022 13:00,75,394,94170,262109,469,356279,TUESDAY,0,0,2.2,64,18.4,1025.4,Fair
11/29/2022 14:00,57,367,51751,236837,424,288588,TUESDAY,0,0,2.8,61,16.6,1026,Fair
11/29/2022 15:00,62,397,75164,293444,459,368608,TUESDAY,0,0,3.9,62,11.2,1026.1,Cloudy
11/29/2022 16:00,96,584,110071,401419,680,511490,TUESDAY,0,0,5,60,5.4,1026,Cloudy
11/29/2022 17:00,109,801,172566,572728,910,745294,TUESDAY,0,0,5,60,5.4,1026,Cloudy
11/29/2022 18:00,74,678,97771,483542,752,581313,TUESDAY,0,0,5.6,64,16.6,1024.8,Cloudy
11/29/2022 19:00,65,431,59669,347529,496,407198,TUESDAY,0,0,5.6,62,9.4,1025.3,Cloudy
11/29/2022 20:00,51,294,62729,251683,345,314412,TUESDAY,0,0,5.6,64,5.4,1026.1,Cloudy
11/29/2022 21:00,31,213,33064,161227,244,194291,TUESDAY,0,0,5.6,64,5.4,1026.1,Cloudy
11/29/2022 22:00,30,162,22489,117479,192,139968,TUESDAY,0,0,5.6,62,0,1026.9,Cloudy
11/29/2022 23:00,11,81,16078,57571,92,73649,TUESDAY,0,0,5.6,62,0,1026.9,Cloudy
11/30/2022 0:00,13,45,43642,25315,58,68957,WEDNESDAY,0,0,5.6,64,0,1026.3,Cloudy
11/30/2022 1:00,10,19,9360,13808,29,23168,WEDNESDAY,0,0,5.6,64,0,1026.3,Cloudy
11/30/2022 2:00,3,13,3518,10435,16,13953,WEDNESDAY,0,0,4.4,70,5.4,1026.7,Cloudy
11/30/2022 3:00,7,2,60387,1130,9,61517,WEDNESDAY,0,0,5,70,0,1026.7,Cloudy
11/30/2022 4:00,3,7,1967,6782,10,8749,WEDNESDAY,0,0,3.3,73,11.2,1026.9,Cloudy
11/30/2022 5:00,6,51,3834,32462,57,36296,WEDNESDAY,0,0,3.3,79,9.4,1026.8,Cloudy
11/30/2022 6:00,18,179,13833,122003,197,135836,WEDNESDAY,0,0,5,67,9.4,1026.2,Cloudy
11/30/2022 7:00,52,477,43163,373895,529,417058,WEDNESDAY,0,0,6.7,70,11.2,1024.8,Cloudy
11/30/2022 8:00,73,885,90042,672790,958,762832,WEDNESDAY,0,0,6.7,73,13,1024.2,Cloudy
11/30/2022 9:00,67,555,81539,490637,622,572176,WEDNESDAY,0,0,6.7,73,13,1024.2,Cloudy
11/30/2022 10:00,51,370,59462,245048,421,304510,WEDNESDAY,0,0,6.1,73,14.8,1023.2,Fair
11/30/2022 11:00,40,359,58063,220274,399,278337,WEDNESDAY,0,0,6.1,73,14.8,1023.2,Cloudy
11/30/2022 12:00,65,386,67160,254057,451,321217,WEDNESDAY,0,0,7.8,73,14.8,1022.1,Cloudy
11/30/2022 13:00,69,400,64487,391396,469,455883,WEDNESDAY,0,0,7.8,79,9.4,1021.3,Cloudy
11/30/2022 14:00,39,326,41165,204998,365,246163,WEDNESDAY,0,0,7.8,79,0,1020,Cloudy
11/30/2022 15:00,33,205,44009,131564,238,175573,WEDNESDAY,0,0,7.8,79,0,1020,Cloudy
11/30/2022 16:00,23,261,23925,202741,284,226666,WEDNESDAY,0,0,9.4,80,7.6,1017.7,Rain
11/30/2022 17:00,28,255,25980,166970,283,192950,WEDNESDAY,0,0,13.3,84,14.8,1011.4,Rain
11/30/2022 18:00,15,200,10883,140162,215,151045,WEDNESDAY,0,0,13.3,84,29.5,1011.4,Rain
11/30/2022 19:00,12,126,9521,67477,138,76998,WEDNESDAY,0,0,13.3,87,38.9,1008.7,Rain
11/30/2022 20:00,10,138,7020,92677,148,99697,WEDNESDAY,0,0,13.3,87,33.5,1008.7,Rain
11/30/2022 21:00,20,132,17743,83956,152,101699,WEDNESDAY,0,0,13.9,93,27.7,1005.4,Rain
11/30/2022 22:00,31,126,25442,94189,157,119631,WEDNESDAY,0,0,13.9,93,46.4,1005.4,Rain
11/30/2022 23:00,15,93,21107,61252,108,82359,WEDNESDAY,0,0,14.4,90,29.5,1001.5,Rain
12/1/2022 0:00,14,38,44439,21780,52,66219,THURSDAY,0,0,14.4,90,29.5,1001.5,Rain
12/1/2022 1:00,4,20,4038,20606,24,24644,THURSDAY,0,0,14.4,90,37.1,1001.4,Rain
12/1/2022 2:00,3,9,2013,5745,12,7758,THURSDAY,0,0,8.9,74,29.5,1003.9,Rain
12/1/2022 3:00,3,5,2000,3721,8,5721,THURSDAY,0,0,7.2,68,33.5,1004.6,Rain
12/1/2022 4:00,2,8,1438,7600,10,9038,THURSDAY,0,0,6.1,55,25.9,1006.1,Rain
12/1/2022 5:00,4,45,5194,35830,49,41024,THURSDAY,0,0,6.1,55,25.9,1006.1,Rain
12/1/2022 6:00,19,152,23422,90947,171,114369,THURSDAY,0,0,6.1,55,18.4,1006.9,Rain
12/1/2022 7:00,51,437,45486,325620,488,371106,THURSDAY,0,0,4.4,43,35.3,1009.8,Rain
12/1/2022 8:00,98,816,97389,585515,914,682904,THURSDAY,0,0,3.9,41,20.5,1010.3,Clear
12/1/2022 9:00,47,447,64486,926801,494,991287,THURSDAY,0,0,3.3,42,20.5,1012,Clear
12/1/2022 10:00,53,318,65233,232319,371,297552,THURSDAY,0,0,2.8,46,20.5,1013.2,Clear
12/1/2022 11:00,51,270,1354523,206736,321,1561259,THURSDAY,0,0,2.8,46,20.5,1013.2,Fair
12/1/2022 12:00,43,358,50656,264749,401,315405,THURSDAY,0,0,3.3,42,18.4,1015.4,Fair
12/1/2022 13:00,53,317,60275,213490,370,273765,THURSDAY,0,0,3.3,42,24.1,1016,Fair
12/1/2022 14:00,64,318,112967,201048,382,314015,THURSDAY,0,0,4.4,37,35.3,1016.7,Fair
12/1/2022 15:00,66,335,74314,240969,401,315283,THURSDAY,0,0,4.4,37,35.3,1016.7,Fair
12/1/2022 16:00,77,574,84526,483043,651,567569,THURSDAY,0,0,5.6,34,37.1,1017.3,Fair
12/1/2022 17:00,107,734,192112,524475,841,716587,THURSDAY,0,0,6.1,35,31.7,1017.7,Fair
12/1/2022 18:00,79,643,67785,457129,722,524914,THURSDAY,0,0,5.6,36,25.9,1018.2,Fair
12/1/2022 19:00,66,438,71367,305491,504,376858,THURSDAY,0,0,5.6,33,25.9,1019.6,Fair
12/1/2022 20:00,48,311,45516,206692,359,252208,THURSDAY,0,0,5.6,33,35.3,1019.6,Fair
12/1/2022 21:00,34,240,30803,161462,274,192265,THURSDAY,0,0,4.4,43,18.4,1022.8,Fair
12/1/2022 22:00,25,150,23317,104166,175,127483,THURSDAY,0,0,4.4,44,29.5,1024,Fair
12/1/2022 23:00,19,85,16603,49364,104,65967,THURSDAY,0,0,4.4,44,29.5,1024,Fair
12/2/2022 0:00,37,54,63267,60420,91,123687,FRIDAY,0,0,3.9,48,18.4,1024.7,Fair
12/2/2022 1:00,29,36,78175,45617,65,123792,FRIDAY,0,0,3.9,50,20.5,1025.8,Fair
12/2/2022 2:00,13,20,17789,20002,33,37791,FRIDAY,0,0,2.8,59,25.9,1027.1,Fair
12/2/2022 3:00,2,4,1940,3073,6,5013,FRIDAY,0,0,2.8,57,18.4,1027.5,Clear
12/2/2022 4:00,4,9,2097,5424,13,7521,FRIDAY,0,0,2.8,57,18.4,1027.5,Fair
12/2/2022 5:00,6,50,4320,33999,56,38319,FRIDAY,0,0,2.8,57,16.6,1028.1,Fair
12/2/2022 6:00,9,129,5876,86328,138,92204,FRIDAY,0,0,2.2,59,16.6,1028.7,Clear
12/2/2022 7:00,31,315,31677,223279,346,254956,FRIDAY,0,0,1.1,64,13,1029.7,Clear
12/2/2022 8:00,60,558,158773,394257,618,553030,FRIDAY,0,0,1.7,61,13,1030.5,Clear
12/2/2022 9:00,47,449,60954,291178,496,352132,FRIDAY,0,0,1.7,61,13,1031.6,Clear
12/2/2022 10:00,62,322,75187,219898,384,295085,FRIDAY,0,0,1.7,61,13,1031.6,Clear
12/2/2022 11:00,77,315,86336,214333,392,300669,FRIDAY,0,0,1.7,64,11.2,1033,Fair
12/2/2022 12:00,107,383,221506,331487,490,552993,FRIDAY,0,0,2.2,62,11.2,1033.3,Fair
12/2/2022 13:00,92,391,122720,287029,483,409749,FRIDAY,0,0,3.3,57,11.2,1034.3,Fair
12/2/2022 14:00,105,391,119669,264564,496,384233,FRIDAY,0,0,4.4,51,13,1034.1,Fair
12/2/2022 15:00,131,462,168185,301878,593,470063,FRIDAY,0,0,4.4,51,13,1034.1,Fair
12/2/2022 16:00,126,643,209943,1611189,769,1821132,FRIDAY,0,0,6.7,41,7.6,1032.7,Fair
12/2/2022 17:00,155,671,1645555,485376,826,2130931,FRIDAY,0,0,6.7,43,16.6,1031.8,Fair
12/2/2022 18:00,148,549,2764481,393416,697,3157897,FRIDAY,0,0,7.2,40,13,1031.6,Fair
12/2/2022 19:00,138,438,238110,308727,576,546837,FRIDAY,0,0,7.2,40,18.4,1031.9,Fair
12/2/2022 20:00,73,253,89081,178217,326,267298,FRIDAY,0,0,7.2,40,18.4,1031.9,Cloudy
12/2/2022 21:00,64,198,675349,151808,262,827157,FRIDAY,0,0,5.6,50,18.4,1032.3,Cloudy
12/2/2022 22:00,67,191,101315,184806,258,286121,FRIDAY,0,0,5.6,50,18.4,1032.3,Cloudy
12/2/2022 23:00,69,147,69384,104529,216,173913,FRIDAY,0,0,5.6,57,20.5,1032,Cloudy
12/3/2022 0:00,68,95,72078,64418,163,136496,SATURDAY,1,0,5,57,18.4,1032.6,Cloudy
12/3/2022 1:00,64,61,878984,49658,125,928642,SATURDAY,1,0,5,60,13,1032.6,Cloudy
12/3/2022 2:00,45,53,727669,63208,98,790877,SATURDAY,1,0,4.4,65,11.2,1031.8,Cloudy
12/3/2022 3:00,7,16,8924,8866,23,17790,SATURDAY,1,0,4.4,76,9.4,1031.1,Cloudy
12/3/2022 4:00,7,12,7044,9340,19,16384,SATURDAY,1,0,4.4,76,9.4,1031.1,Cloudy
12/3/2022 5:00,1,8,1293,5997,9,7290,SATURDAY,1,0,4.4,76,7.6,1030.6,Cloudy
12/3/2022 6:00,11,32,9283,23785,43,33068,SATURDAY,1,0,3.9,82,13,1029.5,Cloudy
12/3/2022 7:00,24,83,23008,69949,107,92957,SATURDAY,1,0,5,82,14.8,1028.7,Cloudy
12/3/2022 8:00,49,225,40304,166532,274,206836,SATURDAY,1,0,5,86,11.2,1027.3,Cloudy
12/3/2022 9:00,109,353,118693,235627,462,354320,SATURDAY,1,0,4.4,86,11.2,1026,Cloudy
12/3/2022 10:00,83,325,81903,224326,408,306229,SATURDAY,1,0,4.4,86,11.2,1026,Cloudy
12/3/2022 11:00,59,217,1311362,148417,276,1459779,SATURDAY,1,0,8.9,86,16.6,1023.6,Cloudy
12/3/2022 12:00,75,228,258368,151578,303,409946,SATURDAY,1,0,10.6,86,25.9,1022.7,Cloudy
12/3/2022 13:00,33,165,49433,174516,198,223949,SATURDAY,1,0,13.9,74,27.7,1021.3,Cloudy
12/3/2022 14:00,24,96,20878,63697,120,84575,SATURDAY,1,0,14.4,70,35.3,1020.2,Cloudy
12/3/2022 15:00,30,148,32582,100270,178,132852,SATURDAY,1,0,14.4,70,35.3,1020.2,Cloudy
12/3/2022 16:00,47,234,39875,163864,281,203739,SATURDAY,1,0,14.4,78,37.1,1015.9,Rain
12/3/2022 17:00,56,275,67576,191600,331,259176,SATURDAY,1,0,13.9,83,44.6,1014.4,Rain
12/3/2022 18:00,75,336,364096,251122,411,615218,SATURDAY,1,0,13.9,87,42.5,1012.9,Rain
12/3/2022 19:00,69,269,79301,161477,338,240778,SATURDAY,1,0,13.9,90,38.9,1012.2,Rain
12/3/2022 20:00,51,204,2228125,138189,255,2366314,SATURDAY,1,0,13.9,90,38.9,1012.2,Rain
12/3/2022 21:00,46,159,55341,115316,205,170657,SATURDAY,1,0,13.9,90,35.3,1011,Cloudy
12/3/2022 22:00,83,151,84682,107400,234,192082,SATURDAY,1,0,13.9,90,31.7,1011,Rain
12/3/2022 23:00,46,123,46562,77699,169,124261,SATURDAY,1,0,13.9,87,25.9,1010.7,Rain
12/4/2022 0:00,51,118,209577,75487,169,285064,SUNDAY,1,0,13.9,83,27.7,1010.5,Rain
12/4/2022 1:00,67,59,82904,40890,126,123794,SUNDAY,1,0,13.9,81,35.3,1012.2,Rain
12/4/2022 2:00,66,43,114430,32033,109,146463,SUNDAY,1,0,10,61,40.7,1013.3,Cloudy
12/4/2022 3:00,10,20,12327,8710,30,21037,SUNDAY,1,0,7.8,55,42.5,1014.6,Cloudy
12/4/2022 4:00,3,5,1893,3935,8,5828,SUNDAY,1,0,6.1,55,24.1,1015.1,Fair
12/4/2022 5:00,11,22,14749,21483,33,36232,SUNDAY,1,0,6.1,55,24.1,1015.1,Fair
12/4/2022 6:00,5,29,8624,19424,34,28048,SUNDAY,1,0,5.6,55,24.1,1015.4,Fair
12/4/2022 7:00,17,57,19265,42165,74,61430,SUNDAY,1,0,4.4,53,14.8,1017.7,Clear
12/4/2022 8:00,38,163,47118,120765,201,167883,SUNDAY,1,0,3.9,55,22.3,1018.1,Clear
12/4/2022 9:00,55,250,2301931,174756,305,2476687,SUNDAY,1,0,3.3,55,16.6,1018.2,Clear
12/4/2022 10:00,90,331,111468,232278,421,343746,SUNDAY,1,0,3.3,55,16.6,1018.2,Clear
12/4/2022 11:00,113,351,193475,255937,464,449412,SUNDAY,1,0,2.8,54,9.4,1020.4,Clear
12/4/2022 12:00,138,428,182672,337528,566,520200,SUNDAY,1,0,3.3,50,16.6,1021,Fair
12/4/2022 13:00,147,450,1314919,364115,597,1679034,SUNDAY,1,0,4.4,46,16.6,1021.5,Fair
12/4/2022 14:00,116,437,151095,344670,553,495765,SUNDAY,1,0,4.4,46,16.6,1021.5,Fair
12/4/2022 15:00,89,399,840429,318511,488,1158940,SUNDAY,1,0,5.6,39,22.3,1020.6,Fair
12/4/2022 16:00,107,402,1914757,308853,509,2223610,SUNDAY,1,0,6.1,38,14.8,1020,Fair
12/4/2022 17:00,67,311,95358,221434,378,316792,SUNDAY,1,0,5.6,38,22.3,1019.5,Fair
12/4/2022 18:00,67,298,88270,337863,365,426133,SUNDAY,1,0,5.6,38,14.8,1019.3,Fair
12/4/2022 19:00,42,208,53730,130285,250,184015,SUNDAY,1,0,5.6,38,14.8,1019.3,Cloudy
12/4/2022 20:00,41,181,51267,110414,222,161681,SUNDAY,1,0,5,39,14.8,1020.8,Cloudy
12/4/2022 21:00,30,133,46254,95682,163,141936,SUNDAY,1,0,4.4,39,9.4,1021.7,Cloudy
12/4/2022 22:00,34,123,81799,72578,157,154377,SUNDAY,1,0,5,38,7.6,1021.9,Cloudy
12/4/2022 23:00,16,61,18003,38566,77,56569,SUNDAY,1,0,5,38,7.6,1021.9,Cloudy
12/5/2022 0:00,10,38,15540,21000,48,36540,MONDAY,0,0,4.4,39,9.4,1022.2,Cloudy
12/5/2022 1:00,16,22,14599,22248,38,36847,MONDAY,0,0,3.9,42,9.4,1022.5,Fair
12/5/2022 2:00,6,7,6320,3386,13,9706,MONDAY,0,0,2.8,50,7.6,1022.3,Fair
12/5/2022 3:00,4,5,4689,3672,9,8361,MONDAY,0,0,2.8,52,13,1022.7,Clear
12/5/2022 4:00,2,8,23921,5276,10,29197,MONDAY,0,0,0.6,63,9.4,1022.6,Clear
12/5/2022 5:00,4,42,2618,25824,46,28442,MONDAY,0,0,0.6,63,9.4,1022.6,Clear
12/5/2022 6:00,11,122,6536,84366,133,90902,MONDAY,0,0,1.1,64,5.4,1023.3,Clear
12/5/2022 7:00,35,385,35794,281497,420,317291,MONDAY,0,0,0.6,69,5.4,1023.6,Clear
12/5/2022 8:00,70,671,66429,474606,741,541035,MONDAY,0,0,0.6,66,5.4,1023.5,Clear
12/5/2022 9:00,43,430,56932,427296,473,484228,MONDAY,0,0,0.6,66,5.4,1023.5,Clear
12/5/2022 10:00,44,306,53016,210823,350,263839,MONDAY,0,0,0,72,14.8,1024.1,Clear
12/5/2022 11:00,44,256,41085,167840,300,208925,MONDAY,0,0,0,72,11.2,1024.8,Fair
12/5/2022 12:00,50,346,57332,230531,396,287863,MONDAY,0,0,1.7,66,14.8,1025.4,Fair
12/5/2022 13:00,64,364,66433,230338,428,296771,MONDAY,0,0,3.3,64,18.4,1025.8,Fair
12/5/2022 14:00,65,333,2363170,292138,398,2655308,MONDAY,0,0,3.3,64,18.4,1025.8,Fair
12/5/2022 15:00,79,391,114522,282882,470,397404,MONDAY,0,0,7.8,51,25.9,1026,Fair
12/5/2022 16:00,92,601,556947,565872,693,1122819,MONDAY,0,0,8.3,52,27.7,1025.2,Fair
12/5/2022 17:00,97,728,79328,530739,825,610067,MONDAY,0,0,8.9,47,24.1,1025,Fair
12/5/2022 18:00,85,617,91810,423741,702,515551,MONDAY,0,0,9.4,48,24.1,1024.9,Fair
12/5/2022 19:00,72,410,109083,253399,482,362482,MONDAY,0,0,9.4,48,25.9,1024.9,Fair
12/5/2022 20:00,59,292,56765,180924,351,237689,MONDAY,0,0,7.8,60,18.4,1025.7,Cloudy
12/5/2022 21:00,54,179,45516,115740,233,161256,MONDAY,0,0,7.8,60,18.4,1025.7,Cloudy
12/5/2022 22:00,40,145,38951,96709,185,135660,MONDAY,0,0,6.1,68,13,1027.6,Cloudy
12/5/2022 23:00,21,87,23037,53981,108,77018,MONDAY,0,0,5,76,13,1027.8,Cloudy
12/6/2022 0:00,11,39,13999,19530,50,33529,TUESDAY,0,0,5,76,13,1027.8,Cloudy
12/6/2022 1:00,17,22,16424,14432,39,30856,TUESDAY,0,0,5,79,9.4,1028.3,Cloudy
12/6/2022 2:00,3,11,2507,7580,14,10087,TUESDAY,0,0,5,82,7.6,1028.6,Cloudy
12/6/2022 3:00,2,2,2355,2922,4,5277,TUESDAY,0,0,5,82,7.6,1028.6,Cloudy
12/6/2022 4:00,1,9,6064,6142,10,12206,TUESDAY,0,0,5,82,13,1029.1,Cloudy
12/6/2022 5:00,2,42,914,29304,44,30218,TUESDAY,0,0,5,82,13,1029.1,Cloudy
12/6/2022 6:00,15,168,11391,114217,183,125608,TUESDAY,0,0,5.6,85,11.2,1029.4,Cloudy
12/6/2022 7:00,41,456,29920,311993,497,341913,TUESDAY,0,0,5.6,85,7.6,1029.9,Cloudy
12/6/2022 8:00,102,880,86516,638668,982,725184,TUESDAY,0,0,5.6,85,5.4,1030.1,Cloudy
12/6/2022 9:00,58,522,100697,493869,580,594566,TUESDAY,0,0,6.1,86,0,1029.7,Cloudy
12/6/2022 10:00,43,341,69021,245675,384,314696,TUESDAY,0,0,6.1,86,0,1029.7,Cloudy
12/6/2022 11:00,45,318,42767,307451,363,350218,TUESDAY,0,0,6.7,85,5.4,1030.2,Cloudy
12/6/2022 12:00,66,382,1370380,247141,448,1617521,TUESDAY,0,0,7.2,90,7.6,1030.3,Cloudy
12/6/2022 13:00,51,372,66430,279055,423,345485,TUESDAY,0,0,8.9,86,9.4,1030.7,Cloudy
12/6/2022 14:00,79,376,84584,282525,455,367109,TUESDAY,0,0,8.9,86,9.4,1030.7,Cloudy
12/6/2022 15:00,93,433,334654,298141,526,632795,TUESDAY,0,0,11.1,71,13,1030.2,Cloudy
12/6/2022 16:00,103,679,119209,468302,782,587511,TUESDAY,0,0,11.1,71,13,1030.2,Cloudy
12/6/2022 17:00,99,853,99246,737099,952,836345,TUESDAY,0,0,11.1,74,11.2,1029.4,Cloudy
12/6/2022 18:00,75,503,72870,349700,578,422570,TUESDAY,0,0,11.1,74,11.2,1029.4,Cloudy
12/6/2022 19:00,29,292,29211,198523,321,227734,TUESDAY,0,0,12.2,64,13,1029.4,Cloudy
12/6/2022 20:00,39,226,39243,156279,265,195522,TUESDAY,0,0,12.2,64,13,1029.4,Cloudy
12/6/2022 21:00,30,155,24549,106854,185,131403,TUESDAY,0,0,10,83,13,1029.7,Cloudy
12/6/2022 22:00,18,86,24181,65071,104,89252,TUESDAY,0,0,9.4,86,11.2,1029.9,Cloudy
12/6/2022 23:00,25,66,28510,49296,91,77806,TUESDAY,0,0,10,86,16.6,1029.7,Cloudy
12/7/2022 0:00,2,22,1414,15204,24,16618,WEDNESDAY,0,0,10,86,16.6,1029.7,Rain
12/7/2022 1:00,3,16,1930,9279,19,11209,WEDNESDAY,0,0,10,89,9.4,1029.6,Rain
12/7/2022 2:00,2,7,841,3087,9,3928,WEDNESDAY,0,0,9.4,93,11.2,1029.5,Rain
12/7/2022 3:00,1,4,687,3266,5,3953,WEDNESDAY,0,0,9.4,93,14.8,1028.9,Rain
12/7/2022 4:00,1,3,5705,1517,4,7222,WEDNESDAY,0,0,9.4,93,14.8,1028.9,Rain
12/7/2022 5:00,1,28,894,19394,29,20288,WEDNESDAY,0,0,10,89,14.8,1028.6,Rain
12/7/2022 6:00,7,78,5757,40533,85,46290,WEDNESDAY,0,0,9.4,93,14.8,1028.1,Rain
12/7/2022 7:00,15,176,10516,128232,191,138748,WEDNESDAY,0,0,9.4,93,14.8,1028.1,Rain
12/7/2022 8:00,49,407,47442,301416,456,348858,WEDNESDAY,0,0,8.9,96,13,1027,Rain
12/7/2022 9:00,25,309,25992,189388,334,215380,WEDNESDAY,0,0,8.9,96,13,1027,Rain
12/7/2022 10:00,38,254,29980,167118,292,197098,WEDNESDAY,0,0,10,96,16.6,1025.9,Rain
12/7/2022 11:00,41,293,40204,223197,334,263401,WEDNESDAY,0,0,10,93,16.6,1025.4,Rain
12/7/2022 12:00,22,218,17548,133713,240,151261,WEDNESDAY,0,0,10,96,14.8,1025,Rain
12/7/2022 13:00,33,199,26166,234659,232,260825,WEDNESDAY,0,0,10.6,96,14.8,1024.7,Rain
12/7/2022 14:00,30,228,33230,135428,258,168658,WEDNESDAY,0,0,10.6,96,14.8,1024.7,Rain
12/7/2022 15:00,26,211,21097,158824,237,179921,WEDNESDAY,0,0,12.2,93,18.4,1023.1,Rain
12/7/2022 16:00,49,375,45893,262430,424,308323,WEDNESDAY,0,0,12.8,93,18.4,1022,Rain
12/7/2022 17:00,122,652,192074,1777571,774,1969645,WEDNESDAY,0,0,13.3,93,22.3,1021.2,Cloudy
12/7/2022 18:00,84,586,133921,414317,670,548238,WEDNESDAY,0,0,13.3,93,22.3,1021.2,Rain
12/7/2022 19:00,75,415,98188,301829,490,400017,WEDNESDAY,0,0,13.3,97,14.8,1020.4,Rain
12/7/2022 20:00,52,254,63725,178698,306,242423,WEDNESDAY,0,0,13.3,100,13,1019.1,Rain
12/7/2022 21:00,47,213,67263,191285,260,258548,WEDNESDAY,0,0,13.3,100,13,1019.1,Cloudy
12/7/2022 22:00,39,175,55236,136531,214,191767,WEDNESDAY,0,0,12.8,100,16.6,1018.2,Rain
12/7/2022 23:00,24,108,40718,95817,132,136535,WEDNESDAY,0,0,13.3,100,11.2,1017.6,Rain
12/8/2022 0:00,25,58,47748,50138,83,97886,THURSDAY,0,0,13.9,96,14.8,1016.3,Rain
12/8/2022 1:00,26,31,59557,22613,57,82170,THURSDAY,0,0,14.4,93,11.2,1016.3,Rain
12/8/2022 2:00,9,15,256097,9855,24,265952,THURSDAY,0,0,14.4,93,11.2,1016.3,Cloudy
12/8/2022 3:00,7,8,16551,6351,15,22902,THURSDAY,0,0,15,90,14.8,1016.1,Cloudy
12/8/2022 4:00,5,7,11736,6840,12,18576,THURSDAY,0,0,14.4,90,16.6,1015.7,Rain
12/8/2022 5:00,6,45,6654,25994,51,32648,THURSDAY,0,0,14.4,87,16.6,1016.1,Cloudy
12/8/2022 6:00,26,174,25579,114568,200,140147,THURSDAY,0,0,13.3,87,18.4,1016.7,Cloudy
12/8/2022 7:00,57,408,62073,415664,465,477737,THURSDAY,0,0,12.2,83,20.5,1017.5,Cloudy
12/8/2022 8:00,100,821,97210,2410111,921,2507321,THURSDAY,0,0,11.1,74,20.5,1017.8,Cloudy
12/8/2022 9:00,65,521,98140,363250,586,461390,THURSDAY,0,0,11.1,74,29.5,1017.8,Fair
12/8/2022 10:00,59,337,86159,228202,396,314361,THURSDAY,0,0,10,71,20.5,1019.3,Fair
12/8/2022 11:00,69,313,113171,1553126,382,1666297,THURSDAY,0,0,9.4,71,22.3,1019.6,Fair
12/8/2022 12:00,90,389,198366,293116,479,491482,THURSDAY,0,0,9.4,63,22.3,1020.1,Fair
12/8/2022 13:00,68,356,94157,2577997,424,2672154,THURSDAY,0,0,9.4,63,22.3,1020.1,Fair
12/8/2022 14:00,106,360,141769,254117,466,395886,THURSDAY,0,0,10,56,25.9,1020.9,Fair
12/8/2022 15:00,91,426,122500,305991,517,428491,THURSDAY,0,0,10.6,54,35.3,1020.2,Fair
12/8/2022 16:00,111,574,119727,482795,685,602522,THURSDAY,0,0,11.1,48,25.9,1020.2,Fair
12/8/2022 17:00,131,737,128102,533215,868,661317,THURSDAY,0,0,11.1,46,25.9,1019.6,Fair
12/8/2022 18:00,98,587,112187,459776,685,571963,THURSDAY,0,0,11.1,46,25.9,1019.6,Fair
12/8/2022 19:00,68,416,65005,284049,484,349054,THURSDAY,0,0,10.6,44,27.7,1020.1,Fair
12/8/2022 20:00,54,268,62075,168363,322,230438,THURSDAY,0,0,8.9,50,22.3,1021,Fair
12/8/2022 21:00,46,227,43409,145602,273,189011,THURSDAY,0,0,8.9,50,29.5,1021,Fair
12/8/2022 22:00,39,154,35450,100634,193,136084,THURSDAY,0,0,7.2,51,22.3,1021.4,Fair
12/8/2022 23:00,20,96,19972,58666,116,78638,THURSDAY,0,0,6.1,53,25.9,1021.7,Fair
12/9/2022 0:00,18,62,17419,33894,80,51313,FRIDAY,0,0,4.4,60,22.3,1022.8,Fair
12/9/2022 1:00,16,37,17944,18692,53,36636,FRIDAY,0,0,4.4,60,22.3,1022.8,Fair
12/9/2022 2:00,11,14,11730,5648,25,17378,FRIDAY,0,0,3.3,64,22.3,1023.5,Fair
12/9/2022 3:00,4,8,2863,5071,12,7934,FRIDAY,0,0,2.8,67,14.8,1023.8,Clear
12/9/2022 4:00,0,9,0,8001,9,8001,FRIDAY,0,0,2.8,67,14.8,1023.8,Clear
12/9/2022 5:00,3,43,1896,32941,46,34837,FRIDAY,0,0,2.2,64,22.3,1023.3,Clear
12/9/2022 6:00,7,100,3133,63090,107,66223,FRIDAY,0,0,1.7,64,22.3,1023.4,Clear
12/9/2022 7:00,38,277,37208,203115,315,240323,FRIDAY,0,0,1.7,58,22.3,1023.4,Clear
12/9/2022 8:00,48,496,192726,364311,544,557037,FRIDAY,0,0,1.7,56,25.9,1023.2,Clear
12/9/2022 9:00,52,379,56169,346504,431,402673,FRIDAY,0,0,1.7,56,27.7,1023.2,Clear
12/9/2022 10:00,51,286,58279,189507,337,247786,FRIDAY,0,0,1.1,56,22.3,1023.7,Clear
12/9/2022 11:00,71,279,121324,179049,350,300373,FRIDAY,0,0,1.1,56,22.3,1024.1,Clear
12/9/2022 12:00,68,350,70711,225904,418,296615,FRIDAY,0,0,1.7,52,20.5,1024.1,Fair
12/9/2022 13:00,98,417,114386,285169,515,399555,FRIDAY,0,0,1.7,52,20.5,1024.1,Fair
12/9/2022 14:00,103,361,2717104,248976,464,2966080,FRIDAY,0,0,4.4,44,20.5,1024.1,Fair
12/9/2022 15:00,105,382,122313,286980,487,409293,FRIDAY,0,0,6.1,33,27.7,1023.5,Fair
12/9/2022 16:00,94,461,114497,2330537,555,2445034,FRIDAY,0,0,7.2,20,27.7,1023.1,Fair
12/9/2022 17:00,134,657,1069952,508321,791,1578273,FRIDAY,0,0,7.8,18,29.5,1022.8,Fair
12/9/2022 18:00,108,498,1822425,378233,606,2200658,FRIDAY,0,0,7.8,18,25.9,1022.8,Fair
12/9/2022 19:00,82,360,108145,272257,442,380402,FRIDAY,0,0,8.3,18,20.5,1022.8,Fair
12/9/2022 20:00,64,255,133667,181190,319,314857,FRIDAY,0,0,7.2,20,20.5,1023.1,Fair
12/9/2022 21:00,58,207,295779,147269,265,443048,FRIDAY,0,0,7.2,20,20.5,1023.1,Fair
12/9/2022 22:00,44,167,68948,114985,211,183933,FRIDAY,0,0,6.1,21,18.4,1023.7,Fair
12/9/2022 23:00,37,129,85061,85884,166,170945,FRIDAY,0,0,5,23,22.3,1023.9,Clear
12/10/2022 0:00,54,87,59465,59794,141,119259,SATURDAY,1,0,3.9,26,20.5,1024.2,Clear
12/10/2022 1:00,50,93,1820655,68297,143,1888952,SATURDAY,1,0,3.3,28,22.3,1024.9,Clear
12/10/2022 2:00,34,48,41217,26654,82,67871,SATURDAY,1,0,2.8,31,18.4,1025.4,Clear
12/10/2022 3:00,12,8,28784,4315,20,33099,SATURDAY,1,0,2.8,31,18.4,1025.4,Clear
12/10/2022 4:00,3,5,1567,4072,8,5639,SATURDAY,1,0,2.2,38,22.3,1025.7,Fair
12/10/2022 5:00,4,15,4619,12696,19,17315,SATURDAY,1,0,1.1,43,16.6,1026.6,Fair
12/10/2022 6:00,8,35,6873,24187,43,31060,SATURDAY,1,0,1.1,46,16.6,1027.1,Clear
12/10/2022 7:00,9,64,7957,38306,73,46263,SATURDAY,1,0,1.1,46,16.6,1027.1,Clear
12/10/2022 8:00,24,126,23508,343037,150,366545,SATURDAY,1,0,0.6,49,16.6,1027.5,Clear
12/10/2022 9:00,41,212,36801,149004,253,185805,SATURDAY,1,0,0,49,16.6,1027.9,Clear
12/10/2022 10:00,61,281,68440,201295,342,269735,SATURDAY,1,0,0,51,20.5,1028.7,Clear
12/10/2022 11:00,87,299,164674,214062,386,378736,SATURDAY,1,0,0,64,22.3,1029.3,Fair
12/10/2022 12:00,101,373,111266,1040964,474,1152230,SATURDAY,1,0,0,72,20.5,1030,Rain
12/10/2022 13:00,148,412,1359715,320262,560,1679977,SATURDAY,1,0,0,72,20.5,1030,Cloudy
12/10/2022 14:00,85,327,139847,264816,412,404663,SATURDAY,1,0,-0.6,63,24.1,1031,Cloudy
12/10/2022 15:00,81,279,114169,300872,360,415041,SATURDAY,1,0,-0.6,63,20.5,1030.8,Cloudy
12/10/2022 16:00,98,353,97246,255662,451,352908,SATURDAY,1,0,0,69,25.9,1030.8,Cloudy
12/10/2022 17:00,48,312,39055,224783,360,263838,SATURDAY,1,0,0,69,25.9,1030.8,Cloudy
12/10/2022 18:00,83,253,101282,211416,336,312698,SATURDAY,1,0,0,72,22.3,1030,Cloudy
12/10/2022 19:00,80,237,142824,326429,317,469253,SATURDAY,1,0,0,72,22.3,1030,Cloudy
12/10/2022 20:00,40,165,47495,123553,205,171048,SATURDAY,1,0,0,75,20.5,1030.3,Cloudy
12/10/2022 21:00,41,158,51187,100693,199,151880,SATURDAY,1,0,0.6,72,20.5,1030.9,Cloudy
12/10/2022 22:00,33,93,30395,71443,126,101838,SATURDAY,1,0,0.6,72,20.5,1030.9,Cloudy
12/10/2022 23:00,71,123,121192,82385,194,203577,SATURDAY,1,0,0.6,63,18.4,1031.7,Cloudy
12/11/2022 0:00,36,72,39705,49764,108,89469,SUNDAY,1,0,0.6,61,20.5,1031.3,Cloudy
12/11/2022 1:00,34,62,96047,171257,96,267304,SUNDAY,1,0,0.6,66,20.5,1030.2,Cloudy
12/11/2022 2:00,24,38,24396,25561,62,49957,SUNDAY,1,0,0.6,66,20.5,1030.2,Cloudy
12/11/2022 3:00,7,9,4844,8206,16,13050,SUNDAY,1,0,2.2,73,29.5,1029.7,Cloudy
12/11/2022 4:00,2,11,9079,8048,13,17127,SUNDAY,1,0,1.7,72,25.9,1030.4,Cloudy
12/11/2022 5:00,3,11,4257,8813,14,13070,SUNDAY,1,0,-0.6,58,22.3,1030.4,Cloudy
12/11/2022 6:00,4,28,4593,18656,32,23249,SUNDAY,1,0,-1.1,58,24.1,1030.7,Cloudy
12/11/2022 7:00,8,37,6535,19153,45,25688,SUNDAY,1,0,-1.7,61,24.1,1030.4,Cloudy
12/11/2022 8:00,17,69,11364,57182,86,68546,SUNDAY,1,0,-1.7,61,24.1,1030.4,Cloudy
12/11/2022 9:00,41,143,77578,100717,184,178295,SUNDAY,1,0,-2.8,63,24.1,1030.2,Cloudy
12/11/2022 10:00,66,218,84616,152271,284,236887,SUNDAY,1,0,-2.8,60,24.1,1030,Cloudy
12/11/2022 11:00,64,236,738878,2180227,300,2919105,SUNDAY,1,0,-3.3,65,27.7,1029.8,Cloudy
12/11/2022 12:00,59,284,69442,219949,343,289391,SUNDAY,1,0,-3.3,68,24.1,1029.5,Cloudy
12/11/2022 13:00,66,308,86844,232587,374,319431,SUNDAY,1,0,-3.3,68,24.1,1029.5,Cloudy
12/11/2022 14:00,52,261,58040,207292,313,265332,SUNDAY,1,0,-2.2,66,22.3,1029,Cloudy
12/11/2022 15:00,85,290,104664,206657,375,311321,SUNDAY,1,0,-2.2,66,22.3,1028.3,Cloudy
12/11/2022 16:00,35,158,42437,194265,193,236702,SUNDAY,1,0,-1.7,66,18.4,1027.3,Cloudy
12/11/2022 17:00,17,102,18381,91536,119,109917,SUNDAY,1,0,-1.1,66,20.5,1025.9,Cloudy
12/11/2022 18:00,11,65,9537,50397,76,59934,SUNDAY,1,0,-1.1,66,20.5,1025.9,Cloudy
12/11/2022 19:00,10,88,9442,57781,98,67223,SUNDAY,1,0,-1.1,75,20.5,1024.7,Cloudy
12/11/2022 20:00,7,62,8982,45922,69,54904,SUNDAY,1,0,-1.1,75,18.4,1024.2,Snow
12/11/2022 21:00,2,44,2035,93450,46,95485,SUNDAY,1,0,-1.1,75,18.4,1024.2,Snow
12/11/2022 22:00,8,52,4799,40256,60,45055,SUNDAY,1,0,-1.1,81,16.6,1023.7,Snow
12/11/2022 23:00,3,31,2491,21970,34,24461,SUNDAY,1,0,-2.2,88,14.8,1022.9,Snow
12/12/2022 0:00,1,19,985,9497,20,10482,MONDAY,0,0,-2.2,88,14.8,1022.5,Snow
12/12/2022 1:00,1,7,837,5628,8,6465,MONDAY,0,0,-2.2,88,16.6,1022.3,Cloudy
12/12/2022 2:00,0,5,0,3381,5,3381,MONDAY,0,0,-2.2,85,14.8,1021.1,Snow
12/12/2022 3:00,5,10,35265,11868,15,47133,MONDAY,0,0,-3.3,81,18.4,1020.8,Snow
12/12/2022 4:00,2,11,2406,11517,13,13923,MONDAY,0,0,-3.3,81,18.4,1020.8,Snow
12/12/2022 5:00,1,28,180770,16699,29,197469,MONDAY,0,0,-3.9,81,18.4,1020.1,Snow
12/12/2022 6:00,4,85,3709,56385,89,60094,MONDAY,0,0,-3.9,81,18.4,1020.1,Snow
12/12/2022 7:00,15,155,9654,477575,170,487229,MONDAY,0,0,-3.9,81,24.1,1020,Snow
12/12/2022 8:00,24,386,17061,291063,410,308124,MONDAY,0,0,-3.9,85,20.5,1019.3,Snow
12/12/2022 9:00,23,248,28506,193677,271,222183,MONDAY,0,0,-3.9,85,20.5,1019.3,Snow
12/12/2022 10:00,17,200,11444,122631,217,134075,MONDAY,0,0,-3.9,85,20.5,1020.2,Cloudy
12/12/2022 11:00,24,161,16453,96921,185,113374,MONDAY,0,0,-3.9,85,20.5,1020.2,Cloudy
12/12/2022 12:00,15,221,17015,135449,236,152464,MONDAY,0,0,-3.9,81,18.4,1020.7,Cloudy
12/12/2022 13:00,33,177,55930,116172,210,172102,MONDAY,0,0,-3.3,74,20.5,1021.7,Cloudy
12/12/2022 14:00,25,229,28089,148500,254,176589,MONDAY,0,0,-2.2,69,16.6,1021.8,Cloudy
12/12/2022 15:00,34,225,47775,153845,259,201620,MONDAY,0,0,-2.2,60,22.3,1021.4,Cloudy
12/12/2022 16:00,53,346,56154,246805,399,302959,MONDAY,0,0,-1.1,51,22.3,1021,Cloudy
12/12/2022 17:00,43,468,50644,348483,511,399127,MONDAY,0,0,-1.1,51,22.3,1021,Fair
12/12/2022 18:00,40,396,37808,281677,436,319485,MONDAY,0,0,0.6,35,18.4,1020.9,Fair
12/12/2022 19:00,33,312,30635,199973,345,230608,MONDAY,0,0,1.1,32,13,1021,Fair
12/12/2022 20:00,15,161,12481,108339,176,120820,MONDAY,0,0,0.6,35,14.8,1021.3,Fair
12/12/2022 21:00,14,130,10750,97467,144,108217,MONDAY,0,0,0,43,13,1021.5,Fair
12/12/2022 22:00,20,94,19954,54905,114,74859,MONDAY,0,0,0,43,13,1021.5,Fair
12/12/2022 23:00,11,67,7886,43153,78,51039,MONDAY,0,0,0,54,14.8,1021.9,Fair
12/13/2022 0:00,14,32,11882,21570,46,33452,TUESDAY,0,0,-1.1,51,18.4,1021.8,Clear
12/13/2022 1:00,6,14,4824,7165,20,11989,TUESDAY,0,0,-1.1,49,18.4,1022,Clear
12/13/2022 2:00,1,9,184,5342,10,5526,TUESDAY,0,0,-1.7,51,18.4,1022.3,Clear
12/13/2022 3:00,1,12,496,14259,13,14755,TUESDAY,0,0,-1.7,51,18.4,1022.3,Clear
12/13/2022 4:00,1,2,5194,1037,3,6231,TUESDAY,0,0,-2.2,51,20.5,1021.8,Clear
12/13/2022 5:00,2,33,1189,40403,35,41592,TUESDAY,0,0,-2.2,51,20.5,1021.9,Clear
12/13/2022 6:00,6,119,3241,76004,125,79245,TUESDAY,0,0,-2.8,53,22.3,1022.2,Clear
12/13/2022 7:00,28,320,60592,203473,348,264065,TUESDAY,0,0,-2.2,53,22.3,1021.7,Clear
12/13/2022 8:00,56,593,58694,617929,649,676623,TUESDAY,0,0,-2.2,53,22.3,1021.7,Clear
12/13/2022 9:00,31,370,24308,256344,401,280652,TUESDAY,0,0,-2.8,58,20.5,1021.2,Clear
12/13/2022 10:00,27,223,30553,158228,250,188781,TUESDAY,0,0,-2.8,58,18.4,1021.8,Clear
12/13/2022 11:00,18,240,20269,173546,258,193815,TUESDAY,0,0,-2.2,55,18.4,1021.9,Fair
12/13/2022 12:00,37,289,212394,172404,326,384798,TUESDAY,0,0,-2.2,55,24.1,1021.9,Fair
12/13/2022 13:00,51,273,38876,269923,324,308799,TUESDAY,0,0,-0.6,51,24.1,1022.3,Fair
12/13/2022 14:00,50,260,47435,169257,310,216692,TUESDAY,0,0,1.1,43,22.3,1022.1,Fair
12/13/2022 15:00,52,305,61464,220101,357,281565,TUESDAY,0,0,1.1,43,27.7,1022.1,Fair
12/13/2022 16:00,81,455,74190,336951,536,411141,TUESDAY,0,0,4.4,37,24.1,1020.7,Rain
12/13/2022 17:00,78,608,81073,452414,686,533487,TUESDAY,0,0,4.4,37,24.1,1019.8,Fair
12/13/2022 18:00,61,464,119817,342995,525,462812,TUESDAY,0,0,4.4,37,24.1,1019.8,Fair
12/13/2022 19:00,45,321,45612,219160,366,264772,TUESDAY,0,0,5,33,27.7,1019.4,Fair
12/13/2022 20:00,31,208,29790,135437,239,165227,TUESDAY,0,0,3.9,39,22.3,1019.2,Fair
12/13/2022 21:00,30,149,31147,102753,179,133900,TUESDAY,0,0,3.3,44,16.6,1019,Fair
12/13/2022 22:00,24,111,22655,69591,135,92246,TUESDAY,0,0,3.3,44,16.6,1019,Fair
12/13/2022 23:00,17,68,13265,37496,85,50761,TUESDAY,0,0,2.2,46,20.5,1018.5,Clear
12/14/2022 0:00,11,39,16282,23413,50,39695,WEDNESDAY,0,0,2.2,44,18.4,1017.8,Fair
12/14/2022 1:00,6,9,4752,8916,15,13668,WEDNESDAY,0,0,2.2,44,18.4,1017.8,Fair
12/14/2022 2:00,1,12,965,6881,13,7846,WEDNESDAY,0,0,1.1,50,20.5,1016.1,Fair
12/14/2022 3:00,0,6,0,4408,6,4408,WEDNESDAY,0,0,1.1,50,20.5,1016.1,Fair
12/14/2022 4:00,3,7,2067,6187,10,8254,WEDNESDAY,0,0,0.6,53,24.1,1014.8,Fair
12/14/2022 5:00,5,33,3928,27189,38,31117,WEDNESDAY,0,0,0.6,56,16.6,1014.3,Fair
12/14/2022 6:00,8,110,4151,61233,118,65384,WEDNESDAY,0,0,0.6,56,16.6,1014.3,Fair
12/14/2022 7:00,29,274,23637,195698,303,219335,WEDNESDAY,0,0,-2.2,63,24.1,1015.1,Fair
12/14/2022 8:00,41,533,31350,370064,574,401414,WEDNESDAY,0,0,-2.2,48,33.5,1015.1,Fair
12/14/2022 9:00,33,354,23217,232128,387,255345,WEDNESDAY,0,0,-4.4,48,44.6,1015.7,Fair
12/14/2022 10:00,31,206,1207642,142956,237,1350598,WEDNESDAY,0,0,-5,45,27.7,1015.5,Rain
12/14/2022 11:00,21,205,31295,142260,226,173555,WEDNESDAY,0,0,-5,50,31.7,1015.8,Fair
12/14/2022 12:00,32,214,40540,129986,246,170526,WEDNESDAY,0,0,-5,50,33.5,1015.8,Fair
12/14/2022 13:00,34,263,33902,168484,297,202386,WEDNESDAY,0,0,-3.3,48,37.1,1015.8,Fair
12/14/2022 14:00,32,236,34758,147047,268,181805,WEDNESDAY,0,0,-1.7,46,37.1,1016,Fair
12/14/2022 15:00,39,269,64375,190227,308,254602,WEDNESDAY,0,0,0,47,35.3,1015.4,Fair
12/14/2022 16:00,64,426,155158,401319,490,556477,WEDNESDAY,0,0,1.7,45,38.9,1014.5,Fair
12/14/2022 17:00,75,565,76256,408663,640,484919,WEDNESDAY,0,0,1.7,45,35.3,1014.5,Fair
12/14/2022 18:00,44,432,39054,312693,476,351747,WEDNESDAY,0,0,2.8,48,29.5,1014.3,Fair
12/14/2022 19:00,32,297,31085,193898,329,224983,WEDNESDAY,0,0,2.8,48,29.5,1015.5,Fair
12/14/2022 20:00,25,161,24745,106443,186,131188,WEDNESDAY,0,0,2.2,50,33.5,1016.5,Fair
12/14/2022 21:00,22,162,24904,122019,184,146923,WEDNESDAY,0,0,1.7,52,22.3,1017.3,Fair
12/14/2022 22:00,19,133,20363,93028,152,113391,WEDNESDAY,0,0,1.7,52,22.3,1017.3,Fair
12/14/2022 23:00,6,63,5451,43285,69,48736,WEDNESDAY,0,0,1.1,56,24.1,1018.8,Fair
12/15/2022 0:00,4,36,6329,23079,40,29408,THURSDAY,0,0,0.6,61,25.9,1019.8,Fair
12/15/2022 1:00,10,16,16917,13809,26,30726,THURSDAY,0,0,0.6,61,24.1,1019.8,Fair
12/15/2022 2:00,2,20,6857,12315,22,19172,THURSDAY,0,0,1.1,61,25.9,1021.1,Fair
12/15/2022 3:00,3,8,1688,5955,11,7643,THURSDAY,0,0,1.1,61,25.9,1021.1,Fair
12/15/2022 4:00,3,6,5139,7988,9,13127,THURSDAY,0,0,0.6,66,20.5,1022.8,Fair
12/15/2022 5:00,3,36,2882,22417,39,25299,THURSDAY,0,0,0.6,66,16.6,1022.9,Fair
12/15/2022 6:00,11,104,7178,75662,115,82840,THURSDAY,0,0,0.6,66,16.6,1022.9,Fair
12/15/2022 7:00,35,288,24570,204282,323,228852,THURSDAY,0,0,0.6,69,13,1023.8,Fair
12/15/2022 8:00,64,592,54475,431515,656,485990,THURSDAY,0,0,1.1,79,16.6,1024.4,Fair
12/15/2022 9:00,36,347,30670,243295,383,273965,THURSDAY,0,0,1.1,79,16.6,1024.4,Fair
12/15/2022 10:00,33,222,24515,144021,255,168536,THURSDAY,0,0,1.1,82,16.6,1024.9,Cloudy
12/15/2022 11:00,31,195,30223,127635,226,157858,THURSDAY,0,0,2.2,82,20.5,1024.2,Cloudy
12/15/2022 12:00,30,191,31210,121611,221,152821,THURSDAY,0,0,2.2,82,20.5,1024.2,Cloudy
12/15/2022 13:00,38,242,458531,150043,280,608574,THURSDAY,0,0,3.9,76,9.4,1025.5,Cloudy
12/15/2022 14:00,36,261,48538,363132,297,411670,THURSDAY,0,0,5.6,73,9.4,1025.6,Cloudy
12/15/2022 15:00,47,270,57923,202754,317,260677,THURSDAY,0,0,6.1,68,18.4,1025.7,Cloudy
12/15/2022 16:00,58,367,62421,263919,425,326340,THURSDAY,0,0,6.1,68,18.4,1025.7,Cloudy
12/15/2022 17:00,56,520,55655,397890,576,453545,THURSDAY,0,0,5.6,79,27.7,1024.8,Cloudy
12/15/2022 18:00,57,401,54644,291303,458,345947,THURSDAY,0,0,5,82,18.4,1023.8,Cloudy
12/15/2022 19:00,34,270,27485,178976,304,206461,THURSDAY,0,0,5.6,79,20.5,1023.6,Cloudy
12/15/2022 20:00,24,173,88250,127100,197,215350,THURSDAY,0,0,5.6,82,22.3,1023.9,Cloudy
12/15/2022 21:00,21,140,18241,105267,161,123508,THURSDAY,0,0,5.6,82,22.3,1023.9,Cloudy
12/15/2022 22:00,39,118,30139,94235,157,124374,THURSDAY,0,0,6.1,79,31.7,1023.4,Cloudy
12/15/2022 23:00,29,72,27474,43076,101,70550,THURSDAY,0,0,6.1,79,31.7,1023.4,Cloudy
12/16/2022 0:00,15,34,9353,19200,49,28553,FRIDAY,0,0,6.1,86,29.5,1022.5,Cloudy
12/16/2022 1:00,10,10,66922,6914,20,73836,FRIDAY,0,0,6.1,86,29.5,1022.5,Cloudy
12/16/2022 2:00,3,18,4347,11219,21,15566,FRIDAY,0,0,6.1,89,37.1,1020.6,Rain
12/16/2022 3:00,1,7,1535,6214,8,7749,FRIDAY,0,0,6.1,89,38.9,1021.4,Cloudy
12/16/2022 4:00,2,6,2833,6098,8,8931,FRIDAY,0,0,5.6,96,31.7,1019.7,Cloudy
12/16/2022 5:00,2,10,2117,5831,12,7948,FRIDAY,0,0,5.6,96,31.7,1018.9,Rain
12/16/2022 6:00,2,22,1893,15123,24,17016,FRIDAY,0,0,5.6,96,37.1,1018.5,Rain
12/16/2022 7:00,5,56,3065,59324,61,62389,FRIDAY,0,0,5.6,96,35.3,1018.5,Rain
12/16/2022 8:00,17,133,10221,101265,150,111486,FRIDAY,0,0,5.6,96,38.9,1016.4,Rain
12/16/2022 9:00,11,130,7138,80701,141,87839,FRIDAY,0,0,5.6,96,38.9,1016.4,Cloudy
12/16/2022 10:00,3,46,2042,25335,49,27377,FRIDAY,0,0,6.1,89,33.5,1015.2,Rain
12/16/2022 11:00,7,66,3552,47341,73,50893,FRIDAY,0,0,6.1,89,33.5,1015.2,Rain
12/16/2022 12:00,10,75,6689,45778,85,52467,FRIDAY,0,0,6.1,89,40.7,1013.7,Rain
12/16/2022 13:00,14,88,14907,69200,102,84107,FRIDAY,0,0,6.1,89,40.7,1012.6,Rain
12/16/2022 14:00,9,68,7815,46587,77,54402,FRIDAY,0,0,6.1,89,40.7,1012.6,Rain
12/16/2022 15:00,9,82,5921,53331,91,59252,FRIDAY,0,0,6.1,93,42.5,1009.6,Rain
12/16/2022 16:00,17,89,227533,64579,106,292112,FRIDAY,0,0,6.1,93,42.5,1009.6,Rain
12/16/2022 17:00,21,133,18713,87050,154,105763,FRIDAY,0,0,6.7,93,46.4,1006.8,Rain
12/16/2022 18:00,17,112,13514,76320,129,89834,FRIDAY,0,0,6.7,93,40.7,1005.9,Rain
12/16/2022 19:00,12,72,26977,179471,84,206448,FRIDAY,0,0,6.7,93,53.6,1005.9,Rain
12/16/2022 20:00,8,59,11029,36500,67,47529,FRIDAY,0,0,7.2,90,48.2,1004.5,Rain
12/16/2022 21:00,8,65,7928,41637,73,49565,FRIDAY,0,0,6.7,89,51.8,1004.5,Rain
12/16/2022 22:00,10,50,9319,34292,60,43611,FRIDAY,0,0,6.7,89,50,1003,Rain
12/16/2022 23:00,10,45,9500,36574,55,46074,FRIDAY,0,0,6.1,93,37.1,1003.3,Rain
12/17/2022 0:00,19,38,16420,26591,57,43011,SATURDAY,1,0,6.1,93,35.3,1002.4,Rain
12/17/2022 1:00,27,31,25329,19574,58,44903,SATURDAY,1,0,6.1,97,35.3,1001.5,Rain
12/17/2022 2:00,9,22,7685,11569,31,19254,SATURDAY,1,0,6.7,96,33.5,998.7,Rain
12/17/2022 3:00,3,8,3674,5182,11,8856,SATURDAY,1,0,6.7,96,40.7,997.5,Rain
12/17/2022 4:00,3,6,3513,5255,9,8768,SATURDAY,1,0,6.7,96,38.9,997.5,Rain
12/17/2022 5:00,4,2,6016,784,6,6800,SATURDAY,1,0,4.4,100,31.7,995.4,Rain
12/17/2022 6:00,1,13,370,10779,14,11149,SATURDAY,1,0,4.4,100,31.7,995.4,Rain
12/17/2022 7:00,0,26,0,17033,26,17033,SATURDAY,1,0,3.9,96,29.5,995.8,Rain
12/17/2022 8:00,7,62,5983,47699,69,53682,SATURDAY,1,0,2.8,96,29.5,996,Rain
12/17/2022 9:00,23,120,22621,86178,143,108799,SATURDAY,1,0,2.2,97,25.9,995.7,Rain
12/17/2022 10:00,42,225,43611,269052,267,312663,SATURDAY,1,0,1.7,96,25.9,997.1,Rain
12/17/2022 11:00,65,232,79219,158226,297,237445,SATURDAY,1,0,1.7,92,25.9,997.1,Rain
12/17/2022 12:00,52,266,55743,191122,318,246865,SATURDAY,1,0,2.2,92,29.5,998.9,Rain
12/17/2022 13:00,79,284,94628,218298,363,312926,SATURDAY,1,0,2.8,89,27.7,999.7,Rain
12/17/2022 14:00,96,319,113123,239560,415,352683,SATURDAY,1,0,2.8,89,27.7,999.7,Rain
12/17/2022 15:00,86,310,284372,234532,396,518904,SATURDAY,1,0,3.9,89,24.1,1000.4,Rain
12/17/2022 16:00,83,277,96883,206478,360,303361,SATURDAY,1,0,5,82,20.5,1000.2,Rain
12/17/2022 17:00,55,288,63998,200664,343,264662,SATURDAY,1,0,5,82,20.5,1000.2,Cloudy
12/17/2022 18:00,74,262,76491,175485,336,251976,SATURDAY,1,0,5.6,79,25.9,1000.3,Cloudy
12/17/2022 19:00,47,185,209132,124394,232,333526,SATURDAY,1,0,5.6,67,22.3,1001.7,Cloudy
12/17/2022 20:00,33,143,37013,99510,176,136523,SATURDAY,1,0,5.6,67,22.3,1002.5,Cloudy
12/17/2022 21:00,43,108,52122,70009,151,122131,SATURDAY,1,0,5.6,67,24.1,1002.5,Cloudy
12/17/2022 22:00,31,82,33254,52747,113,86001,SATURDAY,1,0,5,67,20.5,1003.5,Cloudy
12/17/2022 23:00,20,80,29487,50073,100,79560,SATURDAY,1,0,4.4,68,22.3,1004.8,Cloudy
12/18/2022 0:00,32,60,124819,44494,92,169313,SUNDAY,1,0,3.9,70,20.5,1005.5,Cloudy
12/18/2022 1:00,61,53,77489,152237,114,229726,SUNDAY,1,0,3.3,70,25.9,1005.9,Cloudy
12/18/2022 2:00,42,38,38523,30193,80,68716,SUNDAY,1,0,3.3,70,25.9,1005.9,Fair
12/18/2022 3:00,12,10,23718,7802,22,31520,SUNDAY,1,0,2.8,72,24.1,1006.3,Fair
12/18/2022 4:00,10,5,11109,5527,15,16636,SUNDAY,1,0,2.2,73,24.1,1006.5,Fair
12/18/2022 5:00,6,10,9097,1320902,16,1329999,SUNDAY,1,0,2.2,73,24.1,1006.5,Fair
12/18/2022 6:00,6,26,3657,16921,32,20578,SUNDAY,1,0,2.2,73,24.1,1006.7,Fair
12/18/2022 7:00,8,48,5984,27745,56,33729,SUNDAY,1,0,2.2,73,18.4,1008.3,Fair
12/18/2022 8:00,9,98,6030,67456,107,73486,SUNDAY,1,0,2.2,73,11.2,1008.3,Fair
12/18/2022 9:00,61,222,65785,160907,283,226692,SUNDAY,1,0,1.7,72,14.8,1008.4,Fair
12/18/2022 10:00,59,203,72635,137492,262,210127,SUNDAY,1,0,1.7,72,14.8,1008.4,Clear
12/18/2022 11:00,36,153,38505,113932,189,152437,SUNDAY,1,0,1.7,66,20.5,1008.5,Fair
12/18/2022 12:00,43,161,82164,126044,204,208208,SUNDAY,1,0,1.7,66,16.6,1009.2,Fair
12/18/2022 13:00,76,344,102861,255674,420,358535,SUNDAY,1,0,2.2,64,20.5,1009.7,Fair
12/18/2022 14:00,88,268,114582,212226,356,326808,SUNDAY,1,0,2.8,61,16.6,1009.9,Fair
12/18/2022 15:00,62,275,108395,198905,337,307300,SUNDAY,1,0,2.8,61,16.6,1009.9,Fair
12/18/2022 16:00,53,269,378668,204962,322,583630,SUNDAY,1,0,3.9,55,16.6,1008.6,Cloudy
12/18/2022 17:00,51,195,83181,128018,246,211199,SUNDAY,1,0,5,53,18.4,1008.4,Cloudy
12/18/2022 18:00,32,171,33654,117629,203,151283,SUNDAY,1,0,5,53,18.4,1008.4,Cloudy
12/18/2022 19:00,22,102,28803,112424,124,141227,SUNDAY,1,0,4.4,51,24.1,1009.3,Cloudy
12/18/2022 20:00,24,106,45447,71353,130,116800,SUNDAY,1,0,4.4,51,24.1,1009.3,Cloudy
12/18/2022 21:00,14,84,17694,56612,98,74306,SUNDAY,1,0,3.3,52,22.3,1010.9,Cloudy
12/18/2022 22:00,30,68,54141,40288,98,94429,SUNDAY,1,0,3.3,52,22.3,1010.9,Fair
12/18/2022 23:00,10,28,10230,19789,38,30019,SUNDAY,1,0,1.7,58,20.5,1012.3,Fair
12/19/2022 0:00,6,34,5093,22022,40,27115,MONDAY,0,0,1.1,61,18.4,1012.5,Fair
12/19/2022 1:00,7,14,15995,7874,21,23869,MONDAY,0,0,1.1,61,18.4,1012.5,Fair
12/19/2022 2:00,3,6,4435,29416,9,33851,MONDAY,0,0,1.1,64,22.3,1012.7,Fair
12/19/2022 3:00,1,2,2093,2248,3,4341,MONDAY,0,0,0.6,63,24.1,1013.5,Fair
12/19/2022 4:00,0,6,0,6034,6,6034,MONDAY,0,0,0.6,63,22.3,1013.5,Fair
12/19/2022 5:00,0,35,0,22444,35,22444,MONDAY,0,0,0.6,61,24.1,1013.9,Clear
12/19/2022 6:00,12,103,18024,55604,115,73628,MONDAY,0,0,0.6,61,24.1,1013.9,Clear
12/19/2022 7:00,16,194,20271,138079,210,158350,MONDAY,0,0,0,66,20.5,1015,Clear
12/19/2022 8:00,39,416,46173,299842,455,346015,MONDAY,0,0,0,66,20.5,1015.4,Clear
12/19/2022 9:00,26,260,19329,173283,286,192612,MONDAY,0,0,0,64,20.5,1015.7,Clear
12/19/2022 10:00,30,179,35385,120158,209,155543,MONDAY,0,0,0,64,25.9,1015.7,Clear
12/19/2022 11:00,27,184,35678,128781,211,164459,MONDAY,0,0,-0.6,69,20.5,1016.6,Fair
12/19/2022 12:00,35,226,35492,153447,261,188939,MONDAY,0,0,0,69,18.4,1016.8,Fair
12/19/2022 13:00,36,196,133827,126068,232,259895,MONDAY,0,0,1.1,67,20.5,1016.9,Fair
12/19/2022 14:00,37,209,47487,136201,246,183688,MONDAY,0,0,3.3,57,24.1,1017.4,Fair
12/19/2022 15:00,53,256,61829,170740,309,232569,MONDAY,0,0,4.4,51,24.1,1016.9,Fair
12/19/2022 16:00,58,347,1470316,251096,405,1721412,MONDAY,0,0,4.4,51,29.5,1016.9,Fair
12/19/2022 17:00,40,446,1664995,322387,486,1987382,MONDAY,0,0,5.6,43,27.7,1016.5,Fair
12/19/2022 18:00,46,360,61883,256308,406,318191,MONDAY,0,0,4.4,46,27.7,1017.1,Fair
12/19/2022 19:00,26,246,23339,147222,272,170561,MONDAY,0,0,4.4,48,22.3,1017.8,Fair
12/19/2022 20:00,22,156,24714,103726,178,128440,MONDAY,0,0,4.4,48,22.3,1017.8,Fair
12/19/2022 21:00,17,99,28868,64880,116,93748,MONDAY,0,0,2.8,54,22.3,1018.6,Fair
12/19/2022 22:00,12,86,7966,50483,98,58449,MONDAY,0,0,2.2,56,25.9,1018.9,Fair
12/19/2022 23:00,12,41,10622,24984,53,35606,MONDAY,0,0,2.2,56,25.9,1018.9,Fair
12/20/2022 0:00,5,24,7235,13302,29,20537,TUESDAY,0,0,2.2,59,20.5,1019.2,Fair
12/20/2022 1:00,1,13,1275,8266,14,9541,TUESDAY,0,0,1.1,64,22.3,1019.8,Fair
12/20/2022 2:00,2,5,10058,2795,7,12853,TUESDAY,0,0,1.1,64,22.3,1019.8,Fair
12/20/2022 3:00,1,4,1196,2023,5,3219,TUESDAY,0,0,0.6,56,25.9,1021.2,Fair
12/20/2022 4:00,2,8,2618,6051,10,8669,TUESDAY,0,0,0.6,56,22.3,1021.6,Fair
12/20/2022 5:00,1,28,1240,16405,29,17645,TUESDAY,0,0,0.6,56,22.3,1021.6,Fair
12/20/2022 6:00,5,111,3364,61356,116,64720,TUESDAY,0,0,0,58,27.7,1022.5,Fair
12/20/2022 7:00,19,231,39534,164980,250,204514,TUESDAY,0,0,0,58,27.7,1022.6,Fair
12/20/2022 8:00,36,433,37655,316421,469,354076,TUESDAY,0,0,-0.6,63,25.9,1022.7,Fair
12/20/2022 9:00,28,247,22177,172016,275,194193,TUESDAY,0,0,-0.6,63,25.9,1022.7,Fair
12/20/2022 10:00,22,173,20832,125072,195,145904,TUESDAY,0,0,-0.6,61,22.3,1024.5,Fair
12/20/2022 11:00,31,211,594517,154746,242,749263,TUESDAY,0,0,-0.6,61,24.1,1024.9,Fair
12/20/2022 12:00,29,209,80821,142863,238,223684,TUESDAY,0,0,-0.6,61,24.1,1024.9,Fair
12/20/2022 13:00,46,230,84451,166913,276,251364,TUESDAY,0,0,-0.6,61,24.1,1025.7,Fair
12/20/2022 14:00,59,223,280098,171315,282,451413,TUESDAY,0,0,0.6,58,22.3,1026.3,Fair
12/20/2022 15:00,47,278,51331,216050,325,267381,TUESDAY,0,0,2.8,52,24.1,1026.5,Fair
12/20/2022 16:00,48,352,56162,1963573,400,2019735,TUESDAY,0,0,3.9,50,16.6,1026.1,Rain
12/20/2022 17:00,61,415,56943,316855,476,373798,TUESDAY,0,0,3.9,50,16.6,1026.1,Fair
12/20/2022 18:00,35,343,899284,245510,378,1144794,TUESDAY,0,0,4.4,48,13,1025.6,Fair
12/20/2022 19:00,30,203,29086,135197,233,164283,TUESDAY,0,0,4.4,48,16.6,1026.4,Fair
12/20/2022 20:00,22,138,23800,96812,160,120612,TUESDAY,0,0,3.3,52,16.6,1027,Fair
12/20/2022 21:00,22,93,33790,65657,115,99447,TUESDAY,0,0,3.3,52,16.6,1027,Fair
12/20/2022 22:00,21,67,18008,45117,88,63125,TUESDAY,0,0,2.8,54,16.6,1027.5,Fair
12/20/2022 23:00,12,44,12848,25430,56,38278,TUESDAY,0,0,1.7,58,20.5,1028.2,Fair
12/21/2022 0:00,4,22,11586,16840,26,28426,WEDNESDAY,0,0,0.6,61,14.8,1029.1,Fair
12/21/2022 1:00,4,13,9059,14037,17,23096,WEDNESDAY,0,0,0,64,14.8,1029.3,Fair
12/21/2022 2:00,4,12,4857,6715,16,11572,WEDNESDAY,0,0,0,64,14.8,1029.3,Fair
12/21/2022 3:00,4,7,13197,6877,11,20074,WEDNESDAY,0,0,-1.1,69,14.8,1029.7,Fair
12/21/2022 4:00,5,10,6612,10371,15,16983,WEDNESDAY,0,0,-1.1,69,16.6,1029.7,Fair
12/21/2022 5:00,1,23,413,16546,24,16959,WEDNESDAY,0,0,-1.7,72,14.8,1029.5,Clear
12/21/2022 6:00,7,73,8102,42037,80,50139,WEDNESDAY,0,0,-1.7,72,14.8,1029.5,Clear
12/21/2022 7:00,15,166,12529,109908,181,122437,WEDNESDAY,0,0,-2.2,75,14.8,1030.2,Fair
12/21/2022 8:00,29,378,26592,281475,407,308067,WEDNESDAY,0,0,-2.2,75,13,1030.3,Fair
12/21/2022 9:00,26,226,23520,140219,252,163739,WEDNESDAY,0,0,-2.2,75,13,1030.7,Fair
12/21/2022 10:00,21,221,19390,150695,242,170085,WEDNESDAY,0,0,-2.2,75,11.2,1030.9,Fair
12/21/2022 11:00,33,186,54443,119909,219,174352,WEDNESDAY,0,0,-2.2,75,11.2,1030.9,Fair
12/21/2022 12:00,44,231,52533,153014,275,205547,WEDNESDAY,0,0,-2.2,75,11.2,1031.4,Cloudy
12/21/2022 13:00,42,216,69987,139107,258,209094,WEDNESDAY,0,0,-1.1,69,7.6,1032,Cloudy
12/21/2022 14:00,41,203,50063,149124,244,199187,WEDNESDAY,0,0,0,66,5.4,1032.4,Cloudy
12/21/2022 15:00,62,273,578016,203563,335,781579,WEDNESDAY,0,0,1.7,58,5.4,1032.1,Cloudy
12/21/2022 16:00,64,317,215961,246134,381,462095,WEDNESDAY,0,0,1.7,58,5.4,1032.1,Cloudy
12/21/2022 17:00,39,385,40673,282978,424,323651,WEDNESDAY,0,0,2.8,57,5.4,1031.6,Cloudy
12/21/2022 18:00,48,283,1327876,196490,331,1524366,WEDNESDAY,0,0,3.9,55,7.6,1031.1,Cloudy
12/21/2022 19:00,28,176,30101,171871,204,201972,WEDNESDAY,0,0,3.9,52,13,1031.5,Fair
12/21/2022 20:00,20,150,21306,99428,170,120734,WEDNESDAY,0,0,3.3,52,7.6,1031.6,Fair
12/21/2022 21:00,20,90,16947,68574,110,85521,WEDNESDAY,0,0,3.3,52,7.6,1031.6,Fair
12/21/2022 22:00,21,54,23896,42490,75,66386,WEDNESDAY,0,0,1.7,61,7.6,1032,Fair
12/21/2022 23:00,9,45,8713,33935,54,42648,WEDNESDAY,0,0,1.1,67,9.4,1032.4,Fair
12/22/2022 0:00,6,28,5993,17875,34,23868,THURSDAY,0,0,1.7,61,9.4,1032.4,Fair
12/22/2022 1:00,2,13,2750,8512,15,11262,THURSDAY,0,0,1.7,61,9.4,1032.4,Fair
12/22/2022 2:00,2,7,597,4116,9,4713,THURSDAY,0,0,0.6,69,9.4,1032.4,Fair
12/22/2022 3:00,3,7,2621,6671,10,9292,THURSDAY,0,0,-0.6,76,11.2,1032.7,Fair
12/22/2022 4:00,0,4,0,4166,4,4166,THURSDAY,0,0,0.6,69,14.8,1032.7,Cloudy
12/22/2022 5:00,5,27,8121,15377,32,23498,THURSDAY,0,0,0.6,69,14.8,1032.7,Cloudy
12/22/2022 6:00,1,71,654,44079,72,44733,THURSDAY,0,0,0.6,66,11.2,1032.8,Cloudy
12/22/2022 7:00,14,152,14268,104260,166,118528,THURSDAY,0,0,-1.7,78,7.6,1033.6,Cloudy
12/22/2022 8:00,19,268,14582,194284,287,208866,THURSDAY,0,0,-2.2,78,5.4,1033.7,Cloudy
12/22/2022 9:00,29,203,33775,137307,232,171082,THURSDAY,0,0,-2.2,78,5.4,1034,Cloudy
12/22/2022 10:00,26,163,35529,115969,189,151498,THURSDAY,0,0,-2.2,78,5.4,1034,Cloudy
12/22/2022 11:00,39,182,83556,125835,221,209391,THURSDAY,0,0,-1.1,72,0,1033.5,Cloudy
12/22/2022 12:00,39,221,62205,154882,260,217087,THURSDAY,0,0,-0.6,72,11.2,1033.7,Cloudy
12/22/2022 13:00,39,224,35943,145889,263,181832,THURSDAY,0,0,0.6,69,9.4,1033.9,Cloudy
12/22/2022 14:00,66,231,72727,176463,297,249190,THURSDAY,0,0,0.6,69,9.4,1033.9,Cloudy
12/22/2022 15:00,54,266,46207,195046,320,241253,THURSDAY,0,0,2.2,73,9.4,1033.7,Cloudy
12/22/2022 16:00,42,308,887539,218522,350,1106061,THURSDAY,0,0,5,67,5.4,1031.4,Cloudy
12/22/2022 17:00,38,280,48488,215901,318,264389,THURSDAY,0,0,5,67,5.4,1031.4,Cloudy
12/22/2022 18:00,22,125,39006,84644,147,123650,THURSDAY,0,0,5.6,73,14.8,1029.8,Cloudy
12/22/2022 19:00,11,94,8688,65122,105,73810,THURSDAY,0,0,5.6,76,18.4,1029.7,Cloudy
12/22/2022 20:00,3,46,3637,86964,49,90601,THURSDAY,0,0,5.6,76,18.4,1029.7,Cloudy
12/22/2022 21:00,14,35,12271,19983,49,32254,THURSDAY,0,0,6.1,76,22.3,1028.7,Cloudy
12/22/2022 22:00,10,29,5012,14104,39,19116,THURSDAY,0,0,6.1,76,22.3,1028.7,Cloudy
12/22/2022 23:00,3,23,3470,15879,26,19349,THURSDAY,0,0,6.1,89,31.7,1026.6,Rain
12/23/2022 0:00,1,3,547,2049,4,2596,FRIDAY,0,0,6.1,89,31.7,1026.6,Rain
12/23/2022 1:00,2,2,653,528,4,1181,FRIDAY,0,0,6.7,89,35.3,1024.8,Rain
12/23/2022 2:00,0,5,0,1501,5,1501,FRIDAY,0,0,6.7,89,31.7,1023.4,Rain
12/23/2022 3:00,0,2,0,2776,2,2776,FRIDAY,0,0,7.2,93,31.7,1022.4,Rain
12/23/2022 4:00,0,2,0,1030,2,1030,FRIDAY,0,0,7.2,93,48.2,1019.6,Cloudy
12/23/2022 5:00,0,11,0,6849,11,6849,FRIDAY,0,0,7.2,97,50,1016.8,Rain
12/23/2022 6:00,4,18,2515,11749,22,14264,FRIDAY,0,0,7.8,96,42.5,1014.3,Rain
12/23/2022 7:00,1,18,1719,7853,19,9572,FRIDAY,0,0,8.3,100,48.2,1008.6,Rain
12/23/2022 8:00,0,35,0,21612,35,21612,FRIDAY,0,0,8.3,100,55.4,1008.6,Rain
12/23/2022 9:00,3,48,7795,34174,51,41969,FRIDAY,0,0,10,96,42.5,1004,Rain
12/23/2022 10:00,14,74,14953,49903,88,64856,FRIDAY,0,0,10,96,53.6,1004,Rain
12/23/2022 11:00,21,85,42904,53528,106,96432,FRIDAY,0,0,10,96,46.4,998.5,Rain
12/23/2022 12:00,10,77,14852,37781,87,52633,FRIDAY,0,0,10,96,46.4,998.5,Rain
12/23/2022 13:00,8,60,19135,40230,68,59365,FRIDAY,0,0,11.1,100,61.2,996.8,Cloudy
12/23/2022 14:00,6,44,7646,42049,50,49695,FRIDAY,0,0,11.7,96,50,995.2,Rain
12/23/2022 15:00,4,78,4812,47500,82,52312,FRIDAY,0,0,12.2,97,46.4,993.4,Cloudy
12/23/2022 16:00,8,100,408789,71869,108,480658,FRIDAY,0,0,13.9,90,35.3,987.8,Rain
12/23/2022 17:00,10,139,14728,102010,149,116738,FRIDAY,0,0,12.2,90,35.3,985.2,Rain
12/23/2022 18:00,17,88,1392667,64482,105,1457149,FRIDAY,0,0,12.2,90,44.6,985.2,Rain
12/23/2022 19:00,10,65,8295,44331,75,52626,FRIDAY,0,0,12.8,89,66.6,982.8,Rain
12/23/2022 20:00,4,33,6881,19853,37,26734,FRIDAY,0,0,9.4,90,27.7,981.3,Rain
12/23/2022 21:00,5,28,3810,692547,33,696357,FRIDAY,0,0,9.4,90,35.3,981.3,Rain
12/23/2022 22:00,3,17,2064,14419,20,16483,FRIDAY,0,0,8.3,71,51.8,981.3,Rain
12/23/2022 23:00,2,17,759,9744,19,10503,FRIDAY,0,0,2.8,76,38.9,983.4,Cloudy
12/24/2022 0:00,5,13,4704,7796,18,12500,SATURDAY,1,0,2.8,57,57.6,983.4,Cloudy
12/24/2022 1:00,3,9,6433,5028,12,11461,SATURDAY,1,0,-0.6,61,55.4,986,Cloudy
12/24/2022 2:00,2,1,7589,301,3,7890,SATURDAY,1,0,-2.8,60,40.7,990.3,Fair
12/24/2022 3:00,2,0,1833,0,2,1833,SATURDAY,1,0,-5,57,40.7,992.9,Fair
12/24/2022 4:00,1,2,2769,1460,3,4229,SATURDAY,1,0,-5,57,38.9,992.9,Fair
12/24/2022 5:00,0,7,0,5172,7,5172,SATURDAY,1,0,-7.2,56,48.2,994.7,Fair
12/24/2022 6:00,0,8,0,3891,8,3891,SATURDAY,1,0,-7.8,59,40.7,995.9,Fair
12/24/2022 7:00,0,16,0,8606,16,8606,SATURDAY,1,0,-8.9,56,29.5,997.7,Fair
12/24/2022 8:00,1,17,280623,9662,18,290285,SATURDAY,1,0,-10.6,58,37.1,999.8,Clear
12/24/2022 9:00,5,41,1743,24272,46,26015,SATURDAY,1,0,-10.6,58,38.9,999.8,Clear
12/24/2022 10:00,8,53,34569,30482,61,65051,SATURDAY,1,0,-11.1,55,24.1,1000.6,Clear
12/24/2022 11:00,13,74,20700,48644,87,69344,SATURDAY,1,0,-11.7,55,27.7,1002.8,Fair
12/24/2022 12:00,9,70,9529,41444,79,50973,SATURDAY,1,0,-11.7,55,27.7,1003.7,Fair
12/24/2022 13:00,4,98,2919,69183,102,72102,SATURDAY,1,0,-11.7,55,25.9,1003.7,Fair
12/24/2022 14:00,10,97,13373,56038,107,69411,SATURDAY,1,0,-11.1,53,31.7,1004.5,Fair
12/24/2022 15:00,17,68,19370,41371,85,60741,SATURDAY,1,0,-8.3,44,29.5,1004.7,Fair
12/24/2022 16:00,5,84,2522,58855,89,61377,SATURDAY,1,0,-8.3,44,24.1,1003.9,Fair
12/24/2022 17:00,7,57,5616,33859,64,39475,SATURDAY,1,0,-7.8,43,33.5,1003.5,Fair
12/24/2022 18:00,2,52,3002,37744,54,40746,SATURDAY,1,0,-7.8,43,33.5,1003.5,Fair
12/24/2022 19:00,2,19,1652,11310,21,12962,SATURDAY,1,0,-7.2,43,22.3,1003.9,Fair
12/24/2022 20:00,4,9,3429,4434,13,7863,SATURDAY,1,0,-7.8,45,31.7,1004.4,Fair
12/24/2022 21:00,1,8,550,5502,9,6052,SATURDAY,1,0,-8.3,44,24.1,1005.2,Fair
12/24/2022 22:00,5,9,5407,5785,14,11192,SATURDAY,1,0,-8.3,46,24.1,1005.9,Fair
12/24/2022 23:00,1,14,1718,16420,15,18138,SATURDAY,1,0,-8.3,46,29.5,1005.9,Fair
12/25/2022 0:00,1,7,1291,4006,8,5297,SUNDAY,1,1,-8.9,47,29.5,1006.9,Fair
12/25/2022 1:00,2,2,3693,826,4,4519,SUNDAY,1,1,-9.4,51,24.1,1007.4,Clear
12/25/2022 2:00,1,4,1689,3142,5,4831,SUNDAY,1,1,-10,53,24.1,1007.8,Clear
12/25/2022 3:00,0,3,0,2545,3,2545,SUNDAY,1,1,-10,53,37.1,1007.8,Fair
12/25/2022 4:00,0,1,0,1106,1,1106,SUNDAY,1,1,-10,51,27.7,1008,Clear
12/25/2022 5:00,0,4,0,4954,4,4954,SUNDAY,1,1,-10,53,31.7,1008,Clear
12/25/2022 6:00,1,8,226,4511,9,4737,SUNDAY,1,1,-10,53,27.7,1008,Clear
12/25/2022 7:00,1,6,1600,2401,7,4001,SUNDAY,1,1,-10,53,25.9,1008.2,Clear
12/25/2022 8:00,1,9,318,9612,10,9930,SUNDAY,1,1,-10,53,25.9,1008.2,Clear
12/25/2022 9:00,4,13,3015,6383,17,9398,SUNDAY,1,1,-10,56,25.9,1008,Clear
12/25/2022 10:00,4,29,3164,23149,33,26313,SUNDAY,1,1,-10,53,35.3,1008.2,Clear
12/25/2022 11:00,14,37,25360,35829,51,61189,SUNDAY,1,1,-10,56,29.5,1009.2,Fair
12/25/2022 12:00,12,40,31733,21809,52,53542,SUNDAY,1,1,-10,56,25.9,1009.2,Fair
12/25/2022 13:00,17,40,28943,30202,57,59145,SUNDAY,1,1,-8.3,51,31.7,1010.1,Fair
12/25/2022 14:00,23,47,67093,33868,70,100961,SUNDAY,1,1,-8.3,51,29.5,1010.1,Fair
12/25/2022 15:00,13,49,24719,35259,62,59978,SUNDAY,1,1,-5.6,45,24.1,1009.8,Fair
12/25/2022 16:00,4,46,7295,34212,50,41507,SUNDAY,1,1,-4.4,43,22.3,1009.2,Fair
12/25/2022 17:00,3,22,13124,14742,25,27866,SUNDAY,1,1,-3.3,42,22.3,1008.8,Fair
12/25/2022 18:00,4,31,3792,24347,35,28139,SUNDAY,1,1,-3.3,42,25.9,1008.8,Fair
12/25/2022 19:00,4,34,8383,29711,38,38094,SUNDAY,1,1,-3.3,44,20.5,1009.6,Fair
12/25/2022 20:00,6,27,9000,17845,33,26845,SUNDAY,1,1,-3.3,42,27.7,1010.4,Fair
12/25/2022 21:00,0,22,0,17856,22,17856,SUNDAY,1,1,-3.9,46,22.3,1011,Fair
12/25/2022 22:00,3,13,6254,8969,16,15223,SUNDAY,1,1,-3.9,46,22.3,1011,Fair
12/25/2022 23:00,7,6,6419,9819,13,16238,SUNDAY,1,1,-4.4,48,16.6,1011.8,Fair
12/26/2022 0:00,1,2,503,482,3,985,MONDAY,0,1,-5,52,18.4,1013.1,Fair
12/26/2022 1:00,1,6,318,7272,7,7590,MONDAY,0,1,-4.4,50,22.3,1013.2,Fair
12/26/2022 2:00,1,1,1063,335,2,1398,MONDAY,0,1,-4.4,50,22.3,1013.2,Fair
12/26/2022 3:00,1,0,1090,0,1,1090,MONDAY,0,1,-4.4,50,22.3,1013.5,Fair
12/26/2022 4:00,0,1,0,782,1,782,MONDAY,0,1,-4.4,52,16.6,1013.5,Clear
12/26/2022 5:00,0,7,0,6681,7,6681,MONDAY,0,1,-5.6,57,16.6,1013.9,Clear
12/26/2022 6:00,2,14,8764,12914,16,21678,MONDAY,0,1,-5.6,57,22.3,1014.6,Clear
12/26/2022 7:00,4,22,10047,12187,26,22234,MONDAY,0,1,-5.6,55,20.5,1015.3,Clear
12/26/2022 8:00,2,27,3672,18065,29,21737,MONDAY,0,1,-5.6,55,20.5,1015.8,Clear
12/26/2022 9:00,5,58,6899,61010,63,67909,MONDAY,0,1,-5.6,55,20.5,1015.8,Clear
12/26/2022 10:00,10,72,21728,57515,82,79243,MONDAY,0,1,-5.6,57,22.3,1017.6,Clear
12/26/2022 11:00,16,99,15280,75230,115,90510,MONDAY,0,1,-5.6,57,24.1,1018.9,Fair
12/26/2022 12:00,20,108,29017,64488,128,93505,MONDAY,0,1,-5.6,57,22.3,1019.9,Fair
12/26/2022 13:00,17,92,124040,61737,109,185777,MONDAY,0,1,-5.6,57,22.3,1019.9,Fair
12/26/2022 14:00,29,105,33693,83217,134,116910,MONDAY,0,1,-2.8,48,22.3,1020.9,Fair
12/26/2022 15:00,28,121,27886,78656,149,106542,MONDAY,0,1,-1.7,46,22.3,1021.1,Fair
12/26/2022 16:00,20,86,29017,60337,106,89354,MONDAY,0,1,-1.1,44,16.6,1020.9,Fair
12/26/2022 17:00,19,99,12907,64242,118,77149,MONDAY,0,1,0,41,16.6,1020.7,Fair
12/26/2022 18:00,16,70,27211,48843,86,76054,MONDAY,0,1,0,41,16.6,1020.7,Fair
12/26/2022 19:00,18,70,99410,51797,88,151207,MONDAY,0,1,0.6,36,18.4,1020.6,Fair
12/26/2022 20:00,8,42,5787,27300,50,33087,MONDAY,0,1,0.6,36,18.4,1020.6,Cloudy
12/26/2022 21:00,6,39,3597,30620,45,34217,MONDAY,0,1,0,38,16.6,1021.1,Cloudy
12/26/2022 22:00,9,27,14992,15364,36,30356,MONDAY,0,1,-0.6,41,14.8,1021.4,Cloudy
12/26/2022 23:00,5,20,2732,11504,25,14236,MONDAY,0,1,-0.6,41,13,1021.9,Cloudy
12/27/2022 0:00,7,9,6631,5386,16,12017,TUESDAY,0,0,0,41,11.2,1022.1,Cloudy
12/27/2022 1:00,1,6,1198,5548,7,6746,TUESDAY,0,0,-0.6,43,18.4,1022.7,Cloudy
12/27/2022 2:00,1,6,1589,3449,7,5038,TUESDAY,0,0,-1.1,43,18.4,1022.5,Cloudy
12/27/2022 3:00,0,5,0,5004,5,5004,TUESDAY,0,0,-1.1,43,18.4,1022.5,Cloudy
12/27/2022 4:00,1,4,1050,3975,5,5025,TUESDAY,0,0,-1.7,46,16.6,1022.1,Cloudy
12/27/2022 5:00,1,11,1279,6698,12,7977,TUESDAY,0,0,-1.7,49,11.2,1021.5,Cloudy
12/27/2022 6:00,2,48,1420,27457,50,28877,TUESDAY,0,0,-2.2,53,16.6,1021.9,Cloudy
12/27/2022 7:00,7,66,5909,35926,73,41835,TUESDAY,0,0,-2.2,53,14.8,1021.9,Cloudy
12/27/2022 8:00,1,97,750,75452,98,76202,TUESDAY,0,0,-2.2,53,14.8,1021.9,Cloudy
12/27/2022 9:00,15,95,36453,63586,110,100039,TUESDAY,0,0,-2.2,51,18.4,1021.8,Cloudy
12/27/2022 10:00,19,106,28796,75770,125,104566,TUESDAY,0,0,-2.2,51,18.4,1022.1,Cloudy
12/27/2022 11:00,24,106,57790,83039,130,140829,TUESDAY,0,0,-2.2,51,22.3,1022.7,Cloudy
12/27/2022 12:00,23,128,33112,87154,151,120266,TUESDAY,0,0,-2.2,51,25.9,1023.1,Cloudy
12/27/2022 13:00,33,122,43042,81452,155,124494,TUESDAY,0,0,-2.2,51,25.9,1023.1,Cloudy
12/27/2022 14:00,46,134,91955,111905,180,203860,TUESDAY,0,0,-0.6,47,20.5,1023.2,Cloudy
12/27/2022 15:00,34,144,53256,96270,178,149526,TUESDAY,0,0,-0.6,47,20.5,1023.1,Fair
12/27/2022 16:00,29,144,28863,93393,173,122256,TUESDAY,0,0,1.1,41,16.6,1022.3,Fair
12/27/2022 17:00,26,153,36095,104337,179,140432,TUESDAY,0,0,1.1,41,16.6,1022.3,Fair
12/27/2022 18:00,20,135,25921,88607,155,114528,TUESDAY,0,0,1.1,41,14.8,1021.8,Fair
12/27/2022 19:00,8,90,15134,60201,98,75335,TUESDAY,0,0,1.7,40,18.4,1021.6,Fair
12/27/2022 20:00,13,51,21657,32737,64,54394,TUESDAY,0,0,1.7,40,14.8,1022.3,Fair
12/27/2022 21:00,11,36,16988,64968,47,81956,TUESDAY,0,0,1.1,41,20.5,1023,Fair
12/27/2022 22:00,14,32,26733,19392,46,46125,TUESDAY,0,0,0.6,45,16.6,1023.5,Fair
12/27/2022 23:00,12,26,8677,16945,38,25622,TUESDAY,0,0,0,49,9.4,1024.3,Fair
12/28/2022 0:00,2,11,736,6621,13,7357,WEDNESDAY,0,0,-0.6,49,9.4,1026,Fair
12/28/2022 1:00,1,4,690,3411,5,4101,WEDNESDAY,0,0,-0.6,49,13,1026.1,Fair
12/28/2022 2:00,0,1,0,156,1,156,WEDNESDAY,0,0,-1.1,51,14.8,1026.2,Fair
12/28/2022 3:00,0,6,0,5825,6,5825,WEDNESDAY,0,0,-1.1,51,14.8,1026.2,Fair
12/28/2022 4:00,2,7,1782,6050,9,7832,WEDNESDAY,0,0,-2.2,58,11.2,1025.8,Clear
12/28/2022 5:00,1,19,923,10432,20,11355,WEDNESDAY,0,0,-2.2,58,5.4,1026.3,Clear
12/28/2022 6:00,4,49,2200,27183,53,29383,WEDNESDAY,0,0,-3.3,65,0,1026.8,Fair
12/28/2022 7:00,7,78,7256,52020,85,59276,WEDNESDAY,0,0,-3.9,74,13,1026.9,Fair
12/28/2022 8:00,7,99,5696,66211,106,71907,WEDNESDAY,0,0,-3.9,74,13,1026.9,Fair
12/28/2022 9:00,16,101,157335,73283,117,230618,WEDNESDAY,0,0,-3.3,74,0,1026.3,Fair
12/28/2022 10:00,18,102,33686,77167,120,110853,WEDNESDAY,0,0,-2.2,63,11.2,1026.5,Fair
12/28/2022 11:00,19,129,22313,91872,148,114185,WEDNESDAY,0,0,-3.3,68,13,1026.4,Cloudy
12/28/2022 12:00,33,135,162160,92502,168,254662,WEDNESDAY,0,0,-3.3,68,13,1026.4,Cloudy
12/28/2022 13:00,30,134,62265,96976,164,159241,WEDNESDAY,0,0,-1.7,63,9.4,1026.9,Cloudy
12/28/2022 14:00,37,133,71580,98381,170,169961,WEDNESDAY,0,0,-0.6,63,9.4,1027.1,Cloudy
12/28/2022 15:00,50,163,74020,119825,213,193845,WEDNESDAY,0,0,-0.6,63,9.4,1027.1,Cloudy
12/28/2022 16:00,58,157,97334,112901,215,210235,WEDNESDAY,0,0,2.8,59,18.4,1024.6,Cloudy
12/28/2022 17:00,37,183,107553,156175,220,263728,WEDNESDAY,0,0,2.8,59,18.4,1024.6,Cloudy
12/28/2022 18:00,29,151,41268,111060,180,152328,WEDNESDAY,0,0,6.1,49,20.5,1023.5,Cloudy
12/28/2022 19:00,20,105,22924,71007,125,93931,WEDNESDAY,0,0,5.6,53,24.1,1023.1,Cloudy
12/28/2022 20:00,16,68,33811,52405,84,86216,WEDNESDAY,0,0,5.6,53,24.1,1023.3,Cloudy
12/28/2022 21:00,20,43,36462,30323,63,66785,WEDNESDAY,0,0,5.6,55,14.8,1023.6,Cloudy
12/28/2022 22:00,5,35,4512,25437,40,29949,WEDNESDAY,0,0,5,55,13,1024,Cloudy
12/28/2022 23:00,6,29,3618,22493,35,26111,WEDNESDAY,0,0,5,55,13,1024,Cloudy
12/29/2022 0:00,8,18,11448,10133,26,21581,THURSDAY,0,0,5,55,14.8,1024.4,Cloudy
12/29/2022 1:00,14,10,63396,5071,24,68467,THURSDAY,0,0,4.4,60,18.4,1024.4,Cloudy
12/29/2022 2:00,4,7,7039,4573,11,11612,THURSDAY,0,0,4.4,60,18.4,1024.4,Cloudy
12/29/2022 3:00,0,3,0,4468,3,4468,THURSDAY,0,0,3.3,67,13,1024.6,Cloudy
12/29/2022 4:00,1,3,1478,3338,4,4816,THURSDAY,0,0,2.8,70,13,1024.5,Cloudy
12/29/2022 5:00,5,17,6211,13792,22,20003,THURSDAY,0,0,2.8,70,13,1024.6,Cloudy
12/29/2022 6:00,4,48,2086,27973,52,30059,THURSDAY,0,0,1.7,75,13,1024.9,Fair
12/29/2022 7:00,10,77,8206,61040,87,69246,THURSDAY,0,0,1.7,75,13,1024.9,Fair
12/29/2022 8:00,15,117,20862,88408,132,109270,THURSDAY,0,0,1.7,75,14.8,1024.6,Fair
12/29/2022 9:00,23,95,135557,71546,118,207103,THURSDAY,0,0,1.7,72,9.4,1025.6,Fair
12/29/2022 10:00,40,141,58405,104814,181,163219,THURSDAY,0,0,1.1,79,11.2,1025.1,Clear
12/29/2022 11:00,40,145,48266,120678,185,168944,THURSDAY,0,0,1.7,78,5.4,1025.5,Fair
12/29/2022 12:00,69,180,343268,139000,249,482268,THURSDAY,0,0,1.7,78,5.4,1025.5,Cloudy
12/29/2022 13:00,72,189,125904,150631,261,276535,THURSDAY,0,0,2.2,75,11.2,1026.6,Cloudy
12/29/2022 14:00,134,175,314950,139164,309,454114,THURSDAY,0,0,2.8,72,9.4,1026.5,Cloudy
12/29/2022 15:00,114,195,332246,177449,309,509695,THURSDAY,0,0,2.8,72,9.4,1026.5,Cloudy
12/29/2022 16:00,92,221,133621,190074,313,323695,THURSDAY,0,0,8.3,49,11.2,1024.7,Cloudy
12/29/2022 17:00,47,226,123397,194136,273,317533,THURSDAY,0,0,8.3,49,11.2,1024.7,Cloudy
12/29/2022 18:00,47,202,63765,156253,249,220018,THURSDAY,0,0,12.2,37,14.8,1023,Cloudy
12/29/2022 19:00,35,132,184498,87561,167,272059,THURSDAY,0,0,11.7,36,18.4,1022.3,Cloudy
12/29/2022 20:00,30,81,66980,59408,111,126388,THURSDAY,0,0,10,42,18.4,1022.8,Cloudy
12/29/2022 21:00,20,65,25482,46499,85,71981,THURSDAY,0,0,10,42,18.4,1022.8,Cloudy
12/29/2022 22:00,46,53,111188,45985,99,157173,THURSDAY,0,0,8.9,47,16.6,1022.9,Fair
12/29/2022 23:00,11,36,12979,19760,47,32739,THURSDAY,0,0,7.2,56,13,1022.9,Fair
12/30/2022 0:00,11,18,12033,10455,29,22488,FRIDAY,0,0,7.2,58,13,1023.5,Fair
12/30/2022 1:00,5,13,6355,9371,18,15726,FRIDAY,0,0,6.7,62,11.2,1023.9,Fair
12/30/2022 2:00,8,16,15490,18560,24,34050,FRIDAY,0,0,6.1,62,14.8,1024.3,Clear
12/30/2022 3:00,1,3,903,2983,4,3886,FRIDAY,0,0,5.6,64,7.6,1024.3,Clear
12/30/2022 4:00,2,4,6384,2478,6,8862,FRIDAY,0,0,5.6,64,7.6,1024.3,Clear
12/30/2022 5:00,2,18,716,13590,20,14306,FRIDAY,0,0,5,65,16.6,1024.2,Clear
12/30/2022 6:00,6,38,5177,24890,44,30067,FRIDAY,0,0,5.6,62,14.8,1024.2,Clear
12/30/2022 7:00,11,75,14552,54684,86,69236,FRIDAY,0,0,4.4,65,16.6,1024.7,Clear
12/30/2022 8:00,19,99,26216,76696,118,102912,FRIDAY,0,0,5.6,62,13,1024.4,Clear
12/30/2022 9:00,18,94,25287,76193,112,101480,FRIDAY,0,0,6.1,62,7.6,1024.5,Fair
12/30/2022 10:00,50,159,95120,126553,209,221673,FRIDAY,0,0,8.3,54,13,1024.5,Fair
12/30/2022 11:00,98,189,177992,176506,287,354498,FRIDAY,0,0,8.3,54,13,1024.5,Fair
12/30/2022 12:00,119,233,215531,380052,352,595583,FRIDAY,0,0,7.2,58,5.4,1024.7,Fair
12/30/2022 13:00,152,258,813932,239632,410,1053564,FRIDAY,0,0,8.3,58,11.2,1024.7,Fair
12/30/2022 14:00,168,253,667907,250543,421,918450,FRIDAY,0,0,11.1,52,9.4,1024.8,Cloudy
12/30/2022 15:00,186,297,296211,286687,483,582898,FRIDAY,0,0,12.2,50,7.6,1023.9,Cloudy
12/30/2022 16:00,151,285,405761,247150,436,652911,FRIDAY,0,0,12.2,50,7.6,1023.9,Cloudy
12/30/2022 17:00,89,236,323168,185929,325,509097,FRIDAY,0,0,15.6,42,11.2,1022.3,Cloudy
12/30/2022 18:00,84,193,187426,149183,277,336609,FRIDAY,0,0,17.2,35,7.6,1021.9,Cloudy
12/30/2022 19:00,56,87,309438,69214,143,378652,FRIDAY,0,0,16.7,35,18.4,1021.7,Cloudy
12/30/2022 20:00,54,82,77214,54603,136,131817,FRIDAY,0,0,14.4,44,9.4,1021.8,Cloudy
12/30/2022 21:00,65,66,134321,54903,131,189224,FRIDAY,0,0,14.4,44,9.4,1021.8,Cloudy
12/30/2022 22:00,31,64,48440,50147,95,98587,FRIDAY,0,0,13.3,45,18.4,1021.3,Cloudy
12/30/2022 23:00,25,40,238396,30659,65,269055,FRIDAY,0,0,11.7,54,18.4,1021.4,Cloudy
12/31/2022 0:00,32,34,207300,21674,66,228974,SATURDAY,1,0,10.6,63,20.5,1021.7,Cloudy
12/31/2022 1:00,46,16,119136,16019,62,135155,SATURDAY,1,0,9.4,66,16.6,1022.2,Cloudy
12/31/2022 2:00,17,13,24432,12024,30,36456,SATURDAY,1,0,9.4,66,16.6,1022.2,Cloudy
12/31/2022 3:00,6,6,4653,10005,12,14658,SATURDAY,1,0,8.9,71,22.3,1021.3,Cloudy
12/31/2022 4:00,5,3,6271,2169,8,8440,SATURDAY,1,0,8.3,74,20.5,1021,Cloudy
12/31/2022 5:00,2,9,1125,19039,11,20164,SATURDAY,1,0,8.3,74,20.5,1021,Cloudy
12/31/2022 6:00,3,20,1154,13218,23,14372,SATURDAY,1,0,8.3,74,18.4,1020.6,Cloudy
12/31/2022 7:00,9,38,12890,24809,47,37699,SATURDAY,1,0,7.8,79,22.3,1020.4,Cloudy
12/31/2022 8:00,13,43,12781,300508,56,313289,SATURDAY,1,0,7.8,86,18.4,1020,Cloudy
12/31/2022 9:00,29,88,63134,72262,117,135396,SATURDAY,1,0,7.8,86,18.4,1020,Cloudy
12/31/2022 10:00,29,125,37798,99927,154,137725,SATURDAY,1,0,9.4,90,22.3,1018.9,Cloudy
12/31/2022 11:00,58,154,107619,126660,212,234279,SATURDAY,1,0,9.4,90,22.3,1018.9,Cloudy
12/31/2022 12:00,85,159,299858,137518,244,437376,SATURDAY,1,0,10,93,11.2,1019.2,Cloudy
12/31/2022 13:00,86,162,138305,128947,248,267252,SATURDAY,1,0,10,93,11.2,1019.2,Cloudy
12/31/2022 14:00,90,153,138277,142852,243,281129,SATURDAY,1,0,8.9,100,16.6,1018.4,Cloudy
12/31/2022 15:00,49,117,84492,87607,166,172099,SATURDAY,1,0,8.9,100,16.6,1018.4,Cloudy
12/31/2022 16:00,36,117,44967,95401,153,140368,SATURDAY,1,0,10,100,14.8,1016.8,Cloudy
12/31/2022 17:00,26,67,23018,58254,93,81272,SATURDAY,1,0,11.1,97,11.2,1015.2,Cloudy
12/31/2022 18:00,15,46,35937,35921,61,71858,SATURDAY,1,0,11.1,97,13,1014.4,Cloudy
12/31/2022 19:00,12,50,10304,36778,62,47082,SATURDAY,1,0,11.1,97,13,1014.4,Cloudy
12/31/2022 20:00,18,40,33181,44287,58,77468,SATURDAY,1,0,11.1,97,13,1014.3,Rain
12/31/2022 21:00,22,20,185725,12465,42,198190,SATURDAY,1,0,10.6,100,14.8,1013.4,Rain
12/31/2022 22:00,9,14,7511,9770,23,17281,SATURDAY,1,0,10,100,16.6,1012.5,Rain
12/31/2022 23:00,16,25,27389,51763,41,79152,SATURDAY,1,0,10,100,9.4,1011.2,Rain
1/1/2023 0:00,49,36,138254,24649,85,162903,SUNDAY,1,1,11.1,100,13,1010.4,Rain
1/1/2023 1:00,110,56,226041,60322,166,286363,SUNDAY,1,1,11.1,100,11.2,1008.9,Rain
1/1/2023 2:00,58,34,271225,40846,92,312071,SUNDAY,1,1,11.7,100,13,1008.2,Rain
1/1/2023 3:00,25,10,64469,8548,35,73017,SUNDAY,1,1,11.1,100,11.2,1006.2,Rain
1/1/2023 4:00,11,12,23720,15447,23,39167,SUNDAY,1,1,12.2,100,16.6,1005.3,Rain
1/1/2023 5:00,6,16,15411,22487,22,37898,SUNDAY,1,1,12.2,100,16.6,1005.3,Rain
1/1/2023 6:00,4,28,11329,18572,32,29901,SUNDAY,1,1,12.2,97,16.6,1004.1,Rain
1/1/2023 7:00,8,27,7589,18238,35,25827,SUNDAY,1,1,12.2,93,18.4,1003.2,Rain
1/1/2023 8:00,24,42,328775,40724,66,369499,SUNDAY,1,1,12.2,93,18.4,1003.2,Cloudy
1/1/2023 9:00,17,63,291656,65065,80,356721,SUNDAY,1,1,12.2,90,22.3,1003.4,Cloudy
1/1/2023 10:00,47,115,172932,129817,162,302749,SUNDAY,1,1,11.7,89,22.3,1004.1,Cloudy
1/1/2023 11:00,75,131,191656,137459,206,329115,SUNDAY,1,1,11.7,89,22.3,1004.1,Cloudy
1/1/2023 12:00,126,161,267177,157357,287,424534,SUNDAY,1,1,11.7,77,25.9,1005.4,Cloudy
1/1/2023 13:00,138,170,299669,201440,308,501109,SUNDAY,1,1,11.7,71,31.7,1006.4,Cloudy
1/1/2023 14:00,140,190,2866226,174589,330,3040815,SUNDAY,1,1,11.7,69,31.7,1007.1,Fair
1/1/2023 15:00,154,170,252247,173137,324,425384,SUNDAY,1,1,11.7,69,31.7,1007.1,Fair
1/1/2023 16:00,58,172,87163,130916,230,218079,SUNDAY,1,1,12.2,57,24.1,1008.4,Cloudy
1/1/2023 17:00,45,107,71426,69484,152,140910,SUNDAY,1,1,11.7,59,24.1,1008.5,Cloudy
1/1/2023 18:00,39,98,72620,75506,137,148126,SUNDAY,1,1,11.1,57,24.1,1009.3,Cloudy
1/1/2023 19:00,31,83,259712,58726,114,318438,SUNDAY,1,1,11.1,54,22.3,1010,Cloudy
1/1/2023 20:00,24,62,37978,48890,86,86868,SUNDAY,1,1,11.1,54,22.3,1010,Cloudy
1/1/2023 21:00,18,52,24047,40374,70,64421,SUNDAY,1,1,9.4,54,20.5,1011.3,Cloudy
1/1/2023 22:00,27,50,109423,40636,77,150059,SUNDAY,1,1,8.3,56,20.5,1011.9,Cloudy
1/1/2023 23:00,11,28,58737,18987,39,77724,SUNDAY,1,1,7.8,55,22.3,1012.9,Cloudy
1/2/2023 0:00,7,13,4950,7689,20,12639,MONDAY,0,1,6.7,58,22.3,1013.9,Cloudy
1/2/2023 1:00,5,15,8544,16917,20,25461,MONDAY,0,1,6.7,58,22.3,1013.9,Cloudy
1/2/2023 2:00,3,5,3765,5725,8,9490,MONDAY,0,1,6.1,62,16.6,1014.3,Cloudy
1/2/2023 3:00,2,2,9861,4416,4,14277,MONDAY,0,1,6.1,62,18.4,1015.2,Cloudy
1/2/2023 4:00,2,4,1919,52896,6,54815,MONDAY,0,1,6.1,62,18.4,1015.8,Cloudy
1/2/2023 5:00,1,13,587,11653,14,12240,MONDAY,0,1,5.6,64,11.2,1015.5,Cloudy
1/2/2023 6:00,3,25,3736,17884,28,21620,MONDAY,0,1,5.6,64,11.2,1015.5,Cloudy
1/2/2023 7:00,5,58,4309,40050,63,44359,MONDAY,0,1,3.9,76,0,1016.2,Cloudy
1/2/2023 8:00,15,90,24090,65746,105,89836,MONDAY,0,1,3.3,79,7.6,1016.5,Cloudy
1/2/2023 9:00,21,100,31657,65947,121,97604,MONDAY,0,1,3.3,79,5.4,1017.2,Fair
1/2/2023 10:00,43,143,62007,100539,186,162546,MONDAY,0,1,3.3,79,5.4,1017.2,Cloudy
1/2/2023 11:00,85,171,277113,123594,256,400707,MONDAY,0,1,4.4,76,11.2,1017.7,Cloudy
1/2/2023 12:00,104,202,188527,421376,306,609903,MONDAY,0,1,5,73,11.2,1018,Cloudy
1/2/2023 13:00,100,197,273932,152072,297,426004,MONDAY,0,1,5.6,73,16.6,1018.3,Cloudy
1/2/2023 14:00,99,203,196608,178719,302,375327,MONDAY,0,1,5.6,70,16.6,1019.2,Cloudy
1/2/2023 15:00,118,234,450543,190925,352,641468,MONDAY,0,1,5.6,70,22.3,1019.2,Cloudy
1/2/2023 16:00,99,220,171456,177295,319,348751,MONDAY,0,1,8.3,58,20.5,1018.1,Cloudy
1/2/2023 17:00,121,218,269675,177601,339,447276,MONDAY,0,1,8.9,56,20.5,1017.9,Cloudy
1/2/2023 18:00,44,159,327028,112792,203,439820,MONDAY,0,1,9.4,54,20.5,1017.6,Cloudy
1/2/2023 19:00,47,140,78959,101013,187,179972,MONDAY,0,1,10.6,52,18.4,1017.9,Cloudy
1/2/2023 20:00,33,83,171113,65722,116,236835,MONDAY,0,1,10.6,52,18.4,1017.9,Cloudy
1/2/2023 21:00,26,67,47121,49736,93,96857,MONDAY,0,1,10,52,7.6,1018.2,Cloudy
1/2/2023 22:00,9,47,7505,30970,56,38475,MONDAY,0,1,9.4,54,14.8,1019.1,Cloudy
1/2/2023 23:00,12,22,27971,15388,34,43359,MONDAY,0,1,9.4,54,7.6,1020,Cloudy
1/3/2023 0:00,5,15,49624,12217,20,61841,TUESDAY,0,0,8.3,58,9.4,1020.7,Fair
1/3/2023 1:00,7,13,3228,14334,20,17562,TUESDAY,0,0,7.2,63,11.2,1021.4,Fair
1/3/2023 2:00,2,6,1410,2839,8,4249,TUESDAY,0,0,7.2,63,11.2,1021.4,Fair
1/3/2023 3:00,3,2,4831,1986,5,6817,TUESDAY,0,0,5,73,9.4,1021.8,Fair
1/3/2023 4:00,2,6,1808,6052,8,7860,TUESDAY,0,0,2.8,85,7.6,1021.5,Fair
1/3/2023 5:00,5,28,3450,19371,33,22821,TUESDAY,0,0,2.8,85,7.6,1021.5,Fair
1/3/2023 6:00,14,89,11790,60622,103,72412,TUESDAY,0,0,2.2,85,0,1021.7,Fair
1/3/2023 7:00,22,221,654606,150733,243,805339,TUESDAY,0,0,1.7,89,7.6,1021.8,Cloudy
1/3/2023 8:00,35,347,31080,265366,382,296446,TUESDAY,0,0,2.2,92,0,1021.1,Cloudy
1/3/2023 9:00,22,189,22619,131408,211,154027,TUESDAY,0,0,2.8,93,0,1020.9,Cloudy
1/3/2023 10:00,8,78,12734,53418,86,66152,TUESDAY,0,0,2.8,93,0,1020.9,Cloudy
1/3/2023 11:00,11,58,14501,35711,69,50212,TUESDAY,0,0,3.9,82,5.4,1020.5,Cloudy
1/3/2023 12:00,7,55,8891,30685,62,39576,TUESDAY,0,0,4.4,86,7.6,1020.1,Cloudy
1/3/2023 13:00,3,45,3940,31245,48,35185,TUESDAY,0,0,5,93,5.4,1019.8,Cloudy
1/3/2023 14:00,7,53,6723,32020,60,38743,TUESDAY,0,0,5,93,5.4,1019.8,Cloudy
1/3/2023 15:00,16,88,287360,56548,104,343908,TUESDAY,0,0,5,96,5.4,1019.6,Rain
1/3/2023 16:00,22,199,18263,143459,221,161722,TUESDAY,0,0,6.1,97,16.6,1016.2,Rain
1/3/2023 17:00,31,304,31914,2529345,335,2561259,TUESDAY,0,0,6.1,97,13,1015.3,Rain
1/3/2023 18:00,15,159,21344,97194,174,118538,TUESDAY,0,0,5.6,100,13,1013.2,Rain
1/3/2023 19:00,15,111,19367,78381,126,97748,TUESDAY,0,0,5.6,100,13,1013.2,Rain
1/3/2023 20:00,5,69,4202,80336,74,84538,TUESDAY,0,0,7.2,97,0,1010.9,Rain
1/3/2023 21:00,3,55,2207,40345,58,42552,TUESDAY,0,0,7.2,97,14.8,1010.2,Cloudy
1/3/2023 22:00,3,43,6185,30979,46,37164,TUESDAY,0,0,7.2,97,14.8,1010.2,Rain
1/3/2023 23:00,7,27,7579,21926,34,29505,TUESDAY,0,0,5.6,96,13,1010.2,Rain
1/4/2023 0:00,7,7,183633,31745,14,215378,WEDNESDAY,0,0,5,96,14.8,1010,Rain
1/4/2023 1:00,0,4,0,4109,4,4109,WEDNESDAY,0,0,5,96,13,1010.3,Rain
1/4/2023 2:00,1,0,1695,0,1,1695,WEDNESDAY,0,0,4.4,100,7.6,1010.1,Rain
1/4/2023 3:00,1,2,1764,1144,3,2908,WEDNESDAY,0,0,4.4,97,9.4,1010,Rain
1/4/2023 4:00,1,8,803,6180,9,6983,WEDNESDAY,0,0,4.4,97,9.4,1010,Rain
1/4/2023 5:00,3,41,55094,28367,44,83461,WEDNESDAY,0,0,4.4,97,0,1009.6,Rain
1/4/2023 6:00,11,101,6791,76923,112,83714,WEDNESDAY,0,0,4.4,97,0,1009,Rain
1/4/2023 7:00,21,261,13784,203037,282,216821,WEDNESDAY,0,0,4.4,97,0,1009.5,Rain
1/4/2023 8:00,49,511,41681,419288,560,460969,WEDNESDAY,0,0,5,93,0,1009,Rain
1/4/2023 9:00,32,276,38697,293089,308,331786,WEDNESDAY,0,0,5,93,0,1009,Rain
1/4/2023 10:00,24,158,48299,117079,182,165378,WEDNESDAY,0,0,4.4,97,7.6,1009.2,Rain
1/4/2023 11:00,26,150,111498,112204,176,223702,WEDNESDAY,0,0,4.4,97,9.4,1010.2,Rain
1/4/2023 12:00,37,193,48618,120607,230,169225,WEDNESDAY,0,0,4.4,97,9.4,1011.4,Cloudy
1/4/2023 13:00,47,168,211397,112290,215,323687,WEDNESDAY,0,0,5,96,5.4,1011.8,Cloudy
1/4/2023 14:00,49,176,109391,124611,225,234002,WEDNESDAY,0,0,5,96,5.4,1011.8,Cloudy
1/4/2023 15:00,78,295,121978,216727,373,338705,WEDNESDAY,0,0,6.1,97,5.4,1013.4,Cloudy
1/4/2023 16:00,80,419,110222,314147,499,424369,WEDNESDAY,0,0,6.1,97,5.4,1013.4,Cloudy
1/4/2023 17:00,52,506,557182,1145358,558,1702540,WEDNESDAY,0,0,6.7,89,0,1012.6,Cloudy
1/4/2023 18:00,40,380,57250,266636,420,323886,WEDNESDAY,0,0,6.7,89,9.4,1012.9,Cloudy
1/4/2023 19:00,49,229,49266,153231,278,202497,WEDNESDAY,0,0,6.7,89,9.4,1012.9,Cloudy
1/4/2023 20:00,17,100,20873,65329,117,86202,WEDNESDAY,0,0,6.1,93,9.4,1014.5,Cloudy
1/4/2023 21:00,9,46,9996,67721,55,77717,WEDNESDAY,0,0,6.1,93,11.2,1014.8,Cloudy
1/4/2023 22:00,5,25,3498,13799,30,17297,WEDNESDAY,0,0,6.1,93,14.8,1014.9,Cloudy
1/4/2023 23:00,1,28,730,20825,29,21555,WEDNESDAY,0,0,6.1,93,14.8,1014.9,Rain
1/5/2023 0:00,3,9,1797,5618,12,7415,THURSDAY,0,0,6.1,93,13,1015.4,Rain
1/5/2023 1:00,0,6,0,5674,6,5674,THURSDAY,0,0,6.1,93,14.8,1014.4,Rain
1/5/2023 2:00,0,5,0,4021,5,4021,THURSDAY,0,0,6.1,97,14.8,1014.4,Rain
1/5/2023 3:00,4,1,6459,410,5,6869,THURSDAY,0,0,6.7,96,14.8,1013.7,Rain
1/5/2023 4:00,2,7,1453,7187,9,8640,THURSDAY,0,0,7.2,97,18.4,1013,Rain
1/5/2023 5:00,3,30,1988,300316,33,302304,THURSDAY,0,0,7.2,97,18.4,1013,Rain
1/5/2023 6:00,11,98,6967,73637,109,80604,THURSDAY,0,0,7.2,97,25.9,1012.4,Rain
1/5/2023 7:00,20,280,18756,253098,300,271854,THURSDAY,0,0,7.2,97,25.9,1013.2,Rain
1/5/2023 8:00,34,392,59802,290881,426,350683,THURSDAY,0,0,6.7,100,31.7,1013.7,Rain
1/5/2023 9:00,29,209,26185,133810,238,159995,THURSDAY,0,0,6.7,100,27.7,1013.7,Rain
1/5/2023 10:00,18,154,23706,123546,172,147252,THURSDAY,0,0,6.1,97,25.9,1015.6,Cloudy
1/5/2023 11:00,26,112,56771,78987,138,135758,THURSDAY,0,0,6.1,93,25.9,1015.9,Cloudy
1/5/2023 12:00,20,108,47924,80899,128,128823,THURSDAY,0,0,6.1,93,31.7,1015.9,Rain
1/5/2023 13:00,25,123,29066,90653,148,119719,THURSDAY,0,0,5.6,96,25.9,1016.4,Rain
1/5/2023 14:00,35,127,46261,108324,162,154585,THURSDAY,0,0,4.4,97,29.5,1016.9,Cloudy
1/5/2023 15:00,51,198,71805,151367,249,223172,THURSDAY,0,0,5,96,22.3,1016.8,Cloudy
1/5/2023 16:00,45,323,63522,225753,368,289275,THURSDAY,0,0,5,96,22.3,1016.8,Cloudy
1/5/2023 17:00,67,476,82149,366159,543,448308,THURSDAY,0,0,5,96,20.5,1016.3,Cloudy
1/5/2023 18:00,47,373,53999,340427,420,394426,THURSDAY,0,0,4.4,97,24.1,1015.8,Cloudy
1/5/2023 19:00,16,225,13066,147202,241,160268,THURSDAY,0,0,4.4,97,24.1,1015.8,Cloudy
1/5/2023 20:00,26,124,27921,99724,150,127645,THURSDAY,0,0,3.9,93,22.3,1016.5,Cloudy
1/5/2023 21:00,19,96,17446,67494,115,84940,THURSDAY,0,0,2.8,96,22.3,1016.1,Cloudy
1/5/2023 22:00,13,59,68123,38809,72,106932,THURSDAY,0,0,2.8,96,22.3,1016.1,Cloudy
1/5/2023 23:00,4,38,2117,28583,42,30700,THURSDAY,0,0,2.8,96,25.9,1016.1,Cloudy
1/6/2023 0:00,7,14,8479,11694,21,20173,FRIDAY,0,0,2.8,96,25.9,1016.5,Cloudy
1/6/2023 1:00,6,8,5955,4223,14,10178,FRIDAY,0,0,2.8,96,18.4,1016.8,Cloudy
1/6/2023 2:00,7,3,21277,1499,10,22776,FRIDAY,0,0,2.8,96,18.4,1016.8,Snow
1/6/2023 3:00,0,3,0,3416,3,3416,FRIDAY,0,0,2.2,97,16.6,1016.4,Cloudy
1/6/2023 4:00,3,7,3401,4745,10,8146,FRIDAY,0,0,2.2,92,18.4,1016.4,Cloudy
1/6/2023 5:00,5,23,2582,15565,28,18147,FRIDAY,0,0,1.1,100,13,1016.3,Cloudy
1/6/2023 6:00,10,96,6846,67740,106,74586,FRIDAY,0,0,1.1,97,16.6,1016.6,Cloudy
1/6/2023 7:00,17,191,14532,666037,208,680569,FRIDAY,0,0,1.1,97,13,1016.3,Cloudy
1/6/2023 8:00,25,276,16197,184430,301,200627,FRIDAY,0,0,1.1,97,14.8,1016.3,Cloudy
1/6/2023 9:00,17,160,13792,95989,177,109781,FRIDAY,0,0,1.1,97,14.8,1016.3,Cloudy
1/6/2023 10:00,6,139,3528,86816,145,90344,FRIDAY,0,0,1.1,92,14.8,1015.7,Cloudy
1/6/2023 11:00,14,115,29067,81898,129,110965,FRIDAY,0,0,1.1,92,14.8,1015.7,Rain
1/6/2023 12:00,13,127,18563,90630,140,109193,FRIDAY,0,0,1.1,97,9.4,1017.3,Cloudy
1/6/2023 13:00,20,106,24745,70159,126,94904,FRIDAY,0,0,1.1,97,14.8,1016.7,Rain
1/6/2023 14:00,13,81,20375,59554,94,79929,FRIDAY,0,0,1.1,97,14.8,1016.7,Rain
1/6/2023 15:00,16,114,18293,79584,130,97877,FRIDAY,0,0,1.7,100,11.2,1016,Rain
1/6/2023 16:00,10,151,10994,111627,161,122621,FRIDAY,0,0,1.7,96,11.2,1015,Rain
1/6/2023 17:00,18,179,26671,129527,197,156198,FRIDAY,0,0,2.2,97,11.2,1014.6,Rain
1/6/2023 18:00,15,133,18454,92264,148,110718,FRIDAY,0,0,2.2,97,11.2,1014.6,Rain
1/6/2023 19:00,10,130,24088,86642,140,110730,FRIDAY,0,0,2.2,97,16.6,1014.6,Rain
1/6/2023 20:00,12,104,17139,75579,116,92718,FRIDAY,0,0,1.1,97,18.4,1015,Rain
1/6/2023 21:00,13,70,10252,49493,83,59745,FRIDAY,0,0,0.6,96,14.8,1015.9,Rain
1/6/2023 22:00,11,52,10394,45619,63,56013,FRIDAY,0,0,1.1,97,13,1016.4,Rain
1/6/2023 23:00,13,41,8927,27908,54,36835,FRIDAY,0,0,1.1,97,13,1016.4,Rain
1/7/2023 0:00,7,31,4229,15157,38,19386,SATURDAY,1,0,1.7,92,11.2,1016.9,Rain
1/7/2023 1:00,25,27,343047,31545,52,374592,SATURDAY,1,0,1.7,92,11.2,1016.9,Rain
1/7/2023 2:00,8,17,40749,13834,25,54583,SATURDAY,1,0,2.2,89,13,1017.5,Rain
1/7/2023 3:00,0,2,0,908,2,908,SATURDAY,1,0,2.2,89,13,1017.5,Rain
1/7/2023 4:00,0,5,0,3278,5,3278,SATURDAY,1,0,1.1,97,11.2,1017.6,Cloudy
1/7/2023 5:00,0,9,0,9760,9,9760,SATURDAY,1,0,1.1,100,9.4,1017.5,Cloudy
1/7/2023 6:00,2,27,3083,19877,29,22960,SATURDAY,1,0,1.7,92,11.2,1017.6,Cloudy
1/7/2023 7:00,6,40,3015,31821,46,34836,SATURDAY,1,0,1.7,92,11.2,1017.6,Cloudy
1/7/2023 8:00,14,85,10589,60563,99,71152,SATURDAY,1,0,1.1,92,9.4,1017.3,Cloudy
1/7/2023 9:00,27,141,38166,390332,168,428498,SATURDAY,1,0,1.1,92,9.4,1017.3,Cloudy
1/7/2023 10:00,40,205,48761,161975,245,210736,SATURDAY,1,0,1.1,97,5.4,1017.7,Cloudy
1/7/2023 11:00,83,231,117473,182033,314,299506,SATURDAY,1,0,1.1,92,7.6,1018,Cloudy
1/7/2023 12:00,64,240,113298,209911,304,323209,SATURDAY,1,0,2.2,89,9.4,1018,Cloudy
1/7/2023 13:00,95,259,883774,225670,354,1109444,SATURDAY,1,0,2.2,89,9.4,1018,Cloudy
1/7/2023 14:00,105,270,152172,238083,375,390255,SATURDAY,1,0,4.4,73,13,1018.3,Cloudy
1/7/2023 15:00,74,283,150546,232117,357,382663,SATURDAY,1,0,5.6,70,16.6,1017.8,Cloudy
1/7/2023 16:00,46,237,72300,178671,283,250971,SATURDAY,1,0,5.6,67,16.6,1017.2,Cloudy
1/7/2023 17:00,66,233,106794,169116,299,275910,SATURDAY,1,0,5.6,67,20.5,1016.5,Cloudy
1/7/2023 18:00,51,187,56220,129808,238,186028,SATURDAY,1,0,5.6,67,20.5,1016.5,Cloudy
1/7/2023 19:00,27,130,21707,88377,157,110084,SATURDAY,1,0,5.6,64,14.8,1016.8,Cloudy
1/7/2023 20:00,28,101,73653,1771877,129,1845530,SATURDAY,1,0,5,70,16.6,1017.3,Cloudy
1/7/2023 21:00,22,80,334576,52363,102,386939,SATURDAY,1,0,5,67,16.6,1017.7,Cloudy
1/7/2023 22:00,21,62,24508,42487,83,66995,SATURDAY,1,0,5,62,16.6,1018.3,Cloudy
1/7/2023 23:00,28,62,24323,36277,90,60600,SATURDAY,1,0,5,62,24.1,1018.3,Cloudy
1/8/2023 0:00,19,39,15036,24109,58,39145,SUNDAY,1,0,3.3,70,18.4,1019.7,Cloudy
1/8/2023 1:00,44,31,117939,18853,75,136792,SUNDAY,1,0,2.2,75,18.4,1020.3,Cloudy
1/8/2023 2:00,12,16,13905,18105,28,32010,SUNDAY,1,0,2.2,75,18.4,1020.3,Cloudy
1/8/2023 3:00,3,6,2585,48606,9,51191,SUNDAY,1,0,0.6,66,18.4,1021.4,Fair
1/8/2023 4:00,1,6,969,4505,7,5474,SUNDAY,1,0,0.6,66,18.4,1021.4,Fair
1/8/2023 5:00,3,7,4728,11365,10,16093,SUNDAY,1,0,-1.1,66,18.4,1021.9,Fair
1/8/2023 6:00,5,20,6217,11958,25,18175,SUNDAY,1,0,-2.2,63,24.1,1022.9,Fair
1/8/2023 7:00,3,33,3674,27402,36,31076,SUNDAY,1,0,-2.8,63,24.1,1023.8,Clear
1/8/2023 8:00,9,62,34438,53327,71,87765,SUNDAY,1,0,-3.3,65,14.8,1024,Clear
1/8/2023 9:00,19,121,11581,74438,140,86019,SUNDAY,1,0,-3.3,65,14.8,1024,Clear
1/8/2023 10:00,38,190,47100,112943,228,160043,SUNDAY,1,0,-3.9,68,16.6,1025.1,Clear
1/8/2023 11:00,44,229,61634,174344,273,235978,SUNDAY,1,0,-3.9,66,18.4,1025.5,Fair
1/8/2023 12:00,84,210,298494,155061,294,453555,SUNDAY,1,0,-3.9,63,16.6,1026.1,Fair
1/8/2023 13:00,81,215,113371,163804,296,277175,SUNDAY,1,0,-3.9,63,16.6,1026.1,Fair
1/8/2023 14:00,107,247,216053,749457,354,965510,SUNDAY,1,0,-1.7,56,7.6,1027,Fair
1/8/2023 15:00,88,225,141371,168487,313,309858,SUNDAY,1,0,-0.6,51,7.6,1026.2,Fair
1/8/2023 16:00,52,272,73122,222289,324,295411,SUNDAY,1,0,0.6,47,0,1025.2,Fair
1/8/2023 17:00,48,210,66274,143589,258,209863,SUNDAY,1,0,1.1,52,9.4,1024.3,Fair
1/8/2023 18:00,38,169,41006,128666,207,169672,SUNDAY,1,0,1.1,52,9.4,1024.3,Fair
1/8/2023 19:00,23,126,20787,135270,149,156057,SUNDAY,1,0,2.8,40,14.8,1023.7,Fair
1/8/2023 20:00,30,81,23774,51212,111,74986,SUNDAY,1,0,2.8,42,14.8,1023.5,Fair
1/8/2023 21:00,14,75,19325,52823,89,72148,SUNDAY,1,0,2.2,44,11.2,1023,Fair
1/8/2023 22:00,9,60,7494,38318,69,45812,SUNDAY,1,0,1.1,50,13,1022.9,Fair
1/8/2023 23:00,7,33,13844,21867,40,35711,SUNDAY,1,0,1.1,50,13,1022.9,Fair
1/9/2023 0:00,1,13,545,7086,14,7631,MONDAY,0,0,-0.6,66,14.8,1022.2,Fair
1/9/2023 1:00,3,5,25906,2235,8,28141,MONDAY,0,0,-1.1,72,14.8,1021.4,Fair
1/9/2023 2:00,0,1,0,365,1,365,MONDAY,0,0,-1.1,72,16.6,1020.9,Clear
1/9/2023 3:00,0,3,0,1181,3,1181,MONDAY,0,0,-1.1,72,18.4,1020.6,Clear
1/9/2023 4:00,1,7,566,4835,8,5401,MONDAY,0,0,-1.1,72,18.4,1020.6,Clear
1/9/2023 5:00,6,32,2621,23398,38,26019,MONDAY,0,0,-1.7,75,13,1018.9,Clear
1/9/2023 6:00,6,109,3406,71527,115,74933,MONDAY,0,0,-1.7,75,13,1018.9,Clear
1/9/2023 7:00,23,297,18955,213732,320,232687,MONDAY,0,0,-1.1,78,11.2,1017.5,Clear
1/9/2023 8:00,27,506,18183,359317,533,377500,MONDAY,0,0,-1.1,78,11.2,1017.5,Fair
1/9/2023 9:00,18,314,17347,227200,332,244547,MONDAY,0,0,0,75,7.6,1015.7,Fair
1/9/2023 10:00,25,161,33074,111591,186,144665,MONDAY,0,0,0,79,11.2,1014.3,Fair
1/9/2023 11:00,25,173,49121,114604,198,163725,MONDAY,0,0,0,79,11.2,1014.3,Cloudy
1/9/2023 12:00,46,215,63064,165491,261,228555,MONDAY,0,0,1.1,85,18.4,1013.5,Cloudy
1/9/2023 13:00,39,196,60037,133294,235,193331,MONDAY,0,0,1.1,85,18.4,1013.5,Cloudy
1/9/2023 14:00,54,221,86965,776357,275,863322,MONDAY,0,0,2.8,76,11.2,1013.4,Cloudy
1/9/2023 15:00,57,257,74644,192789,314,267433,MONDAY,0,0,3.9,67,13,1012.5,Cloudy
1/9/2023 16:00,54,424,52899,311531,478,364430,MONDAY,0,0,5.6,55,13,1011,Cloudy
1/9/2023 17:00,65,542,79017,423440,607,502457,MONDAY,0,0,5,57,16.6,1010.2,Cloudy
1/9/2023 18:00,51,420,51260,288906,471,340166,MONDAY,0,0,5,57,16.6,1010.2,Cloudy
1/9/2023 19:00,34,272,886139,170995,306,1057134,MONDAY,0,0,5.6,53,16.6,1009.3,Cloudy
1/9/2023 20:00,17,148,17448,116560,165,134008,MONDAY,0,0,4.4,55,20.5,1009.5,Fair
1/9/2023 21:00,26,98,520172,73278,124,593450,MONDAY,0,0,3.9,59,18.4,1009.5,Fair
1/9/2023 22:00,20,65,1465982,1007314,85,2473296,MONDAY,0,0,3.9,59,18.4,1009.5,Fair
1/9/2023 23:00,12,33,8800,21280,45,30080,MONDAY,0,0,2.2,64,16.6,1009.7,Fair
1/10/2023 0:00,2,20,1002,14327,22,15329,TUESDAY,0,0,1.7,64,20.5,1010.1,Fair
1/10/2023 1:00,4,2,3369,341,6,3710,TUESDAY,0,0,1.1,64,16.6,1010.4,Fair
1/10/2023 2:00,3,5,5157,3705,8,8862,TUESDAY,0,0,1.1,64,18.4,1010.5,Fair
1/10/2023 3:00,2,0,2356,0,2,2356,TUESDAY,0,0,1.1,64,18.4,1010.5,Fair
1/10/2023 4:00,3,5,7422,4792,8,12214,TUESDAY,0,0,1.1,67,18.4,1010.5,Fair
1/10/2023 5:00,5,38,3621,27313,43,30934,TUESDAY,0,0,1.1,67,14.8,1010.6,Clear
1/10/2023 6:00,13,125,12040,72630,138,84670,TUESDAY,0,0,0.6,69,13,1011.1,Clear
1/10/2023 7:00,34,367,40962,263564,401,304526,TUESDAY,0,0,1.7,66,14.8,1011.3,Clear
1/10/2023 8:00,57,613,92223,479516,670,571739,TUESDAY,0,0,1.7,66,14.8,1011.3,Clear
1/10/2023 9:00,44,367,51444,257615,411,309059,TUESDAY,0,0,2.8,64,18.4,1011.9,Clear
1/10/2023 10:00,26,198,35718,323867,224,359585,TUESDAY,0,0,2.2,67,16.6,1012.3,Clear
1/10/2023 11:00,30,215,72866,160835,245,233701,TUESDAY,0,0,2.8,64,9.4,1012.7,Fair
1/10/2023 12:00,32,218,43214,151540,250,194754,TUESDAY,0,0,3.3,59,16.6,1013.3,Fair
1/10/2023 13:00,46,219,2208912,140963,265,2349875,TUESDAY,0,0,3.3,59,16.6,1013.3,Fair
1/10/2023 14:00,44,216,234237,164160,260,398397,TUESDAY,0,0,3.3,55,20.5,1015,Cloudy
1/10/2023 15:00,60,327,137034,239028,387,376062,TUESDAY,0,0,3.3,55,20.5,1015,Cloudy
1/10/2023 16:00,70,467,102374,365734,537,468108,TUESDAY,0,0,5,45,22.3,1014.6,Cloudy
1/10/2023 17:00,64,667,136656,483448,731,620104,TUESDAY,0,0,5,45,22.3,1014.6,Cloudy
1/10/2023 18:00,47,437,102744,288780,484,391524,TUESDAY,0,0,5,43,16.6,1014.6,Cloudy
1/10/2023 19:00,37,325,49475,225737,362,275212,TUESDAY,0,0,5,41,16.6,1015.1,Cloudy
1/10/2023 20:00,23,170,24382,116406,193,140788,TUESDAY,0,0,4.4,43,13,1016,Cloudy
1/10/2023 21:00,10,127,7616,84939,137,92555,TUESDAY,0,0,2.8,46,14.8,1016.7,Cloudy
1/10/2023 22:00,7,71,5272,49121,78,54393,TUESDAY,0,0,2.8,46,14.8,1016.7,Fair
1/10/2023 23:00,13,44,156549,39170,57,195719,TUESDAY,0,0,1.1,52,16.6,1017.6,Cloudy
1/11/2023 0:00,8,15,9097,11169,23,20266,WEDNESDAY,0,0,0.6,49,14.8,1018.4,Cloudy
1/11/2023 1:00,0,6,0,2869,6,2869,WEDNESDAY,0,0,-0.6,47,16.6,1018.9,Cloudy
1/11/2023 2:00,2,2,2592,1382,4,3974,WEDNESDAY,0,0,-1.1,47,9.4,1020,Cloudy
1/11/2023 3:00,0,5,0,4549,5,4549,WEDNESDAY,0,0,-1.1,44,14.8,1020.9,Cloudy
1/11/2023 4:00,3,10,3202,10283,13,13485,WEDNESDAY,0,0,-2.2,51,14.8,1021.4,Cloudy
1/11/2023 5:00,4,26,1406,17944,30,19350,WEDNESDAY,0,0,-2.8,55,13,1022,Cloudy
1/11/2023 6:00,12,102,8129,60301,114,68430,WEDNESDAY,0,0,-3.3,57,14.8,1022.6,Cloudy
1/11/2023 7:00,34,313,21992,222014,347,244006,WEDNESDAY,0,0,-3.3,57,14.8,1022.6,Cloudy
1/11/2023 8:00,50,556,43747,409443,606,453190,WEDNESDAY,0,0,-3.9,63,14.8,1023.2,Cloudy
1/11/2023 9:00,26,361,29739,228237,387,257976,WEDNESDAY,0,0,-4.4,68,13,1024,Cloudy
1/11/2023 10:00,27,186,28219,129239,213,157458,WEDNESDAY,0,0,-4.4,68,16.6,1024.7,Cloudy
1/11/2023 11:00,31,176,44499,115429,207,159928,WEDNESDAY,0,0,-5,71,16.6,1024.8,Cloudy
1/11/2023 12:00,43,229,60627,689284,272,749911,WEDNESDAY,0,0,-5,71,16.6,1024.8,Cloudy
1/11/2023 13:00,30,167,30787,128642,197,159429,WEDNESDAY,0,0,-3.3,71,16.6,1026,Cloudy
1/11/2023 14:00,26,208,63917,138249,234,202166,WEDNESDAY,0,0,-1.7,66,16.6,1026.5,Cloudy
1/11/2023 15:00,39,243,57041,172066,282,229107,WEDNESDAY,0,0,0,64,16.6,1026.4,Cloudy
1/11/2023 16:00,59,433,67942,434494,492,502436,WEDNESDAY,0,0,0,64,16.6,1026.4,Cloudy
1/11/2023 17:00,66,601,1231734,453435,667,1685169,WEDNESDAY,0,0,0.6,63,11.2,1025.5,Cloudy
1/11/2023 18:00,47,440,45068,332387,487,377455,WEDNESDAY,0,0,1.7,58,11.2,1025.6,Cloudy
1/11/2023 19:00,21,298,21175,238663,319,259838,WEDNESDAY,0,0,0.6,63,14.8,1025.9,Cloudy
1/11/2023 20:00,20,150,91043,104087,170,195130,WEDNESDAY,0,0,0.6,63,14.8,1025.9,Cloudy
1/11/2023 21:00,20,106,20350,76602,126,96952,WEDNESDAY,0,0,0,66,16.6,1026.1,Cloudy
1/11/2023 22:00,5,66,7234,44105,71,51339,WEDNESDAY,0,0,-0.6,78,14.8,1026.8,Cloudy
1/11/2023 23:00,10,39,14843,28432,49,43275,WEDNESDAY,0,0,-0.6,78,14.8,1026.8,Cloudy
1/12/2023 0:00,9,15,23554,8106,24,31660,THURSDAY,0,0,-0.6,78,13,1027.2,Cloudy
1/12/2023 1:00,2,4,952,3479,6,4431,THURSDAY,0,0,-0.6,82,9.4,1027.2,Cloudy
1/12/2023 2:00,3,5,2750,2422,8,5172,THURSDAY,0,0,-0.6,82,9.4,1027.2,Cloudy
1/12/2023 3:00,1,4,1630,4046,5,5676,THURSDAY,0,0,0,81,11.2,1026.9,Cloudy
1/12/2023 4:00,1,4,963,4759,5,5722,THURSDAY,0,0,0,81,11.2,1026.8,Cloudy
1/12/2023 5:00,5,33,3561,19051,38,22612,THURSDAY,0,0,0,92,11.2,1026.4,Cloudy
1/12/2023 6:00,8,91,7923,61165,99,69088,THURSDAY,0,0,0,88,11.2,1026.5,Cloudy
1/12/2023 7:00,27,295,20840,210781,322,231621,THURSDAY,0,0,0,88,11.2,1026.5,Cloudy
1/12/2023 8:00,36,539,28682,386009,575,414691,THURSDAY,0,0,-0.6,92,9.4,1026.4,Cloudy
1/12/2023 9:00,20,309,21852,210128,329,231980,THURSDAY,0,0,-0.6,89,7.6,1026.2,Cloudy
1/12/2023 10:00,19,160,14427,95709,179,110136,THURSDAY,0,0,-0.6,89,5.4,1025.9,Cloudy
1/12/2023 11:00,9,133,11288,77942,142,89230,THURSDAY,0,0,-0.6,89,11.2,1025.4,Cloudy
1/12/2023 12:00,18,163,22930,217158,181,240088,THURSDAY,0,0,0,92,7.6,1026.1,Cloudy
1/12/2023 13:00,16,173,17337,136020,189,153357,THURSDAY,0,0,0,92,7.6,1026.1,Cloudy
1/12/2023 14:00,22,183,26105,129158,205,155263,THURSDAY,0,0,1.7,85,5.4,1025.7,Cloudy
1/12/2023 15:00,34,215,35612,236094,249,271706,THURSDAY,0,0,1.7,85,5.4,1025.7,Cloudy
1/12/2023 16:00,39,355,35676,1262693,394,1298369,THURSDAY,0,0,2.2,89,0,1025.6,Cloudy
1/12/2023 17:00,55,532,60989,407404,587,468393,THURSDAY,0,0,3.9,89,14.8,1022.7,Rain
1/12/2023 18:00,49,439,55715,322211,488,377926,THURSDAY,0,0,4.4,89,18.4,1021.7,Rain
1/12/2023 19:00,36,288,93625,193857,324,287482,THURSDAY,0,0,4.4,89,18.4,1021.7,Rain
1/12/2023 20:00,21,164,88608,99326,185,187934,THURSDAY,0,0,4.4,89,20.5,1021.3,Rain
1/12/2023 21:00,12,91,10865,53095,103,63960,THURSDAY,0,0,5,86,22.3,1020.5,Rain
1/12/2023 22:00,5,48,1341234,33926,53,1375160,THURSDAY,0,0,5,89,20.5,1020.4,Rain
1/12/2023 23:00,0,17,0,10568,17,10568,THURSDAY,0,0,5,89,18.4,1019.1,Rain
1/13/2023 0:00,4,17,3145,14143,21,17288,FRIDAY,0,0,5.6,89,16.6,1018.4,Rain
1/13/2023 1:00,1,6,1534,3988,7,5522,FRIDAY,0,0,6.1,89,16.6,1016.6,Rain
1/13/2023 2:00,2,6,2076,3002,8,5078,FRIDAY,0,0,6.1,93,16.6,1015.1,Rain
1/13/2023 3:00,1,2,1201,1125,3,2326,FRIDAY,0,0,7.8,93,22.3,1010.8,Rain
1/13/2023 4:00,3,6,3220,3472,9,6692,FRIDAY,0,0,7.8,93,22.3,1010.8,Rain
1/13/2023 5:00,2,23,962,14800,25,15762,FRIDAY,0,0,9.4,97,29.5,1008.5,Rain
1/13/2023 6:00,8,85,34551,75720,93,110271,FRIDAY,0,0,10.6,100,16.6,1005.4,Rain
1/13/2023 7:00,21,208,14983,143966,229,158949,FRIDAY,0,0,10.6,100,16.6,1005.4,Cloudy
1/13/2023 8:00,31,392,28837,258176,423,287013,FRIDAY,0,0,13.3,90,42.5,1003.6,Rain
1/13/2023 9:00,27,222,30927,145454,249,176381,FRIDAY,0,0,12.2,97,20.5,1002.5,Rain
1/13/2023 10:00,37,152,45318,100726,189,146044,FRIDAY,0,0,13.3,93,20.5,1001.3,Rain
1/13/2023 11:00,30,210,42854,144910,240,187764,FRIDAY,0,0,14.4,87,37.1,1001,Rain
1/13/2023 12:00,54,241,76012,165938,295,241950,FRIDAY,0,0,14.4,87,44.6,1001,Rain
1/13/2023 13:00,56,244,2321800,163795,300,2485595,FRIDAY,0,0,13.3,87,35.3,1001.3,Rain
1/13/2023 14:00,83,239,140685,170408,322,311093,FRIDAY,0,0,12.8,89,25.9,1000.8,Rain
1/13/2023 15:00,98,320,368675,738171,418,1106846,FRIDAY,0,0,12.8,89,25.9,1000.8,Rain
1/13/2023 16:00,109,405,143832,1524494,514,1668326,FRIDAY,0,0,11.7,93,27.7,999.8,Rain
1/13/2023 17:00,95,455,111688,360524,550,472212,FRIDAY,0,0,12.8,83,25.9,998.8,Rain
1/13/2023 18:00,65,336,85199,255119,401,340318,FRIDAY,0,0,12.8,83,31.7,998.8,Rain
1/13/2023 19:00,42,236,44963,166249,278,211212,FRIDAY,0,0,12.8,83,22.3,999.2,Cloudy
1/13/2023 20:00,38,155,217269,119817,193,337086,FRIDAY,0,0,12.8,83,16.6,1000,Cloudy
1/13/2023 21:00,28,158,1599238,119042,186,1718280,FRIDAY,0,0,12.8,83,16.6,1000,Cloudy
1/13/2023 22:00,36,97,44367,69580,133,113947,FRIDAY,0,0,11.7,86,11.2,1001.6,Cloudy
1/13/2023 23:00,27,66,233954,47988,93,281942,FRIDAY,0,0,11.7,86,11.2,1001.6,Cloudy
1/14/2023 0:00,25,56,16826,36124,81,52950,SATURDAY,1,0,8.9,80,14.8,1003.8,Cloudy
1/14/2023 1:00,37,32,59073,23487,69,82560,SATURDAY,1,0,8.9,80,24.1,1003.8,Cloudy
1/14/2023 2:00,13,24,11466,19513,37,30979,SATURDAY,1,0,7.8,76,24.1,1004.1,Cloudy
1/14/2023 3:00,1,4,1695,2488,5,4183,SATURDAY,1,0,7.2,74,25.9,1003.8,Cloudy
1/14/2023 4:00,0,2,0,4081,2,4081,SATURDAY,1,0,5.6,73,22.3,1005.1,Cloudy
1/14/2023 5:00,2,12,795,9010,14,9805,SATURDAY,1,0,2.8,78,20.5,1004.7,Cloudy
1/14/2023 6:00,4,46,5363,29597,50,34960,SATURDAY,1,0,2.8,78,20.5,1004.7,Rain
1/14/2023 7:00,11,46,7399,42424,57,49823,SATURDAY,1,0,1.1,92,20.5,1005,Cloudy
1/14/2023 8:00,16,84,16806,57853,100,74659,SATURDAY,1,0,1.7,89,16.6,1006,Cloudy
1/14/2023 9:00,30,118,43333,342017,148,385350,SATURDAY,1,0,1.7,89,16.6,1006,Cloudy
1/14/2023 10:00,30,134,41095,88299,164,129394,SATURDAY,1,0,1.1,92,18.4,1007,Cloudy
1/14/2023 11:00,25,147,38445,106835,172,145280,SATURDAY,1,0,1.1,92,18.4,1007,Rain
1/14/2023 12:00,33,175,56064,137692,208,193756,SATURDAY,1,0,1.1,88,25.9,1007.4,Cloudy
1/14/2023 13:00,43,194,59016,141232,237,200248,SATURDAY,1,0,1.1,88,22.3,1008.5,Cloudy
1/14/2023 14:00,42,179,53168,140090,221,193258,SATURDAY,1,0,1.1,88,22.3,1008.5,Cloudy
1/14/2023 15:00,37,147,71491,105695,184,177186,SATURDAY,1,0,1.1,88,20.5,1009.5,Cloudy
1/14/2023 16:00,43,132,65789,112680,175,178469,SATURDAY,1,0,0.6,92,16.6,1009.5,Cloudy
1/14/2023 17:00,23,159,24370,121072,182,145442,SATURDAY,1,0,0.6,96,16.6,1009,Cloudy
1/14/2023 18:00,14,198,16935,145179,212,162114,SATURDAY,1,0,0.6,96,16.6,1009,Cloudy
1/14/2023 19:00,35,143,34355,108783,178,143138,SATURDAY,1,0,1.1,92,16.6,1009.2,Cloudy
1/14/2023 20:00,33,103,570882,79401,136,650283,SATURDAY,1,0,1.1,92,14.8,1010.1,Cloudy
1/14/2023 21:00,21,76,22763,50559,97,73322,SATURDAY,1,0,1.1,92,13,1011.4,Cloudy
1/14/2023 22:00,15,82,8665,55403,97,64068,SATURDAY,1,0,1.1,92,14.8,1011.7,Cloudy
1/14/2023 23:00,24,67,72941,47778,91,120719,SATURDAY,1,0,1.1,88,18.4,1012.2,Cloudy
1/15/2023 0:00,15,54,62269,33537,69,95806,SUNDAY,1,0,0.6,92,18.4,1012.4,Cloudy
1/15/2023 1:00,63,42,100930,32978,105,133908,SUNDAY,1,0,0.6,92,22.3,1012.4,Snow
1/15/2023 2:00,19,36,28743,25385,55,54128,SUNDAY,1,0,1.1,88,20.5,1012.4,Snow
1/15/2023 3:00,2,5,1415,4978,7,6393,SUNDAY,1,0,1.1,75,22.3,1012.5,Snow
1/15/2023 4:00,2,8,2648,5778,10,8426,SUNDAY,1,0,1.1,75,27.7,1012.5,Snow
1/15/2023 5:00,4,16,4114,12734,20,16848,SUNDAY,1,0,0.6,75,24.1,1012,Snow
1/15/2023 6:00,4,20,1385,10163,24,11548,SUNDAY,1,0,0.6,72,31.7,1012,Snow
1/15/2023 7:00,5,41,4111,24210,46,28321,SUNDAY,1,0,0.6,69,29.5,1013,Snow
1/15/2023 8:00,7,67,4732,45810,74,50542,SUNDAY,1,0,0.6,69,35.3,1013.8,Snow
1/15/2023 9:00,24,119,44452,75906,143,120358,SUNDAY,1,0,0.6,69,33.5,1013.8,Cloudy
1/15/2023 10:00,36,189,220970,142046,225,363016,SUNDAY,1,0,1.1,67,27.7,1014.1,Cloudy
1/15/2023 11:00,52,228,81366,170792,280,252158,SUNDAY,1,0,1.1,67,31.7,1014.1,Cloudy
1/15/2023 12:00,58,218,186907,172432,276,359339,SUNDAY,1,0,1.1,59,35.3,1014.2,Snow
1/15/2023 13:00,61,239,616350,165293,300,781643,SUNDAY,1,0,1.7,54,33.5,1015.1,Snow
1/15/2023 14:00,42,171,143031,123549,213,266580,SUNDAY,1,0,1.7,45,33.5,1015.7,Cloudy
1/15/2023 15:00,25,159,33912,117531,184,151443,SUNDAY,1,0,1.7,45,37.1,1015.7,Cloudy
1/15/2023 16:00,30,118,123761,89451,148,213212,SUNDAY,1,0,2.8,32,22.3,1014.6,Cloudy
1/15/2023 17:00,25,129,23170,94922,154,118092,SUNDAY,1,0,2.2,35,33.5,1014.6,Cloudy
1/15/2023 18:00,12,128,9858,91037,140,100895,SUNDAY,1,0,2.2,35,33.5,1014.6,Cloudy
1/15/2023 19:00,3,87,3337,65566,90,68903,SUNDAY,1,0,-0.6,78,37.1,1014.8,Cloudy
1/15/2023 20:00,10,56,8219,45376,66,53595,SUNDAY,1,0,-1.1,92,25.9,1015.1,Snow
1/15/2023 21:00,2,43,12161,48534,45,60695,SUNDAY,1,0,0,75,29.5,1015.9,Snow
1/15/2023 22:00,7,37,47682,35222,44,82904,SUNDAY,1,0,0,75,29.5,1015.9,Snow
1/15/2023 23:00,8,33,8088,23587,41,31675,SUNDAY,1,0,-0.6,78,35.3,1016.4,Snow
1/16/2023 0:00,4,17,2208,11247,21,13455,MONDAY,0,1,-1.1,88,29.5,1016.2,Cloudy
1/16/2023 1:00,2,12,721,8388,14,9109,MONDAY,0,1,-1.7,89,29.5,1016,Snow
1/16/2023 2:00,3,2,3294,4183,5,7477,MONDAY,0,1,-1.1,85,29.5,1015.3,Snow
1/16/2023 3:00,1,5,896,5357,6,6253,MONDAY,0,1,-1.1,85,25.9,1014.8,Snow
1/16/2023 4:00,2,3,1114,2639,5,3753,MONDAY,0,1,-1.1,85,25.9,1014.8,Snow
1/16/2023 5:00,3,15,1311060,11244,18,1322304,MONDAY,0,1,-1.1,85,27.7,1014.3,Snow
1/16/2023 6:00,2,34,1607,28744,36,30351,MONDAY,0,1,-1.1,85,29.5,1013.3,Snow
1/16/2023 7:00,2,38,597,29392,40,29989,MONDAY,0,1,-0.6,85,29.5,1013,Snow
1/16/2023 8:00,0,36,0,28306,36,28306,MONDAY,0,1,-0.6,85,29.5,1013,Snow
1/16/2023 9:00,2,59,1900,48971,61,50871,MONDAY,0,1,-0.6,85,25.9,1012.2,Snow
1/16/2023 10:00,5,81,3040,52529,86,55569,MONDAY,0,1,-0.6,85,24.1,1011.5,Rain
1/16/2023 11:00,12,106,40227,83477,118,123704,MONDAY,0,1,-0.6,85,24.1,1011.5,Snow
1/16/2023 12:00,10,94,8630,63041,104,71671,MONDAY,0,1,-0.6,89,16.6,1010.7,Snow
1/16/2023 13:00,6,98,3764,64578,104,68342,MONDAY,0,1,-0.6,89,16.6,1010.7,Snow
1/16/2023 14:00,16,123,14812,89002,139,103814,MONDAY,0,1,0.6,85,20.5,1009.5,Snow
1/16/2023 15:00,11,116,8455,81914,127,90369,MONDAY,0,1,0.6,85,20.5,1009.5,Snow
1/16/2023 16:00,28,163,23263,117993,191,141256,MONDAY,0,1,0.6,85,18.4,1008.7,Snow
1/16/2023 17:00,21,187,28713,139062,208,167775,MONDAY,0,1,0,88,20.5,1007.1,Snow
1/16/2023 18:00,11,186,17449,127020,197,144469,MONDAY,0,1,0,88,20.5,1006.1,Snow
1/16/2023 19:00,18,141,24506,98224,159,122730,MONDAY,0,1,0,81,22.3,1005.3,Snow
1/16/2023 20:00,9,100,7407,66307,109,73714,MONDAY,0,1,0,81,24.1,1005.3,Snow
1/16/2023 21:00,10,79,13786,48968,89,62754,MONDAY,0,1,0.6,75,22.3,1005.3,Snow
1/16/2023 22:00,7,44,4843,28317,51,33160,MONDAY,0,1,0.6,75,22.3,1005.4,Snow
1/16/2023 23:00,11,30,9972,14850,41,24822,MONDAY,0,1,0.6,72,22.3,1006,Snow
1/17/2023 0:00,3,18,2420,8810,21,11230,TUESDAY,0,0,0.6,69,20.5,1005.5,Snow
1/17/2023 1:00,2,7,2822,3452,9,6274,TUESDAY,0,0,0.6,69,24.1,1005.4,Snow
1/17/2023 2:00,1,4,539,2097,5,2636,TUESDAY,0,0,0.6,69,24.1,1005.1,Snow
1/17/2023 3:00,1,0,1515,0,1,1515,TUESDAY,0,0,0.6,69,25.9,1005.1,Snow
1/17/2023 4:00,2,2,5321,1093,4,6414,TUESDAY,0,0,0.6,69,20.5,1004.4,Snow
1/17/2023 5:00,4,34,3725,23857,38,27582,TUESDAY,0,0,0,72,20.5,1003.9,Cloudy
1/17/2023 6:00,4,116,4694,72035,120,76729,TUESDAY,0,0,0,72,20.5,1003.9,Cloudy
1/17/2023 7:00,14,306,12011,247996,320,260007,TUESDAY,0,0,0,72,16.6,1004,Cloudy
1/17/2023 8:00,39,587,40216,1013217,626,1053433,TUESDAY,0,0,0,72,16.6,1004,Cloudy
1/17/2023 9:00,22,347,23009,251262,369,274271,TUESDAY,0,0,0.6,72,11.2,1003.7,Cloudy
1/17/2023 10:00,19,188,22626,131069,207,153695,TUESDAY,0,0,0.6,72,11.2,1003.7,Cloudy
1/17/2023 11:00,34,200,30869,145187,234,176056,TUESDAY,0,0,0.6,72,16.6,1004.3,Fair
1/17/2023 12:00,38,236,51476,149964,274,201440,TUESDAY,0,0,1.7,69,14.8,1004.3,Fair
1/17/2023 13:00,28,215,39690,149741,243,189431,TUESDAY,0,0,1.7,69,14.8,1004.3,Fair
1/17/2023 14:00,44,222,73644,190456,266,264100,TUESDAY,0,0,3.3,67,9.4,1004.4,Fair
1/17/2023 15:00,74,314,92030,220144,388,312174,TUESDAY,0,0,3.3,67,9.4,1004.4,Fair
1/17/2023 16:00,58,440,74453,328962,498,403415,TUESDAY,0,0,6.7,58,11.2,1002.6,Fair
1/17/2023 17:00,78,674,83405,1183879,752,1267284,TUESDAY,0,0,7.8,53,13,1002.1,Fair
1/17/2023 18:00,37,400,35147,288152,437,323299,TUESDAY,0,0,9.4,52,18.4,1001.9,Cloudy
1/17/2023 19:00,20,251,19659,171368,271,191027,TUESDAY,0,0,9.4,52,16.6,1001.8,Cloudy
1/17/2023 20:00,25,205,24449,149348,230,173797,TUESDAY,0,0,9.4,52,16.6,1001.8,Cloudy
1/17/2023 21:00,25,146,24487,110521,171,135008,TUESDAY,0,0,9.4,44,18.4,1001.9,Cloudy
1/17/2023 22:00,21,81,27361,53596,102,80957,TUESDAY,0,0,8.3,48,14.8,1002.3,Cloudy
1/17/2023 23:00,5,47,3810,27531,52,31341,TUESDAY,0,0,8.3,48,14.8,1002.3,Cloudy
1/18/2023 0:00,3,33,2714,47493,36,50207,WEDNESDAY,0,0,6.1,65,16.6,1002.2,Cloudy
1/18/2023 1:00,4,6,5938,3458,10,9396,WEDNESDAY,0,0,6.1,57,14.8,1002,Cloudy
1/18/2023 2:00,3,4,6120,1830,7,7950,WEDNESDAY,0,0,6.7,53,16.6,1001.9,Cloudy
1/18/2023 3:00,0,5,0,3310,5,3310,WEDNESDAY,0,0,6.1,51,18.4,1001.7,Cloudy
1/18/2023 4:00,0,5,0,3058,5,3058,WEDNESDAY,0,0,6.1,51,14.8,1001.3,Cloudy
1/18/2023 5:00,4,35,2221,24708,39,26929,WEDNESDAY,0,0,6.1,51,14.8,1001.3,Cloudy
1/18/2023 6:00,9,151,12859,101061,160,113920,WEDNESDAY,0,0,6.1,57,14.8,1001.2,Cloudy
1/18/2023 7:00,26,377,21740,273769,403,295509,WEDNESDAY,0,0,5.6,67,5.4,1000.8,Cloudy
1/18/2023 8:00,49,491,74057,365203,540,439260,WEDNESDAY,0,0,5.6,67,20.5,1001.6,Cloudy
1/18/2023 9:00,18,310,33354,206275,328,239629,WEDNESDAY,0,0,5.6,67,20.5,1001.6,Cloudy
1/18/2023 10:00,27,234,21812,159054,261,180866,WEDNESDAY,0,0,5.6,70,14.8,1002.2,Cloudy
1/18/2023 11:00,28,212,28064,154363,240,182427,WEDNESDAY,0,0,5.6,73,11.2,1002.4,Cloudy
1/18/2023 12:00,44,257,73839,178040,301,251879,WEDNESDAY,0,0,6.7,76,16.6,1003.2,Cloudy
1/18/2023 13:00,61,256,88645,171512,317,260157,WEDNESDAY,0,0,6.7,79,16.6,1004,Cloudy
1/18/2023 14:00,57,272,229267,193823,329,423090,WEDNESDAY,0,0,6.7,79,16.6,1004,Cloudy
1/18/2023 15:00,88,342,956349,240828,430,1197177,WEDNESDAY,0,0,9.4,69,14.8,1003.8,Cloudy
1/18/2023 16:00,93,509,189584,378545,602,568129,WEDNESDAY,0,0,9.4,66,20.5,1003.4,Cloudy
1/18/2023 17:00,93,723,469377,572037,816,1041414,WEDNESDAY,0,0,10,58,20.5,1003.3,Cloudy
1/18/2023 18:00,77,548,83421,425878,625,509299,WEDNESDAY,0,0,10,56,27.7,1003.7,Cloudy
1/18/2023 19:00,46,354,61962,309329,400,371291,WEDNESDAY,0,0,10,56,29.5,1003.7,Cloudy
1/18/2023 20:00,40,255,89564,163979,295,253543,WEDNESDAY,0,0,9.4,56,22.3,1005.2,Cloudy
1/18/2023 21:00,39,139,42320,96731,178,139051,WEDNESDAY,0,0,8.9,56,20.5,1006.3,Cloudy
1/18/2023 22:00,15,108,17891,367042,123,384933,WEDNESDAY,0,0,8.9,56,20.5,1006.3,Fair
1/18/2023 23:00,10,56,8955,32762,66,41717,WEDNESDAY,0,0,8.3,61,20.5,1007.7,Fair
1/19/2023 0:00,10,18,167681,11994,28,179675,THURSDAY,0,0,7.8,60,20.5,1008.9,Fair
1/19/2023 1:00,3,8,6867,5414,11,12281,THURSDAY,0,0,6.7,65,22.3,1010,Fair
1/19/2023 2:00,1,5,329,2569,6,2898,THURSDAY,0,0,6.7,65,22.3,1010,Fair
1/19/2023 3:00,0,4,0,3351,4,3351,THURSDAY,0,0,5.6,70,13,1011.5,Fair
1/19/2023 4:00,5,6,5744,2681,11,8425,THURSDAY,0,0,5.6,70,13,1011.5,Fair
1/19/2023 5:00,8,38,4615,20688,46,25303,THURSDAY,0,0,5,70,14.8,1013.1,Clear
1/19/2023 6:00,16,126,13956,84010,142,97966,THURSDAY,0,0,4.4,73,14.8,1013.1,Clear
1/19/2023 7:00,33,347,29787,485744,380,515531,THURSDAY,0,0,4.4,73,14.8,1013.1,Clear
1/19/2023 8:00,64,675,53365,520721,739,574086,THURSDAY,0,0,3.9,70,16.6,1013.6,Clear
1/19/2023 9:00,46,408,50033,284045,454,334078,THURSDAY,0,0,3.3,73,11.2,1013.9,Clear
1/19/2023 10:00,31,245,35625,178628,276,214253,THURSDAY,0,0,3.3,73,11.2,1013.9,Clear
1/19/2023 11:00,45,252,58845,164811,297,223656,THURSDAY,0,0,3.3,70,14.8,1015.5,Fair
1/19/2023 12:00,38,274,69323,212270,312,281593,THURSDAY,0,0,3.3,70,14.8,1015.5,Fair
1/19/2023 13:00,51,263,321695,166323,314,488018,THURSDAY,0,0,3.3,64,20.5,1016.8,Fair
1/19/2023 14:00,46,219,45060,197886,265,242946,THURSDAY,0,0,3.3,62,13,1016.8,Cloudy
1/19/2023 15:00,27,155,191753,116984,182,308737,THURSDAY,0,0,3.9,62,7.6,1016.4,Cloudy
1/19/2023 16:00,17,212,165990,153682,229,319672,THURSDAY,0,0,3.9,62,7.6,1016.4,Cloudy
1/19/2023 17:00,34,292,36349,232078,326,268427,THURSDAY,0,0,4.4,60,0,1014.4,Cloudy
1/19/2023 18:00,29,260,29445,177104,289,206549,THURSDAY,0,0,3.9,67,7.6,1014.2,Cloudy
1/19/2023 19:00,19,186,9699,124613,205,134312,THURSDAY,0,0,3.3,73,9.4,1014.2,Cloudy
1/19/2023 20:00,19,120,16044,75458,139,91502,THURSDAY,0,0,3.3,73,9.4,1014.2,Rain
1/19/2023 21:00,10,84,14189,55193,94,69382,THURSDAY,0,0,2.8,78,7.6,1014.1,Rain
1/19/2023 22:00,8,37,6012,23534,45,29546,THURSDAY,0,0,2.2,85,13,1013.6,Rain
1/19/2023 23:00,5,15,1818,8826,20,10644,THURSDAY,0,0,2.2,89,14.8,1012.7,Rain
1/20/2023 0:00,1,15,382,10057,16,10439,FRIDAY,0,0,2.8,89,20.5,1011.5,Rain
1/20/2023 1:00,1,9,717,8023,10,8740,FRIDAY,0,0,2.8,96,18.4,1009.1,Rain
1/20/2023 2:00,1,7,1361,5823,8,7184,FRIDAY,0,0,2.8,96,18.4,1009.1,Rain
1/20/2023 3:00,0,1,0,424,1,424,FRIDAY,0,0,3.9,96,22.3,1006.5,Rain
1/20/2023 4:00,3,8,1555,7125,11,8680,FRIDAY,0,0,3.9,96,22.3,1006.5,Rain
1/20/2023 5:00,2,24,1203,16776,26,17979,FRIDAY,0,0,3.3,97,29.5,1003.8,Rain
1/20/2023 6:00,4,67,1856,44320,71,46176,FRIDAY,0,0,2.2,97,22.3,1004.4,Rain
1/20/2023 7:00,19,155,16048,117797,174,133845,FRIDAY,0,0,2.2,97,18.4,1000.3,Rain
1/20/2023 8:00,25,315,21446,224552,340,245998,FRIDAY,0,0,2.2,97,16.6,1002.1,Rain
1/20/2023 9:00,23,263,18656,186705,286,205361,FRIDAY,0,0,1.7,96,14.8,1001.8,Rain
1/20/2023 10:00,15,149,15692,102762,164,118454,FRIDAY,0,0,2.2,97,11.2,1002.1,Rain
1/20/2023 11:00,21,131,81431,879989,152,961420,FRIDAY,0,0,2.2,97,11.2,1002.1,Rain
1/20/2023 12:00,6,133,12785,79558,139,92343,FRIDAY,0,0,1.1,100,14.8,1002.3,Rain
1/20/2023 13:00,12,118,10637,79252,130,89889,FRIDAY,0,0,1.1,97,14.8,1002.7,Rain
1/20/2023 14:00,16,123,19003,86141,139,105144,FRIDAY,0,0,1.1,100,18.4,1002.8,Rain
1/20/2023 15:00,23,175,32738,116926,198,149664,FRIDAY,0,0,1.1,100,14.8,1002.7,Rain
1/20/2023 16:00,29,236,302296,169691,265,471987,FRIDAY,0,0,1.1,100,14.8,1002.7,Snow
1/20/2023 17:00,34,310,49010,249465,344,298475,FRIDAY,0,0,1.1,97,14.8,1002.9,Snow
1/20/2023 18:00,19,260,12487,194547,279,207034,FRIDAY,0,0,1.1,97,14.8,1002.9,Snow
1/20/2023 19:00,20,193,18132,141849,213,159981,FRIDAY,0,0,1.1,92,13,1004.5,Snow
1/20/2023 20:00,28,114,1171769,76339,142,1248108,FRIDAY,0,0,1.1,92,13,1004.5,Snow
1/20/2023 21:00,15,105,11345,83815,120,95160,FRIDAY,0,0,0.6,92,14.8,1005.6,Snow
1/20/2023 22:00,18,70,17477,56159,88,73636,FRIDAY,0,0,0.6,92,13,1006.6,Snow
1/20/2023 23:00,24,59,26848,50189,83,77037,FRIDAY,0,0,0.6,92,11.2,1007.6,Snow
1/21/2023 0:00,21,51,18067,37710,72,55777,SATURDAY,1,0,0.6,92,16.6,1008.6,Snow
1/21/2023 1:00,42,50,1073549,39605,92,1113154,SATURDAY,1,0,0.6,88,16.6,1009.4,Snow
1/21/2023 2:00,17,31,18780,27157,48,45937,SATURDAY,1,0,0,92,16.6,1010.3,Snow
1/21/2023 3:00,2,5,3040,2553,7,5593,SATURDAY,1,0,0,88,11.2,1011.4,Snow
1/21/2023 4:00,1,6,380,3357,7,3737,SATURDAY,1,0,0,88,14.8,1011.9,Snow
1/21/2023 5:00,0,11,0,7509,11,7509,SATURDAY,1,0,-0.6,89,13,1012.5,Cloudy
1/21/2023 6:00,6,36,3470,12582,42,16052,SATURDAY,1,0,-0.6,89,13,1012.5,Snow
1/21/2023 7:00,5,50,4455,21991,55,26446,SATURDAY,1,0,-0.6,85,14.8,1013.8,Snow
1/21/2023 8:00,14,87,12094,59965,101,72059,SATURDAY,1,0,-1.1,85,16.6,1014.5,Cloudy
1/21/2023 9:00,23,178,25839,130007,201,155846,SATURDAY,1,0,-1.1,88,13,1015.2,Cloudy
1/21/2023 10:00,50,219,92950,174286,269,267236,SATURDAY,1,0,-1.1,85,11.2,1016.1,Cloudy
1/21/2023 11:00,60,249,85926,158449,309,244375,SATURDAY,1,0,-1.1,85,11.2,1016.1,Cloudy
1/21/2023 12:00,57,280,83349,196067,337,279416,SATURDAY,1,0,-1.1,81,11.2,1018.5,Cloudy
1/21/2023 13:00,69,249,536799,179249,318,716048,SATURDAY,1,0,-0.6,78,9.4,1019.4,Cloudy
1/21/2023 14:00,81,302,201047,211873,383,412920,SATURDAY,1,0,-0.6,78,9.4,1019.4,Cloudy
1/21/2023 15:00,87,293,189984,223234,380,413218,SATURDAY,1,0,-0.6,78,11.2,1020,Cloudy
1/21/2023 16:00,91,257,156808,190978,348,347786,SATURDAY,1,0,0,79,7.6,1020.1,Cloudy
1/21/2023 17:00,54,232,147882,186420,286,334302,SATURDAY,1,0,0,81,7.6,1019.9,Cloudy
1/21/2023 18:00,47,241,50984,172437,288,223421,SATURDAY,1,0,0,75,14.8,1020,Cloudy
1/21/2023 19:00,45,174,57759,189380,219,247139,SATURDAY,1,0,0,72,18.4,1020.3,Cloudy
1/21/2023 20:00,24,161,41506,103671,185,145177,SATURDAY,1,0,0,72,18.4,1020.3,Cloudy
1/21/2023 21:00,47,92,127963,72233,139,200196,SATURDAY,1,0,-0.6,69,18.4,1021.6,Fair
1/21/2023 22:00,25,77,20977,49247,102,70224,SATURDAY,1,0,-0.6,69,18.4,1021.6,Fair
1/21/2023 23:00,32,65,24943,44607,97,69550,SATURDAY,1,0,-1.1,69,14.8,1022.1,Fair
1/22/2023 0:00,23,51,175119,38954,74,214073,SUNDAY,1,0,-1.1,66,18.4,1023.3,Fair
1/22/2023 1:00,67,45,365515,37647,112,403162,SUNDAY,1,0,-1.1,66,18.4,1023.3,Fair
1/22/2023 2:00,34,19,297107,15391,53,312498,SUNDAY,1,0,-1.7,72,14.8,1023.5,Fair
1/22/2023 3:00,1,18,470,8410,19,8880,SUNDAY,1,0,-1.7,72,13,1023.4,Fair
1/22/2023 4:00,3,12,3072,10182,15,13254,SUNDAY,1,0,-1.7,72,13,1023.4,Clear
1/22/2023 5:00,3,15,6017,42529,18,48546,SUNDAY,1,0,-1.7,69,18.4,1023.1,Clear
1/22/2023 6:00,1,24,271813,10790,25,282603,SUNDAY,1,0,-1.7,69,18.4,1023.1,Clear
1/22/2023 7:00,9,41,7797,26215,50,34012,SUNDAY,1,0,-1.7,69,13,1023.5,Clear
1/22/2023 8:00,13,76,13372,51688,89,65060,SUNDAY,1,0,-1.7,72,14.8,1024,Clear
1/22/2023 9:00,35,126,26103,795519,161,821622,SUNDAY,1,0,-1.7,72,13,1023.7,Clear
1/22/2023 10:00,46,216,59501,154480,262,213981,SUNDAY,1,0,-1.7,72,16.6,1023.8,Clear
1/22/2023 11:00,79,216,109241,160746,295,269987,SUNDAY,1,0,-1.7,72,16.6,1023.8,Fair
1/22/2023 12:00,64,282,217116,212552,346,429668,SUNDAY,1,0,-1.1,72,18.4,1023.6,Fair
1/22/2023 13:00,55,281,66060,209623,336,275683,SUNDAY,1,0,-1.1,72,18.4,1023.9,Fair
1/22/2023 14:00,90,328,102422,240345,418,342767,SUNDAY,1,0,-0.6,72,9.4,1023.8,Cloudy
1/22/2023 15:00,63,280,74338,204347,343,278685,SUNDAY,1,0,-0.6,72,9.4,1023.8,Cloudy
1/22/2023 16:00,53,229,181659,159477,282,341136,SUNDAY,1,0,0.6,72,7.6,1023,Cloudy
1/22/2023 17:00,36,222,91263,162043,258,253306,SUNDAY,1,0,1.1,73,11.2,1020.9,Cloudy
1/22/2023 18:00,22,132,22782,89280,154,112062,SUNDAY,1,0,1.1,73,13,1020.1,Cloudy
1/22/2023 19:00,14,111,13544,80517,125,94061,SUNDAY,1,0,1.7,72,16.6,1019.9,Cloudy
1/22/2023 20:00,2,58,1122,33817,60,34939,SUNDAY,1,0,1.7,72,16.6,1019.9,Cloudy
1/22/2023 21:00,6,42,6970,21743,48,28713,SUNDAY,1,0,1.1,82,9.4,1019.2,Cloudy
1/22/2023 22:00,3,37,8174,20584,40,28758,SUNDAY,1,0,1.1,82,9.4,1019.2,Cloudy
1/22/2023 23:00,5,19,4741,10939,24,15680,SUNDAY,1,0,1.1,88,5.4,1018.3,Rain
1/23/2023 0:00,2,12,1130,6820,14,7950,MONDAY,0,0,1.1,92,9.4,1016.6,Rain
1/23/2023 1:00,1,3,2353,2204,4,4557,MONDAY,0,0,2.2,97,5.4,1015.3,Rain
1/23/2023 2:00,1,0,981,0,1,981,MONDAY,0,0,2.8,93,11.2,1015.2,Rain
1/23/2023 3:00,0,3,0,1571,3,1571,MONDAY,0,0,2.2,97,11.2,1014.1,Rain
1/23/2023 4:00,1,3,468,1048,4,1516,MONDAY,0,0,1.7,100,16.6,1010.7,Rain
1/23/2023 5:00,1,19,211,13912,20,14123,MONDAY,0,0,1.7,100,16.6,1010.7,Rain
1/23/2023 6:00,4,61,4941,36513,65,41454,MONDAY,0,0,1.7,96,20.5,1009.5,Rain
1/23/2023 7:00,18,168,16175,111890,186,128065,MONDAY,0,0,2.2,97,25.9,1006.1,Rain
1/23/2023 8:00,25,365,17546,246175,390,263721,MONDAY,0,0,2.2,97,25.9,1004,Rain
1/23/2023 9:00,22,232,18164,151801,254,169965,MONDAY,0,0,2.2,97,31.7,1001.6,Rain
1/23/2023 10:00,23,170,22008,107925,193,129933,MONDAY,0,0,2.2,97,37.1,1001.6,Rain
1/23/2023 11:00,7,146,97183,87273,153,184456,MONDAY,0,0,2.2,97,29.5,1000.4,Rain
1/23/2023 12:00,6,103,2800,73806,109,76606,MONDAY,0,0,2.2,92,22.3,999.7,Rain
1/23/2023 13:00,16,75,17893,50605,91,68498,MONDAY,0,0,2.2,92,20.5,999.8,Cloudy
1/23/2023 14:00,3,58,18644,52874,61,71518,MONDAY,0,0,1.7,96,20.5,1000.1,Rain
1/23/2023 15:00,8,71,9171,64424,79,73595,MONDAY,0,0,1.7,96,22.3,1000.1,Rain
1/23/2023 16:00,7,99,11488,85102,106,96590,MONDAY,0,0,1.1,88,27.7,997.5,Rain
1/23/2023 17:00,9,144,7264,117223,153,124487,MONDAY,0,0,1.1,88,18.4,996.1,Snow
1/23/2023 18:00,11,123,13088,125759,134,138847,MONDAY,0,0,0.6,92,16.6,997,Snow
1/23/2023 19:00,1,97,442,73312,98,73754,MONDAY,0,0,0,96,20.5,997.8,Snow
1/23/2023 20:00,8,93,1102808,69892,101,1172700,MONDAY,0,0,0,96,20.5,997.8,Snow
1/23/2023 21:00,2,79,1346,48188,81,49534,MONDAY,0,0,0.6,96,24.1,998.6,Snow
1/23/2023 22:00,5,60,6257,40445,65,46702,MONDAY,0,0,1.1,92,20.5,999.5,Snow
1/23/2023 23:00,3,28,2947,21779,31,24726,MONDAY,0,0,0.6,88,25.9,1002.1,Snow
1/24/2023 0:00,2,7,1770,3150,9,4920,TUESDAY,0,0,0.6,88,37.1,1002.1,Snow
1/24/2023 1:00,1,3,451,1686,4,2137,TUESDAY,0,0,0.6,88,25.9,1003.3,Snow
1/24/2023 2:00,3,4,3145,1390,7,4535,TUESDAY,0,0,0.6,75,27.7,1006.1,Snow
1/24/2023 3:00,0,3,0,1511,3,1511,TUESDAY,0,0,0,79,25.9,1006.1,Cloudy
1/24/2023 4:00,0,5,0,3772,5,3772,TUESDAY,0,0,0,75,31.7,1007.6,Cloudy
1/24/2023 5:00,2,34,694,25457,36,26151,TUESDAY,0,0,-0.6,78,27.7,1009.5,Fair
1/24/2023 6:00,6,105,2773,70905,111,73678,TUESDAY,0,0,-0.6,78,31.7,1009.5,Fair
1/24/2023 7:00,13,229,10283,179260,242,189543,TUESDAY,0,0,0,72,25.9,1011.2,Fair
1/24/2023 8:00,25,429,23786,360793,454,384579,TUESDAY,0,0,-0.6,76,25.9,1011.7,Clear
1/24/2023 9:00,30,308,35578,241753,338,277331,TUESDAY,0,0,-0.6,72,18.4,1012,Fair
1/24/2023 10:00,20,188,33116,157221,208,190337,TUESDAY,0,0,-0.6,72,18.4,1012,Clear
1/24/2023 11:00,25,196,34537,150501,221,185038,TUESDAY,0,0,-0.6,78,18.4,1013.5,Fair
1/24/2023 12:00,19,190,17081,127719,209,144800,TUESDAY,0,0,0,81,18.4,1014.1,Cloudy
1/24/2023 13:00,26,211,25058,180716,237,205774,TUESDAY,0,0,0.6,82,18.4,1014.6,Fair
1/24/2023 14:00,26,186,1299280,133797,212,1433077,TUESDAY,0,0,1.1,82,22.3,1015.2,Cloudy
1/24/2023 15:00,26,280,52353,198660,306,251013,TUESDAY,0,0,1.1,82,22.3,1015.2,Cloudy
1/24/2023 16:00,49,398,63341,306192,447,369533,TUESDAY,0,0,2.8,72,20.5,1014.8,Cloudy
1/24/2023 17:00,44,551,46807,451452,595,498259,TUESDAY,0,0,2.8,70,25.9,1014.9,Cloudy
1/24/2023 18:00,42,468,34166,327230,510,361396,TUESDAY,0,0,2.8,70,25.9,1014.9,Cloudy
1/24/2023 19:00,34,306,33067,200930,340,233997,TUESDAY,0,0,3.3,67,20.5,1016.5,Cloudy
1/24/2023 20:00,15,203,11387,146080,218,157467,TUESDAY,0,0,3.3,67,27.7,1016.5,Cloudy
1/24/2023 21:00,22,153,16541,98719,175,115260,TUESDAY,0,0,3.3,67,18.4,1018.4,Cloudy
1/24/2023 22:00,9,92,8177,58221,101,66398,TUESDAY,0,0,3.3,67,18.4,1018.4,Fair
1/24/2023 23:00,15,37,52694,18959,52,71653,TUESDAY,0,0,2.8,70,25.9,1019.2,Fair
1/25/2023 0:00,6,30,7875,18483,36,26358,WEDNESDAY,0,0,2.2,73,24.1,1019.7,Fair
1/25/2023 1:00,5,7,8221,3805,12,12026,WEDNESDAY,0,0,2.2,73,24.1,1020.6,Fair
1/25/2023 2:00,2,5,1330,2659,7,3989,WEDNESDAY,0,0,2.2,73,25.9,1021.5,Fair
1/25/2023 3:00,1,2,366,3001,3,3367,WEDNESDAY,0,0,2.8,70,18.4,1022.3,Fair
1/25/2023 4:00,2,6,3939,2426,8,6365,WEDNESDAY,0,0,1.1,79,16.6,1022.7,Fair
1/25/2023 5:00,4,40,1695,32831,44,34526,WEDNESDAY,0,0,1.1,75,14.8,1023,Fair
1/25/2023 6:00,9,98,6721,76484,107,83205,WEDNESDAY,0,0,1.1,75,14.8,1023,Fair
1/25/2023 7:00,42,333,30024,240662,375,270686,WEDNESDAY,0,0,1.1,75,14.8,1024.1,Fair
1/25/2023 8:00,64,701,73690,520603,765,594293,WEDNESDAY,0,0,1.1,73,14.8,1024.3,Fair
1/25/2023 9:00,25,390,23889,249819,415,273708,WEDNESDAY,0,0,1.1,73,13,1025.2,Fair
1/25/2023 10:00,25,249,26455,174458,274,200913,WEDNESDAY,0,0,1.1,73,13,1025.2,Clear
1/25/2023 11:00,36,237,38327,166520,273,204847,WEDNESDAY,0,0,1.1,73,16.6,1026.7,Cloudy
1/25/2023 12:00,35,241,40687,247817,276,288504,WEDNESDAY,0,0,1.1,73,11.2,1027.2,Cloudy
1/25/2023 13:00,26,225,91426,145782,251,237208,WEDNESDAY,0,0,1.1,73,13,1027.2,Cloudy
1/25/2023 14:00,31,252,34980,190296,283,225276,WEDNESDAY,0,0,1.7,72,5.4,1026.5,Cloudy
1/25/2023 15:00,41,277,38857,192660,318,231517,WEDNESDAY,0,0,1.7,72,5.4,1026.5,Cloudy
1/25/2023 16:00,57,468,48429,321692,525,370121,WEDNESDAY,0,0,2.2,75,5.4,1025.7,Cloudy
1/25/2023 17:00,43,477,260173,358604,520,618777,WEDNESDAY,0,0,2.2,79,7.6,1026,Cloudy
1/25/2023 18:00,33,358,23070,258184,391,281254,WEDNESDAY,0,0,2.2,82,5.4,1025.5,Cloudy
1/25/2023 19:00,23,242,18373,149064,265,167437,WEDNESDAY,0,0,2.2,75,7.6,1024.9,Cloudy
1/25/2023 20:00,10,142,6540,92943,152,99483,WEDNESDAY,0,0,2.2,75,7.6,1024.9,Snow
1/25/2023 21:00,5,66,3154,50201,71,53355,WEDNESDAY,0,0,2.2,79,11.2,1023.9,Snow
1/25/2023 22:00,2,44,1462,59883,46,61345,WEDNESDAY,0,0,2.8,72,18.4,1022.7,Rain
1/25/2023 23:00,4,29,2221,14772,33,16993,WEDNESDAY,0,0,2.2,79,29.5,1020.4,Rain
1/26/2023 0:00,1,11,6490,7439,12,13929,THURSDAY,0,0,1.7,85,20.5,1019.9,Rain
1/26/2023 1:00,0,5,0,2386,5,2386,THURSDAY,0,0,1.7,92,22.3,1017.7,Rain
1/26/2023 2:00,2,3,3648,1675,5,5323,THURSDAY,0,0,2.8,93,22.3,1015.5,Rain
1/26/2023 3:00,0,1,0,642,1,642,THURSDAY,0,0,3.9,96,33.5,1012.6,Rain
1/26/2023 4:00,2,4,624,1735,6,2359,THURSDAY,0,0,5.6,96,20.5,1006.2,Rain
1/26/2023 5:00,2,28,724,17993,30,18717,THURSDAY,0,0,5.6,96,20.5,1006.2,Rain
1/26/2023 6:00,5,75,3414,48079,80,51493,THURSDAY,0,0,8.9,100,18.4,1000.1,Rain
1/26/2023 7:00,23,225,295572,157296,248,452868,THURSDAY,0,0,12.2,93,18.4,997.6,Rain
1/26/2023 8:00,67,600,58932,429692,667,488624,THURSDAY,0,0,12.2,93,42.5,997.6,Rain
1/26/2023 9:00,42,415,40446,269838,457,310284,THURSDAY,0,0,11.7,93,25.9,995.5,Rain
1/26/2023 10:00,26,250,32648,212468,276,245116,THURSDAY,0,0,11.7,93,22.3,993.1,Rain
1/26/2023 11:00,28,236,25111,172544,264,197655,THURSDAY,0,0,11.1,100,14.8,992.5,Rain
1/26/2023 12:00,31,255,83080,161639,286,244719,THURSDAY,0,0,8.9,89,16.6,992.6,Rain
1/26/2023 13:00,38,208,34914,138365,246,173279,THURSDAY,0,0,8.9,89,16.6,992.6,Rain
1/26/2023 14:00,31,229,29219,162107,260,191326,THURSDAY,0,0,7.2,90,18.4,993.2,Rain
1/26/2023 15:00,50,284,217050,206809,334,423859,THURSDAY,0,0,8.3,86,29.5,994.3,Cloudy
1/26/2023 16:00,60,458,314734,392830,518,707564,THURSDAY,0,0,8.3,83,37.1,994.8,Cloudy
1/26/2023 17:00,99,619,142912,485395,718,628307,THURSDAY,0,0,7.8,73,35.3,995.4,Cloudy
1/26/2023 18:00,64,523,83059,1132257,587,1215316,THURSDAY,0,0,6.7,70,25.9,996.8,Cloudy
1/26/2023 19:00,42,336,192005,388055,378,580060,THURSDAY,0,0,6.7,70,35.3,996.8,Cloudy
1/26/2023 20:00,34,215,29178,148312,249,177490,THURSDAY,0,0,6.7,62,35.3,998.1,Cloudy
1/26/2023 21:00,58,188,60236,127361,246,187597,THURSDAY,0,0,6.1,55,27.7,1000.9,Cloudy
1/26/2023 22:00,58,143,206470,99093,201,305563,THURSDAY,0,0,5.6,49,31.7,1002.4,Cloudy
1/26/2023 23:00,18,75,670283,52751,93,723034,THURSDAY,0,0,4.4,51,31.7,1003.9,Cloudy
1/27/2023 0:00,19,41,18225,26489,60,44714,FRIDAY,0,0,4.4,51,31.7,1003.9,Cloudy
1/27/2023 1:00,8,15,10379,8912,23,19291,FRIDAY,0,0,3.3,55,38.9,1006.3,Cloudy
1/27/2023 2:00,4,6,2851,2882,10,5733,FRIDAY,0,0,2.8,57,37.1,1007.6,Cloudy
1/27/2023 3:00,2,6,1419,6168,8,7587,FRIDAY,0,0,2.2,59,27.7,1008.7,Fair
1/27/2023 4:00,2,6,1944,3314,8,5258,FRIDAY,0,0,2.2,59,27.7,1008.7,Fair
1/27/2023 5:00,3,35,1105,18074,38,19179,FRIDAY,0,0,1.7,58,24.1,1010.5,Fair
1/27/2023 6:00,6,81,2892,48261,87,51153,FRIDAY,0,0,1.1,56,24.1,1012,Fair
1/27/2023 7:00,22,280,25549,242595,302,268144,FRIDAY,0,0,0.6,56,14.8,1013,Fair
1/27/2023 8:00,30,449,27384,340575,479,367959,FRIDAY,0,0,0.6,56,18.4,1013.7,Fair
1/27/2023 9:00,42,377,356306,271131,419,627437,FRIDAY,0,0,0.6,56,18.4,1013.7,Fair
1/27/2023 10:00,41,229,44543,150067,270,194610,FRIDAY,0,0,0,54,18.4,1015.3,Fair
1/27/2023 11:00,60,269,91752,231696,329,323448,FRIDAY,0,0,-0.6,56,14.8,1016.3,Fair
1/27/2023 12:00,59,301,91931,206313,360,298244,FRIDAY,0,0,0,56,9.4,1017.4,Fair
1/27/2023 13:00,68,263,108426,183955,331,292381,FRIDAY,0,0,1.1,54,13,1018.3,Fair
1/27/2023 14:00,53,288,252131,224376,341,476507,FRIDAY,0,0,1.1,54,13,1018.3,Fair
1/27/2023 15:00,68,367,82798,336947,435,419745,FRIDAY,0,0,2.8,50,7.6,1018.9,Fair
1/27/2023 16:00,94,450,477390,359630,544,837020,FRIDAY,0,0,3.3,48,11.2,1018.5,Fair
1/27/2023 17:00,96,518,115150,399826,614,514976,FRIDAY,0,0,4.4,46,11.2,1017.6,Fair
1/27/2023 18:00,76,409,84982,287547,485,372529,FRIDAY,0,0,5,46,13,1018,Fair
1/27/2023 19:00,62,277,276539,204083,339,480622,FRIDAY,0,0,5,46,13,1018,Fair
1/27/2023 20:00,44,170,56193,121556,214,177749,FRIDAY,0,0,5,41,13,1019.3,Fair
1/27/2023 21:00,67,166,91681,118601,233,210282,FRIDAY,0,0,3.9,44,9.4,1020,Fair
1/27/2023 22:00,35,124,51962,88353,159,140315,FRIDAY,0,0,2.2,67,14.8,1021,Fair
1/27/2023 23:00,33,76,84422,49418,109,133840,FRIDAY,0,0,1.7,69,9.4,1021.4,Fair
1/28/2023 0:00,47,71,46487,55571,118,102058,SATURDAY,1,0,1.7,69,9.4,1021.4,Fair
1/28/2023 1:00,44,61,1114120,82430,105,1196550,SATURDAY,1,0,1.1,73,7.6,1021.6,Fair
1/28/2023 2:00,30,16,32528,15796,46,48324,SATURDAY,1,0,1.7,69,7.6,1021.9,Fair
1/28/2023 3:00,4,10,3067,7931,14,10998,SATURDAY,1,0,0,75,11.2,1022.1,Fair
1/28/2023 4:00,3,9,1003,8476,12,9479,SATURDAY,1,0,0,75,11.2,1022.1,Cloudy
1/28/2023 5:00,2,22,1337,15538,24,16875,SATURDAY,1,0,-0.6,82,11.2,1021.4,Cloudy
1/28/2023 6:00,4,36,6338,14396,40,20734,SATURDAY,1,0,-0.6,82,11.2,1021.4,Cloudy
1/28/2023 7:00,12,54,6525,36500,66,43025,SATURDAY,1,0,0,81,11.2,1021.8,Fair
1/28/2023 8:00,19,115,30090,88101,134,118191,SATURDAY,1,0,0,79,18.4,1021.7,Fair
1/28/2023 9:00,46,184,53539,932154,230,985693,SATURDAY,1,0,0,79,18.4,1021.7,Fair
1/28/2023 10:00,81,256,118426,204098,337,322524,SATURDAY,1,0,1.1,73,20.5,1021.6,Fair
1/28/2023 11:00,119,353,176030,272414,472,448444,SATURDAY,1,0,2.2,64,20.5,1021.4,Fair
1/28/2023 12:00,165,371,291290,497980,536,789270,SATURDAY,1,0,2.2,64,20.5,1021.4,Fair
1/28/2023 13:00,186,364,383811,325597,550,709408,SATURDAY,1,0,3.9,62,22.3,1021.2,Cloudy
1/28/2023 14:00,224,393,502140,352319,617,854459,SATURDAY,1,0,5.6,57,24.1,1021.5,Fair
1/28/2023 15:00,277,409,773254,374002,686,1147256,SATURDAY,1,0,5.6,57,24.1,1021.5,Fair
1/28/2023 16:00,212,381,407663,387941,593,795604,SATURDAY,1,0,8.9,44,20.5,1020.8,Fair
1/28/2023 17:00,97,339,814656,506600,436,1321256,SATURDAY,1,0,9.4,38,29.5,1020.5,Fair
1/28/2023 18:00,103,293,122463,224792,396,347255,SATURDAY,1,0,9.4,38,29.5,1020.5,Fair
1/28/2023 19:00,87,237,155983,165434,324,321417,SATURDAY,1,0,9.4,36,24.1,1021.2,Fair
1/28/2023 20:00,67,177,66929,135888,244,202817,SATURDAY,1,0,8.9,37,18.4,1021.9,Cloudy
1/28/2023 21:00,98,127,170647,94674,225,265321,SATURDAY,1,0,8.9,35,16.6,1022.8,Cloudy
1/28/2023 22:00,74,125,789287,98781,199,888068,SATURDAY,1,0,8.3,37,20.5,1023.8,Cloudy
1/28/2023 23:00,61,102,68730,112370,163,181100,SATURDAY,1,0,7.8,40,13,1024.4,Cloudy
1/29/2023 0:00,74,75,248264,53126,149,301390,SUNDAY,1,0,7.8,40,13,1024.4,Cloudy
1/29/2023 1:00,120,64,144753,57272,184,202025,SUNDAY,1,0,6.7,47,13,1025.7,Cloudy
1/29/2023 2:00,52,44,906026,37626,96,943652,SUNDAY,1,0,6.1,49,14.8,1026.1,Cloudy
1/29/2023 3:00,10,20,27251,13982,30,41233,SUNDAY,1,0,5,55,13,1026.1,Cloudy
1/29/2023 4:00,0,7,0,4458,7,4458,SUNDAY,1,0,5,55,13,1026.1,Cloudy
1/29/2023 5:00,3,22,6859,14251,25,21110,SUNDAY,1,0,3.9,57,0,1026.6,Cloudy
1/29/2023 6:00,6,32,4115,19375,38,23490,SUNDAY,1,0,3.9,59,5.4,1027.1,Cloudy
1/29/2023 7:00,10,70,7909,39908,80,47817,SUNDAY,1,0,3.3,67,0,1027.4,Cloudy
1/29/2023 8:00,24,89,24678,60269,113,84947,SUNDAY,1,0,2.2,73,5.4,1027.6,Cloudy
1/29/2023 9:00,49,201,131414,146795,250,278209,SUNDAY,1,0,2.2,73,5.4,1027.6,Cloudy
1/29/2023 10:00,89,287,115739,207374,376,323113,SUNDAY,1,0,2.8,78,5.4,1027.3,Cloudy
1/29/2023 11:00,120,301,213294,252466,421,465760,SUNDAY,1,0,2.2,85,0,1027.7,Cloudy
1/29/2023 12:00,140,361,633717,304491,501,938208,SUNDAY,1,0,2.8,82,7.6,1027.4,Cloudy
1/29/2023 13:00,148,408,243198,332663,556,575861,SUNDAY,1,0,3.3,83,13,1026.7,Cloudy
1/29/2023 14:00,159,354,350594,269531,513,620125,SUNDAY,1,0,3.3,83,13,1026.7,Cloudy
1/29/2023 15:00,115,364,821482,296856,479,1118338,SUNDAY,1,0,8.3,74,13,1024.7,Cloudy
1/29/2023 16:00,83,335,99027,233909,418,332936,SUNDAY,1,0,9.4,63,20.5,1023.1,Cloudy
1/29/2023 17:00,73,292,75673,231538,365,307211,SUNDAY,1,0,9.4,63,20.5,1023.1,Cloudy
1/29/2023 18:00,70,270,540771,210414,340,751185,SUNDAY,1,0,10,54,20.5,1021.6,Cloudy
1/29/2023 19:00,55,226,61967,150839,281,212806,SUNDAY,1,0,10,61,24.1,1019.6,Cloudy
1/29/2023 20:00,35,142,25731,171024,177,196755,SUNDAY,1,0,10,61,20.5,1019.1,Cloudy
1/29/2023 21:00,26,126,40335,83805,152,124140,SUNDAY,1,0,8.9,71,20.5,1019.2,Cloudy
1/29/2023 22:00,32,106,40707,65296,138,106003,SUNDAY,1,0,9.4,63,22.3,1018.7,Cloudy
1/29/2023 23:00,20,48,16757,29506,68,46263,SUNDAY,1,0,9.4,63,20.5,1018.4,Cloudy
1/30/2023 0:00,16,23,16516,14617,39,31133,MONDAY,0,0,9.4,63,20.5,1018.4,Cloudy
1/30/2023 1:00,5,15,5688,6499,20,12187,MONDAY,0,0,7.2,68,16.6,1017.8,Cloudy
1/30/2023 2:00,3,9,63936,7201,12,71137,MONDAY,0,0,7.8,63,20.5,1018.1,Cloudy
1/30/2023 3:00,3,6,3587,3535,9,7122,MONDAY,0,0,8.3,58,22.3,1018.2,Cloudy
1/30/2023 4:00,3,9,3345,5319,12,8664,MONDAY,0,0,8.3,58,22.3,1018.2,Cloudy
1/30/2023 5:00,6,47,3404,31136,53,34540,MONDAY,0,0,7.2,63,18.4,1018.3,Cloudy
1/30/2023 6:00,3,134,3223,85036,137,88259,MONDAY,0,0,5.6,70,13,1018.8,Cloudy
1/30/2023 7:00,25,332,21649,240764,357,262413,MONDAY,0,0,5.6,70,14.8,1019.2,Cloudy
1/30/2023 8:00,48,628,40774,458768,676,499542,MONDAY,0,0,5,73,11.2,1019.4,Cloudy
1/30/2023 9:00,31,391,35676,343500,422,379176,MONDAY,0,0,5,73,11.2,1019.7,Cloudy
1/30/2023 10:00,38,263,42640,177314,301,219954,MONDAY,0,0,5,73,11.2,1019.7,Cloudy
1/30/2023 11:00,49,260,63313,191671,309,254984,MONDAY,0,0,4.4,73,7.6,1021.4,Cloudy
1/30/2023 12:00,46,277,58156,182341,323,240497,MONDAY,0,0,3.9,79,13,1021.6,Cloudy
1/30/2023 13:00,69,305,90319,204623,374,294942,MONDAY,0,0,6.1,68,16.6,1021.9,Cloudy
1/30/2023 14:00,53,297,66620,199458,350,266078,MONDAY,0,0,6.1,68,16.6,1021.9,Cloudy
1/30/2023 15:00,57,325,436570,373887,382,810457,MONDAY,0,0,7.2,65,0,1022.5,Cloudy
1/30/2023 16:00,100,503,119009,375734,603,494743,MONDAY,0,0,7.2,65,14.8,1021.1,Cloudy
1/30/2023 17:00,76,684,77827,504977,760,582804,MONDAY,0,0,6.7,70,14.8,1020,Cloudy
1/30/2023 18:00,54,517,54551,354228,571,408779,MONDAY,0,0,6.7,70,14.8,1020,Cloudy
1/30/2023 19:00,41,380,94846,248076,421,342922,MONDAY,0,0,5.6,79,14.8,1019.2,Cloudy
1/30/2023 20:00,39,248,44076,172253,287,216329,MONDAY,0,0,5.6,79,14.8,1019.2,Cloudy
1/30/2023 21:00,21,179,78951,290055,200,369006,MONDAY,0,0,5,86,9.4,1019.4,Cloudy
1/30/2023 22:00,19,104,30086,72812,123,102898,MONDAY,0,0,5,89,5.4,1019.1,Cloudy
1/30/2023 23:00,7,65,6078,37825,72,43903,MONDAY,0,0,5,89,5.4,1019.1,Cloudy
1/31/2023 0:00,5,22,2994,18494,27,21488,TUESDAY,0,0,4.4,86,0,1018.4,Cloudy
1/31/2023 1:00,4,12,5419,11188,16,16607,TUESDAY,0,0,3.3,89,0,1017.9,Cloudy
1/31/2023 2:00,2,7,2426,4574,9,7000,TUESDAY,0,0,5.6,82,13,1017.7,Cloudy
1/31/2023 3:00,3,1,3908,358,4,4266,TUESDAY,0,0,6.1,76,11.2,1017.6,Snow
1/31/2023 4:00,2,9,2869,7332,11,10201,TUESDAY,0,0,6.1,76,11.2,1017.6,Cloudy
1/31/2023 5:00,4,23,7344,13825,27,21169,TUESDAY,0,0,3.9,79,16.6,1017.7,Cloudy
1/31/2023 6:00,4,101,4625,68497,105,73122,TUESDAY,0,0,3.9,79,7.6,1018.1,Cloudy
1/31/2023 7:00,25,266,24303,184962,291,209265,TUESDAY,0,0,3.3,76,14.8,1018.7,Cloudy
1/31/2023 8:00,29,576,23955,427283,605,451238,TUESDAY,0,0,3.3,76,14.8,1018.7,Rain
1/31/2023 9:00,33,397,29892,266051,430,295943,TUESDAY,0,0,1.7,85,16.6,1018.8,Snow
1/31/2023 10:00,27,219,23643,138076,246,161719,TUESDAY,0,0,0.6,92,14.8,1019.9,Rain
1/31/2023 11:00,27,226,31899,153583,253,185482,TUESDAY,0,0,0.6,92,14.8,1019.9,Rain
1/31/2023 12:00,29,269,32854,168711,298,201565,TUESDAY,0,0,0.6,82,9.4,1021.3,Cloudy
1/31/2023 13:00,43,236,48177,162993,279,211170,TUESDAY,0,0,0.6,82,9.4,1021.3,Cloudy
1/31/2023 14:00,44,272,65831,179789,316,245620,TUESDAY,0,0,1.1,69,16.6,1022,Cloudy
1/31/2023 15:00,41,319,48117,235758,360,283875,TUESDAY,0,0,1.7,66,20.5,1022.4,Cloudy
1/31/2023 16:00,50,466,68119,349448,516,417567,TUESDAY,0,0,1.7,61,18.4,1022,Cloudy
1/31/2023 17:00,64,685,67858,529497,749,597355,TUESDAY,0,0,2.2,52,22.3,1021.4,Cloudy
1/31/2023 18:00,40,525,44739,405432,565,450171,TUESDAY,0,0,2.2,52,22.3,1021.4,Fair
1/31/2023 19:00,32,327,45135,205652,359,250787,TUESDAY,0,0,1.1,47,20.5,1022.2,Fair
1/31/2023 20:00,27,190,22463,124318,217,146781,TUESDAY,0,0,1.1,46,24.1,1022.5,Fair
1/31/2023 21:00,16,149,8992,101547,165,110539,TUESDAY,0,0,-0.6,47,22.3,1022.9,Fair
1/31/2023 22:00,13,76,13742,44188,89,57930,TUESDAY,0,0,-0.6,47,22.3,1022.9,Fair
1/31/2023 23:00,5,43,4715,25027,48,29742,TUESDAY,0,0,-2.2,46,22.3,1024.1,Fair
2/1/2023 0:00,2,20,1922,15021,22,16943,WEDNESDAY,0,0,-2.8,44,20.5,1024.7,Fair
2/1/2023 1:00,3,7,4318,2391,10,6709,WEDNESDAY,0,0,-3.3,44,14.8,1025.2,Fair
2/1/2023 2:00,1,3,1011,1522,4,2533,WEDNESDAY,0,0,-3.9,42,11.2,1025.7,Fair
2/1/2023 3:00,0,2,0,590,2,590,WEDNESDAY,0,0,-3.9,42,11.2,1025.7,Fair
2/1/2023 4:00,0,8,0,5275,8,5275,WEDNESDAY,0,0,-5,43,16.6,1025.7,Cloudy
2/1/2023 5:00,3,35,3184,18329,38,21513,WEDNESDAY,0,0,-5,42,18.4,1025,Cloudy
2/1/2023 6:00,6,115,3040,68193,121,71233,WEDNESDAY,0,0,-5,39,14.8,1025,Cloudy
2/1/2023 7:00,20,322,13264,227249,342,240513,WEDNESDAY,0,0,-5,36,13,1025,Cloudy
2/1/2023 8:00,56,646,42693,453997,702,496690,WEDNESDAY,0,0,-5,36,13,1025,Cloudy
2/1/2023 9:00,26,362,34503,242659,388,277162,WEDNESDAY,0,0,-5,38,13,1025,Cloudy
2/1/2023 10:00,17,265,15360,176179,282,191539,WEDNESDAY,0,0,-5.6,41,13,1025,Cloudy
2/1/2023 11:00,30,211,46665,132197,241,178862,WEDNESDAY,0,0,-5.6,41,18.4,1025.3,Cloudy
2/1/2023 12:00,35,224,29073,164138,259,193211,WEDNESDAY,0,0,-6.1,45,7.6,1025.8,Cloudy
2/1/2023 13:00,28,220,40949,206642,248,247591,WEDNESDAY,0,0,-6.1,45,7.6,1025.8,Cloudy
2/1/2023 14:00,25,226,24166,151695,251,175861,WEDNESDAY,0,0,-3.9,53,13,1025.8,Cloudy
2/1/2023 15:00,59,297,258607,207628,356,466235,WEDNESDAY,0,0,-2.2,53,7.6,1025.2,Fair
2/1/2023 16:00,61,443,67493,324198,504,391691,WEDNESDAY,0,0,-2.2,55,0,1024.2,Fair
2/1/2023 17:00,69,640,64548,450394,709,514942,WEDNESDAY,0,0,-2.2,60,9.4,1023.5,Fair
2/1/2023 18:00,58,476,40714,316656,534,357370,WEDNESDAY,0,0,-1.7,58,13,1022.8,Fair
2/1/2023 19:00,41,303,37857,198523,344,236380,WEDNESDAY,0,0,-1.7,58,13,1022.8,Fair
2/1/2023 20:00,24,195,250244,130933,219,381177,WEDNESDAY,0,0,-1.7,56,11.2,1022.6,Fair
2/1/2023 21:00,22,137,3356762,99164,159,3455926,WEDNESDAY,0,0,-2.2,55,0,1022.9,Fair
2/1/2023 22:00,15,102,1335389,70315,117,1405704,WEDNESDAY,0,0,-2.2,55,0,1022.9,Fair
2/1/2023 23:00,6,47,4533,2593715,53,2598248,WEDNESDAY,0,0,-1.1,32,11.2,1024,Fair
2/2/2023 0:00,6,22,5879,12212,28,18091,THURSDAY,0,0,-1.7,36,16.6,1024.4,Fair
2/2/2023 1:00,7,9,15473,12351,16,27824,THURSDAY,0,0,-2.2,39,13,1024.7,Clear
2/2/2023 2:00,2,5,2438,3080,7,5518,THURSDAY,0,0,-2.8,39,13,1024.6,Clear
2/2/2023 3:00,0,10,0,9554,10,9554,THURSDAY,0,0,-2.8,39,22.3,1024.6,Clear
2/2/2023 4:00,0,8,0,5057,8,5057,THURSDAY,0,0,-3.3,42,18.4,1024.9,Clear
2/2/2023 5:00,7,27,6348,16665,34,23013,THURSDAY,0,0,-3.9,46,16.6,1024.4,Clear
2/2/2023 6:00,13,97,8654,58622,110,67276,THURSDAY,0,0,-3.3,46,16.6,1024.9,Fair
2/2/2023 7:00,10,292,8694,198411,302,207105,THURSDAY,0,0,-3.3,48,13,1024.3,Fair
2/2/2023 8:00,45,606,85340,438793,651,524133,THURSDAY,0,0,-3.3,48,13,1024.3,Fair
2/2/2023 9:00,22,393,33571,253152,415,286723,THURSDAY,0,0,-3.3,48,13,1023.9,Fair
2/2/2023 10:00,26,239,38165,186763,265,224928,THURSDAY,0,0,-4.4,57,16.6,1024,Fair
2/2/2023 11:00,25,214,25531,151156,239,176687,THURSDAY,0,0,-3.9,55,9.4,1023.8,Cloudy
2/2/2023 12:00,38,225,70256,162019,263,232275,THURSDAY,0,0,-2.8,53,11.2,1023.3,Cloudy
2/2/2023 13:00,37,231,39333,197303,268,236636,THURSDAY,0,0,-2.8,53,11.2,1023.3,Cloudy
2/2/2023 14:00,28,221,33698,143222,249,176920,THURSDAY,0,0,-0.6,47,20.5,1022.4,Cloudy
2/2/2023 15:00,56,290,56812,211247,346,268059,THURSDAY,0,0,1.1,40,18.4,1021.5,Cloudy
2/2/2023 16:00,53,420,71759,310126,473,381885,THURSDAY,0,0,1.1,38,22.3,1020.2,Cloudy
2/2/2023 17:00,73,583,82730,452326,656,535056,THURSDAY,0,0,2.2,35,18.4,1017.9,Cloudy
2/2/2023 18:00,52,482,51984,334117,534,386101,THURSDAY,0,0,2.2,35,18.4,1017.9,Fair
2/2/2023 19:00,34,318,28151,535114,352,563265,THURSDAY,0,0,3.3,31,20.5,1016.2,Fair
2/2/2023 20:00,24,219,113662,147274,243,260936,THURSDAY,0,0,2.8,34,24.1,1013.7,Fair
2/2/2023 21:00,25,171,20076,109629,196,129705,THURSDAY,0,0,2.2,38,24.1,1012.8,Fair
2/2/2023 22:00,17,104,62878,72707,121,135585,THURSDAY,0,0,2.2,38,25.9,1012.8,Fair
2/2/2023 23:00,10,49,59940,31645,59,91585,THURSDAY,0,0,1.1,46,25.9,1011.2,Fair
2/3/2023 0:00,2,31,1727,21731,33,23458,FRIDAY,0,0,1.1,46,27.7,1011.2,Fair
2/3/2023 1:00,14,19,14382,15779,33,30161,FRIDAY,0,0,0,58,22.3,1009.4,Clear
2/3/2023 2:00,7,8,81330,4849,15,86179,FRIDAY,0,0,0,58,22.3,1008.5,Clear
2/3/2023 3:00,3,3,1874,1610,6,3484,FRIDAY,0,0,0,58,22.3,1008.5,Clear
2/3/2023 4:00,0,9,0,7545,9,7545,FRIDAY,0,0,0,54,25.9,1006,Clear
2/3/2023 5:00,4,20,2252,9199,24,11451,FRIDAY,0,0,-0.6,56,18.4,1004.8,Clear
2/3/2023 6:00,2,83,681,50123,85,50804,FRIDAY,0,0,-0.6,56,18.4,1004.8,Clear
2/3/2023 7:00,7,155,5620,101556,162,107176,FRIDAY,0,0,0,47,20.5,1003.3,Clear
2/3/2023 8:00,8,227,11627,146573,235,158200,FRIDAY,0,0,0,47,20.5,1003.3,Clear
2/3/2023 9:00,21,196,47152,125948,217,173100,FRIDAY,0,0,0,47,20.5,1003.3,Clear
2/3/2023 10:00,13,116,17705,69573,129,87278,FRIDAY,0,0,-0.6,54,27.7,1005.3,Fair
2/3/2023 11:00,10,117,8284,67255,127,75539,FRIDAY,0,0,-0.6,54,27.7,1005.3,Fair
2/3/2023 12:00,18,121,11900,71637,139,83537,FRIDAY,0,0,-3.9,42,31.7,1007.3,Fair
2/3/2023 13:00,14,130,18342,76597,144,94939,FRIDAY,0,0,-5,35,42.5,1008.9,Fair
2/3/2023 14:00,18,117,15818,69049,135,84867,FRIDAY,0,0,-6.1,30,38.9,1010.3,Fair
2/3/2023 15:00,17,135,17722,88139,152,105861,FRIDAY,0,0,-7.2,24,42.5,1011.2,Fair
2/3/2023 16:00,14,145,9157,91915,159,101072,FRIDAY,0,0,-7.2,24,38.9,1011.2,Fair
2/3/2023 17:00,14,138,13155,88676,152,101831,FRIDAY,0,0,-7.2,23,37.1,1010.6,Clear
2/3/2023 18:00,5,101,6473,61344,106,67817,FRIDAY,0,0,-7.8,23,33.5,1010.9,Fair
2/3/2023 19:00,3,70,2063,46021,73,48084,FRIDAY,0,0,-7.8,22,38.9,1011,Fair
2/3/2023 20:00,8,28,5485,15503,36,20988,FRIDAY,0,0,-8.9,21,50,1011.9,Fair
2/3/2023 21:00,5,31,4647,17231,36,21878,FRIDAY,0,0,-9.4,23,35.3,1012.8,Fair
2/3/2023 22:00,3,22,7172,11753,25,18925,FRIDAY,0,0,-11.7,27,42.5,1015,Fair
2/3/2023 23:00,1,9,818,4837,10,5655,FRIDAY,0,0,-13.3,29,38.9,1017.3,Fair
2/4/2023 0:00,1,5,1098,2805,6,3903,SATURDAY,1,0,-14.4,30,40.7,1018.7,Fair
2/4/2023 1:00,0,5,0,1798,5,1798,SATURDAY,1,0,-15.6,30,37.1,1020.2,Fair
2/4/2023 2:00,0,2,0,1143,2,1143,SATURDAY,1,0,-17.8,32,46.4,1022.3,Fair
2/4/2023 3:00,0,1,0,175,1,175,SATURDAY,1,0,-20,27,46.4,1024.4,Fair
2/4/2023 5:00,1,1,386,177,2,563,SATURDAY,1,0,-21.7,34,31.7,1026.5,Clear
2/4/2023 6:00,1,5,1304,29282,6,30586,SATURDAY,1,0,-22.8,34,37.1,1028.4,Clear
2/4/2023 7:00,2,8,2300,3562,10,5862,SATURDAY,1,0,-22.8,34,35.3,1028.4,Clear
2/4/2023 8:00,3,14,3310,6398,17,9708,SATURDAY,1,0,-22.8,32,22.3,1029.9,Clear
2/4/2023 9:00,3,21,191268,12409,24,203677,SATURDAY,1,0,-22.8,34,40.7,1031,Clear
2/4/2023 10:00,1,38,390,22206,39,22596,SATURDAY,1,0,-22.8,32,35.3,1031.3,Clear
2/4/2023 11:00,9,56,4586,29300,65,33886,SATURDAY,1,0,-22.8,34,33.5,1032.2,Cloudy
2/4/2023 12:00,6,76,171103,58762,82,229865,SATURDAY,1,0,-22.8,34,35.3,1032.2,Cloudy
2/4/2023 13:00,10,73,103730,39908,83,143638,SATURDAY,1,0,-20,33,27.7,1033.3,Cloudy
2/4/2023 14:00,11,78,102635,41984,89,144619,SATURDAY,1,0,-18.3,30,27.7,1034.1,Cloudy
2/4/2023 15:00,6,96,7111,54490,102,61601,SATURDAY,1,0,-16.7,26,27.7,1034.2,Fair
2/4/2023 16:00,22,82,22726,46344,104,69070,SATURDAY,1,0,-14.4,22,27.7,1033.4,Fair
2/4/2023 17:00,16,88,11930,54436,104,66366,SATURDAY,1,0,-14.4,22,27.7,1033.4,Fair
2/4/2023 18:00,13,79,12084,48974,92,61058,SATURDAY,1,0,-11.1,21,24.1,1032.3,Fair
2/4/2023 19:00,6,77,4426,44675,83,49101,SATURDAY,1,0,-10.6,22,18.4,1032.4,Fair
2/4/2023 20:00,9,66,8320,39658,75,47978,SATURDAY,1,0,-10.6,23,18.4,1032.6,Cloudy
2/4/2023 21:00,9,49,8742,32666,58,41408,SATURDAY,1,0,-10.6,23,18.4,1032.6,Cloudy
2/4/2023 22:00,7,28,3916,15473,35,19389,SATURDAY,1,0,-10,26,13,1032.9,Cloudy
2/4/2023 23:00,2,21,2240,12433,23,14673,SATURDAY,1,0,-10,26,13,1032.9,Cloudy
2/5/2023 0:00,13,23,10910,13448,36,24358,SUNDAY,1,0,-10,26,18.4,1032.6,Cloudy
2/5/2023 1:00,16,26,307258,15976,42,323234,SUNDAY,1,0,-9.4,27,18.4,1032.9,Cloudy
2/5/2023 2:00,6,14,3257,11462,20,14719,SUNDAY,1,0,-9.4,27,18.4,1032.9,Cloudy
2/5/2023 3:00,0,1,0,263,1,263,SUNDAY,1,0,-8.9,33,16.6,1031.6,Cloudy
2/5/2023 4:00,2,6,4514,3785,8,8299,SUNDAY,1,0,-8.3,44,18.4,1030.4,Cloudy
2/5/2023 5:00,2,10,4747,7488,12,12235,SUNDAY,1,0,-7.2,47,18.4,1029.3,Cloudy
2/5/2023 6:00,2,22,5054,11278,24,16332,SUNDAY,1,0,-6.7,59,18.4,1028.3,Cloudy
2/5/2023 7:00,6,33,10972,20665,39,31637,SUNDAY,1,0,-6.7,59,22.3,1028.3,Cloudy
2/5/2023 8:00,13,66,22996,42730,79,65726,SUNDAY,1,0,-5,57,22.3,1026.4,Cloudy
2/5/2023 9:00,21,139,38197,90549,160,128746,SUNDAY,1,0,-4.4,60,16.6,1025.4,Cloudy
2/5/2023 10:00,53,240,81607,190106,293,271713,SUNDAY,1,0,-3.3,60,20.5,1024.9,Cloudy
2/5/2023 11:00,60,237,107751,161020,297,268771,SUNDAY,1,0,-2.8,60,16.6,1024.5,Cloudy
2/5/2023 12:00,87,298,162838,229749,385,392587,SUNDAY,1,0,-2.8,60,16.6,1024.5,Cloudy
2/5/2023 13:00,116,364,208681,296755,480,505436,SUNDAY,1,0,0,58,16.6,1022.8,Cloudy
2/5/2023 14:00,116,356,4196146,279970,472,4476116,SUNDAY,1,0,3.3,48,24.1,1021.7,Cloudy
2/5/2023 15:00,124,337,588898,265908,461,854806,SUNDAY,1,0,5,43,35.3,1021,Cloudy
2/5/2023 16:00,123,377,632950,305467,500,938417,SUNDAY,1,0,5,43,33.5,1021,Cloudy
2/5/2023 17:00,65,335,229209,245073,400,474282,SUNDAY,1,0,9.4,33,29.5,1017.4,Cloudy
2/5/2023 18:00,57,254,67200,184684,311,251884,SUNDAY,1,0,10,33,33.5,1016.6,Cloudy
2/5/2023 19:00,43,188,44333,124687,231,169020,SUNDAY,1,0,10,33,20.5,1016.2,Cloudy
2/5/2023 20:00,12,119,11147,92138,131,103285,SUNDAY,1,0,10,33,20.5,1015.8,Cloudy
2/5/2023 21:00,26,125,30682,82597,151,113279,SUNDAY,1,0,10,33,24.1,1015.8,Cloudy
2/5/2023 22:00,17,74,85727,49618,91,135345,SUNDAY,1,0,5.6,59,20.5,1015.5,Cloudy
2/5/2023 23:00,6,48,3687,27703,54,31390,SUNDAY,1,0,5,65,14.8,1015.5,Cloudy
2/6/2023 0:00,8,20,8214,8054,28,16268,MONDAY,0,0,5,65,16.6,1015.3,Cloudy
2/6/2023 1:00,6,14,49762,9016,20,58778,MONDAY,0,0,4.4,65,13,1015.6,Cloudy
2/6/2023 2:00,7,4,8700,2525,11,11225,MONDAY,0,0,4.4,65,13,1015.6,Cloudy
2/6/2023 3:00,2,1,6176,216,3,6392,MONDAY,0,0,2.8,70,13,1015.5,Cloudy
2/6/2023 4:00,3,6,476459,3524,9,479983,MONDAY,0,0,2.2,75,11.2,1015.4,Cloudy
2/6/2023 5:00,12,34,29411,26360,46,55771,MONDAY,0,0,2.8,72,11.2,1015,Cloudy
2/6/2023 6:00,10,117,13494,89548,127,103042,MONDAY,0,0,3.9,67,13,1014.5,Cloudy
2/6/2023 7:00,31,327,117045,234002,358,351047,MONDAY,0,0,3.9,67,13,1014.5,Cloudy
2/6/2023 8:00,44,672,37750,2325346,716,2363096,MONDAY,0,0,2.8,76,5.4,1013.9,Cloudy
2/6/2023 9:00,54,392,71488,342038,446,413526,MONDAY,0,0,2.8,72,13,1014.5,Cloudy
2/6/2023 10:00,48,261,64813,184294,309,249107,MONDAY,0,0,1.1,79,9.4,1014.9,Cloudy
2/6/2023 11:00,36,249,40874,151002,285,191876,MONDAY,0,0,2.2,79,11.2,1015.4,Cloudy
2/6/2023 12:00,33,297,59104,198392,330,257496,MONDAY,0,0,2.2,79,11.2,1015.4,Cloudy
2/6/2023 13:00,57,230,143279,179005,287,322284,MONDAY,0,0,4.4,65,11.2,1014.9,Cloudy
2/6/2023 14:00,53,274,72364,173419,327,245783,MONDAY,0,0,7.2,51,11.2,1015.6,Cloudy
2/6/2023 15:00,72,288,102396,184800,360,287196,MONDAY,0,0,8.3,48,18.4,1015.7,Cloudy
2/6/2023 16:00,84,486,149961,351436,570,501397,MONDAY,0,0,8.3,48,18.4,1015.7,Cloudy
2/6/2023 17:00,78,726,83555,543168,804,626723,MONDAY,0,0,8.9,46,22.3,1015.6,Cloudy
2/6/2023 18:00,51,538,53179,379376,589,432555,MONDAY,0,0,8.3,48,25.9,1015.3,Cloudy
2/6/2023 19:00,50,336,123351,228021,386,351372,MONDAY,0,0,7.2,56,25.9,1015.5,Cloudy
2/6/2023 20:00,28,225,23246,153061,253,176307,MONDAY,0,0,6.1,60,22.3,1016,Cloudy
2/6/2023 21:00,26,146,97100,109782,172,206882,MONDAY,0,0,6.1,60,22.3,1016,Cloudy
2/6/2023 22:00,20,81,15423,55989,101,71412,MONDAY,0,0,5,62,24.1,1016.7,Cloudy
2/6/2023 23:00,7,58,8284,39704,65,47988,MONDAY,0,0,5,60,20.5,1018.1,Cloudy
2/7/2023 0:00,3,13,1880,7649,16,9529,TUESDAY,0,0,4.4,60,13,1018.9,Cloudy
2/7/2023 1:00,3,8,2056,7877,11,9933,TUESDAY,0,0,3.3,59,14.8,1020.3,Cloudy
2/7/2023 2:00,0,6,0,2867,6,2867,TUESDAY,0,0,3.3,59,14.8,1020.3,Cloudy
2/7/2023 3:00,1,4,1371,3745,5,5116,TUESDAY,0,0,0.6,58,18.4,1023,Cloudy
2/7/2023 4:00,2,6,3848,7620,8,11468,TUESDAY,0,0,0,58,22.3,1024,Fair
2/7/2023 5:00,10,45,5687,27428,55,33115,TUESDAY,0,0,-1.1,41,25.9,1025.3,Fair
2/7/2023 6:00,11,115,282472,2616719,126,2899191,TUESDAY,0,0,-1.1,41,25.9,1025.3,Fair
2/7/2023 7:00,22,340,15152,241620,362,256772,TUESDAY,0,0,-1.7,36,18.4,1026.1,Clear
2/7/2023 8:00,46,722,40355,509997,768,550352,TUESDAY,0,0,-2.8,39,20.5,1026.4,Clear
2/7/2023 9:00,38,440,38225,342911,478,381136,TUESDAY,0,0,-3.9,44,13,1027.3,Clear
2/7/2023 10:00,24,207,22698,156774,231,179472,TUESDAY,0,0,-3.9,38,16.6,1027.8,Clear
2/7/2023 11:00,38,239,54904,180917,277,235821,TUESDAY,0,0,-3.9,36,16.6,1028.8,Fair
2/7/2023 12:00,43,239,54077,170618,282,224695,TUESDAY,0,0,-3.9,36,16.6,1028.8,Fair
2/7/2023 13:00,34,223,34656,164798,257,199454,TUESDAY,0,0,-2.2,44,18.4,1029.2,Fair
2/7/2023 14:00,31,252,41989,153089,283,195078,TUESDAY,0,0,-1.1,47,18.4,1029.5,Fair
2/7/2023 15:00,41,311,119132,210785,352,329917,TUESDAY,0,0,-0.6,56,16.6,1029.5,Fair
2/7/2023 16:00,50,465,64262,342883,515,407145,TUESDAY,0,0,-0.6,56,16.6,1029.5,Fair
2/7/2023 17:00,60,717,47660,508506,777,556166,TUESDAY,0,0,-1.1,66,14.8,1027.2,Cloudy
2/7/2023 18:00,48,493,46277,344509,541,390786,TUESDAY,0,0,-1.1,66,14.8,1027.2,Cloudy
2/7/2023 19:00,37,329,28370,227546,366,255916,TUESDAY,0,0,-1.1,69,11.2,1025.8,Cloudy
2/7/2023 20:00,26,229,16963,459591,255,476554,TUESDAY,0,0,-1.1,72,14.8,1024.3,Cloudy
2/7/2023 21:00,16,100,13104,69763,116,82867,TUESDAY,0,0,-1.1,72,14.8,1024.3,Cloudy
2/7/2023 22:00,2,90,1121,63540,92,64661,TUESDAY,0,0,-0.6,76,14.8,1024.1,Cloudy
2/7/2023 23:00,5,42,4090,27238,47,31328,TUESDAY,0,0,-0.6,76,20.5,1022.8,Cloudy
2/8/2023 0:00,9,16,55618,13952,25,69570,WEDNESDAY,0,0,0,75,18.4,1020.8,Cloudy
2/8/2023 1:00,4,10,2470,11397,14,13867,WEDNESDAY,0,0,0,75,18.4,1020.8,Cloudy
2/8/2023 2:00,1,7,300,10748,8,11048,WEDNESDAY,0,0,0.6,72,22.3,1022.5,Snow
2/8/2023 3:00,1,3,1870,1431,4,3301,WEDNESDAY,0,0,0,81,14.8,1020.6,Snow
2/8/2023 4:00,1,4,724,2250,5,2974,WEDNESDAY,0,0,0.6,85,14.8,1018,Rain
2/8/2023 5:00,10,39,7207,32025,49,39232,WEDNESDAY,0,0,1.7,89,24.1,1017,Rain
2/8/2023 6:00,10,141,7170,103746,151,110916,WEDNESDAY,0,0,1.7,89,24.1,1017,Cloudy
2/8/2023 7:00,23,334,20844,247993,357,268837,WEDNESDAY,0,0,2.2,89,16.6,1016.3,Cloudy
2/8/2023 8:00,71,734,91582,524225,805,615807,WEDNESDAY,0,0,2.8,85,18.4,1016.3,Cloudy
2/8/2023 9:00,43,456,44583,389280,499,433863,WEDNESDAY,0,0,2.8,85,16.6,1016.3,Cloudy
2/8/2023 10:00,47,257,68181,186145,304,254326,WEDNESDAY,0,0,3.9,79,18.4,1016.5,Fair
2/8/2023 11:00,53,265,112851,299265,318,412116,WEDNESDAY,0,0,3.9,79,18.4,1016.5,Fair
2/8/2023 12:00,58,293,494691,223270,351,717961,WEDNESDAY,0,0,5.6,70,22.3,1017.4,Fair
2/8/2023 13:00,50,287,70255,197424,337,267679,WEDNESDAY,0,0,5.6,70,22.3,1017.4,Fair
2/8/2023 14:00,86,301,2008194,208555,387,2216749,WEDNESDAY,0,0,6.1,65,14.8,1019,Fair
2/8/2023 15:00,58,351,95074,256713,409,351787,WEDNESDAY,0,0,6.7,60,22.3,1019.6,Fair
2/8/2023 16:00,87,545,121596,398238,632,519834,WEDNESDAY,0,0,6.7,60,22.3,1019.6,Fair
2/8/2023 17:00,112,774,1952493,594283,886,2546776,WEDNESDAY,0,0,8.3,42,24.1,1018.9,Fair
2/8/2023 18:00,90,573,116117,545932,663,662049,WEDNESDAY,0,0,8.3,42,24.1,1018.9,Fair
2/8/2023 19:00,50,377,48793,245796,427,294589,WEDNESDAY,0,0,8.3,42,22.3,1019.3,Fair
2/8/2023 20:00,35,242,780396,163140,277,943536,WEDNESDAY,0,0,8.9,37,22.3,1020,Fair
2/8/2023 21:00,35,193,47010,138648,228,185658,WEDNESDAY,0,0,8.9,37,22.3,1020,Fair
2/8/2023 22:00,37,163,32635,133148,200,165783,WEDNESDAY,0,0,7.2,44,16.6,1021.3,Fair
2/8/2023 23:00,8,63,14493,38088,71,52581,WEDNESDAY,0,0,6.7,45,14.8,1022.3,Fair
2/9/2023 0:00,7,18,4845,12515,25,17360,THURSDAY,0,0,6.1,51,24.1,1022.9,Fair
2/9/2023 1:00,13,7,34732,7081,20,41813,THURSDAY,0,0,6.1,51,24.1,1022.9,Clear
2/9/2023 2:00,1,7,1855,5612,8,7467,THURSDAY,0,0,3.9,59,13,1023.4,Clear
2/9/2023 3:00,2,4,877,2776,6,3653,THURSDAY,0,0,3.9,57,13,1023.8,Clear
2/9/2023 4:00,1,9,385,10287,10,10672,THURSDAY,0,0,5,51,14.8,1024.5,Clear
2/9/2023 5:00,5,32,3288,23521,37,26809,THURSDAY,0,0,4.4,53,16.6,1024.9,Clear
2/9/2023 6:00,12,141,55844,90973,153,146817,THURSDAY,0,0,3.3,57,11.2,1024.6,Fair
2/9/2023 7:00,31,363,25650,269667,394,295317,THURSDAY,0,0,3.3,57,11.2,1024.6,Fair
2/9/2023 8:00,75,773,78420,587535,848,665955,THURSDAY,0,0,2.2,64,11.2,1024.9,Fair
2/9/2023 9:00,44,425,48098,291603,469,339701,THURSDAY,0,0,2.8,61,7.6,1026.2,Fair
2/9/2023 10:00,45,296,59694,228550,341,288244,THURSDAY,0,0,2.8,61,7.6,1026.2,Fair
2/9/2023 11:00,51,273,173209,171550,324,344759,THURSDAY,0,0,2.2,64,0,1026.5,Fair
2/9/2023 12:00,56,281,75793,206773,337,282566,THURSDAY,0,0,2.2,64,0,1026.5,Cloudy
2/9/2023 13:00,39,286,37422,197878,325,235300,THURSDAY,0,0,4.4,62,0,1026.8,Cloudy
2/9/2023 14:00,41,270,46492,238357,311,284849,THURSDAY,0,0,7.8,49,7.6,1026.7,Cloudy
2/9/2023 15:00,63,327,508013,265806,390,773819,THURSDAY,0,0,6.7,55,7.6,1026.3,Cloudy
2/9/2023 16:00,67,482,66561,349644,549,416205,THURSDAY,0,0,6.7,55,7.6,1026.3,Cloudy
2/9/2023 17:00,91,703,89523,587382,794,676905,THURSDAY,0,0,6.1,57,16.6,1024.5,Cloudy
2/9/2023 18:00,89,543,248469,449082,632,697551,THURSDAY,0,0,5.6,70,18.4,1022.8,Cloudy
2/9/2023 19:00,59,320,51340,216532,379,267872,THURSDAY,0,0,6.1,68,18.4,1022.3,Cloudy
2/9/2023 20:00,44,278,41374,216447,322,257821,THURSDAY,0,0,6.1,68,18.4,1022.3,Rain
2/9/2023 21:00,43,198,40632,157733,241,198365,THURSDAY,0,0,6.1,57,13,1019.9,Rain
2/9/2023 22:00,25,116,38212,399710,141,437922,THURSDAY,0,0,6.1,60,14.8,1019,Rain
2/9/2023 23:00,40,78,1456706,55223,118,1511929,THURSDAY,0,0,5.6,62,11.2,1018.1,Rain
2/10/2023 0:00,18,44,71134,29889,62,101023,FRIDAY,0,0,5,73,9.4,1016.9,Rain
2/10/2023 1:00,16,21,26196,19018,37,45214,FRIDAY,0,0,5,73,9.4,1016.9,Rain
2/10/2023 2:00,7,7,18039,5212,14,23251,FRIDAY,0,0,6.1,79,5.4,1013.4,Rain
2/10/2023 3:00,0,7,0,2792,7,2792,FRIDAY,0,0,6.7,82,7.6,1012,Rain
2/10/2023 4:00,0,7,0,8560,7,8560,FRIDAY,0,0,5.6,85,7.6,1010.8,Rain
2/10/2023 5:00,8,28,11666,22496,36,34162,FRIDAY,0,0,5,86,9.4,1008.9,Cloudy
2/10/2023 6:00,15,119,8786,130095,134,138881,FRIDAY,0,0,5,86,9.4,1008.9,Cloudy
2/10/2023 7:00,37,271,140444,192108,308,332552,FRIDAY,0,0,4.4,93,7.6,1006,Cloudy
2/10/2023 8:00,56,608,57597,460231,664,517828,FRIDAY,0,0,5,89,9.4,1005.4,Cloudy
2/10/2023 9:00,62,420,74438,277978,482,352416,FRIDAY,0,0,3.9,93,5.4,1005.4,Cloudy
2/10/2023 10:00,56,290,76351,209228,346,285579,FRIDAY,0,0,3.3,93,0,1005,Cloudy
2/10/2023 11:00,111,327,215826,257699,438,473525,FRIDAY,0,0,3.3,93,0,1005,Fair
2/10/2023 12:00,108,345,121149,585777,453,706926,FRIDAY,0,0,3.3,93,14.8,1005,Fair
2/10/2023 13:00,125,373,181509,270775,498,452284,FRIDAY,0,0,10,77,14.8,1005.6,Fair
2/10/2023 14:00,141,337,315710,265870,478,581580,FRIDAY,0,0,12.2,69,14.8,1005.9,Fair
2/10/2023 15:00,188,447,438487,349442,635,787929,FRIDAY,0,0,12.2,69,18.4,1005.9,Fair
2/10/2023 16:00,152,557,207714,458547,709,666261,FRIDAY,0,0,14.4,53,29.5,1006,Fair
2/10/2023 17:00,159,623,239774,500307,782,740081,FRIDAY,0,0,15,41,29.5,1006,Fair
2/10/2023 18:00,96,432,192485,318712,528,511197,FRIDAY,0,0,15,41,35.3,1006.5,Fair
2/10/2023 19:00,72,317,2615244,234783,389,2850027,FRIDAY,0,0,15,41,29.5,1006.5,Fair
2/10/2023 20:00,66,229,245080,160049,295,405129,FRIDAY,0,0,13.9,37,38.9,1007.6,Fair
2/10/2023 21:00,42,169,1623012,117368,211,1740380,FRIDAY,0,0,10.6,42,25.9,1009.3,Fair
2/10/2023 22:00,62,142,107267,106012,204,213279,FRIDAY,0,0,9.4,48,44.6,1010.7,Fair
2/10/2023 23:00,72,115,941532,91724,187,1033256,FRIDAY,0,0,7.2,56,25.9,1011.6,Fair
2/11/2023 0:00,38,60,456251,36225,98,492476,SATURDAY,1,0,7.2,56,25.9,1011.6,Fair
2/11/2023 1:00,34,53,94686,39468,87,134154,SATURDAY,1,0,6.1,57,25.9,1011.5,Fair
2/11/2023 2:00,11,36,17808,24903,47,42711,SATURDAY,1,0,5.6,59,20.5,1012.6,Fair
2/11/2023 3:00,7,17,16919,11694,24,28613,SATURDAY,1,0,5.6,59,27.7,1012.6,Fair
2/11/2023 4:00,3,6,3005,3298,9,6303,SATURDAY,1,0,5.6,57,20.5,1012.8,Fair
2/11/2023 5:00,4,7,1438,8252,11,9690,SATURDAY,1,0,5.6,55,20.5,1012,Clear
2/11/2023 6:00,4,40,20005,23976,44,43981,SATURDAY,1,0,5.6,55,20.5,1012,Clear
2/11/2023 7:00,16,50,245653,40175,66,285828,SATURDAY,1,0,4.4,43,22.3,1013,Fair
2/11/2023 8:00,35,113,62014,85721,148,147735,SATURDAY,1,0,3.3,40,29.5,1013.9,Fair
2/11/2023 9:00,45,234,167474,163411,279,330885,SATURDAY,1,0,2.8,48,29.5,1014.3,Fair
2/11/2023 10:00,85,299,745755,224569,384,970324,SATURDAY,1,0,2.8,48,35.3,1014.3,Fair
2/11/2023 11:00,88,289,158166,263477,377,421643,SATURDAY,1,0,2.2,50,22.3,1017.3,Fair
2/11/2023 12:00,114,354,547849,404922,468,952771,SATURDAY,1,0,2.8,48,22.3,1018.9,Fair
2/11/2023 13:00,139,372,199910,329501,511,529411,SATURDAY,1,0,3.9,46,27.7,1020.2,Fair
2/11/2023 14:00,181,381,301011,353818,562,654829,SATURDAY,1,0,5,41,22.3,1021,Fair
2/11/2023 15:00,175,371,3148645,325921,546,3474566,SATURDAY,1,0,5,41,31.7,1021,Fair
2/11/2023 16:00,155,343,365567,356952,498,722519,SATURDAY,1,0,6.1,32,18.4,1022.3,Fair
2/11/2023 17:00,131,331,168424,248404,462,416828,SATURDAY,1,0,6.7,27,22.3,1022.5,Fair
2/11/2023 18:00,72,306,91836,223800,378,315636,SATURDAY,1,0,6.7,23,22.3,1022.7,Fair
2/11/2023 19:00,80,250,99608,184402,330,284010,SATURDAY,1,0,6.7,23,13,1022.8,Fair
2/11/2023 20:00,63,196,67913,153104,259,221017,SATURDAY,1,0,6.7,23,13,1022.8,Fair
2/11/2023 21:00,46,128,119562,95226,174,214788,SATURDAY,1,0,5.6,24,11.2,1023.7,Fair
2/11/2023 22:00,28,96,32127,64528,124,96655,SATURDAY,1,0,5,25,11.2,1024.5,Fair
2/11/2023 23:00,42,80,2962375,59499,122,3021874,SATURDAY,1,0,5,26,5.4,1024.4,Clear
2/12/2023 0:00,49,76,134279,54262,125,188541,SUNDAY,1,0,5,26,5.4,1024.4,Clear
2/12/2023 1:00,41,50,64627,40339,91,104966,SUNDAY,1,0,4.4,39,13,1024.3,Clear
2/12/2023 2:00,23,23,1201637,20399,46,1222036,SUNDAY,1,0,4.4,39,13,1024.3,Clear
2/12/2023 3:00,8,7,10930,7530,15,18460,SUNDAY,1,0,1.7,49,16.6,1023.9,Clear
2/12/2023 4:00,10,10,6067,14193,20,20260,SUNDAY,1,0,1.7,49,16.6,1023.9,Clear
2/12/2023 5:00,4,12,4220,9525,16,13745,SUNDAY,1,0,0.6,56,13,1023,Clear
2/12/2023 6:00,3,22,3965,11457,25,15422,SUNDAY,1,0,0,56,16.6,1022,Clear
2/12/2023 7:00,12,36,17085,23918,48,41003,SUNDAY,1,0,0,58,13,1021.3,Clear
2/12/2023 8:00,33,127,36199,95262,160,131461,SUNDAY,1,0,0.6,56,13,1020.6,Clear
2/12/2023 9:00,53,184,67549,160286,237,227835,SUNDAY,1,0,0,58,14.8,1020.8,Fair
2/12/2023 10:00,81,294,124504,218513,375,343017,SUNDAY,1,0,0,58,14.8,1020.8,Clear
2/12/2023 11:00,107,335,186554,239337,442,425891,SUNDAY,1,0,-0.6,63,11.2,1020.8,Fair
2/12/2023 12:00,148,354,287537,287244,502,574781,SUNDAY,1,0,1.7,56,18.4,1020.7,Cloudy
2/12/2023 13:00,142,377,321747,291801,519,613548,SUNDAY,1,0,3.9,48,14.8,1020.4,Cloudy
2/12/2023 14:00,176,361,1984659,364013,537,2348672,SUNDAY,1,0,3.9,48,14.8,1020.4,Cloudy
2/12/2023 15:00,150,351,275972,302746,501,578718,SUNDAY,1,0,7.2,35,14.8,1019.3,Cloudy
2/12/2023 16:00,145,418,704917,330085,563,1035002,SUNDAY,1,0,7.8,34,11.2,1018.2,Cloudy
2/12/2023 17:00,126,419,150563,313794,545,464357,SUNDAY,1,0,8.9,30,9.4,1016.7,Cloudy
2/12/2023 18:00,84,351,93318,243462,435,336780,SUNDAY,1,0,10,27,11.2,1015.5,Cloudy
2/12/2023 19:00,26,177,22574,126570,203,149144,SUNDAY,1,0,10,27,11.2,1015.5,Cloudy
2/12/2023 20:00,27,125,46770,89853,152,136623,SUNDAY,1,0,8.9,31,7.6,1014.9,Cloudy
2/12/2023 21:00,44,122,228002,83939,166,311941,SUNDAY,1,0,7.8,37,9.4,1014.2,Cloudy
2/12/2023 22:00,83,223,306556,381602,306,688158,SUNDAY,1,0,7.8,37,9.4,1014.2,Cloudy
2/12/2023 23:00,26,88,56957,52777,114,109734,SUNDAY,1,0,6.7,45,14.8,1014.2,Cloudy
2/13/2023 0:00,19,35,20778,25404,54,46182,MONDAY,0,0,6.1,47,9.4,1013.2,Cloudy
2/13/2023 1:00,7,21,15500,14278,28,29778,MONDAY,0,0,4.4,60,9.4,1013.1,Cloudy
2/13/2023 2:00,4,8,4248,6649,12,10897,MONDAY,0,0,4.4,60,9.4,1013.1,Cloudy
2/13/2023 3:00,1,5,1770,7399,6,9169,MONDAY,0,0,3.9,62,7.6,1011.5,Cloudy
2/13/2023 4:00,2,11,1857,10125,13,11982,MONDAY,0,0,3.9,57,5.4,1010.6,Cloudy
2/13/2023 5:00,10,29,13126,21380,39,34506,MONDAY,0,0,2.8,78,9.4,1009.3,Cloudy
2/13/2023 6:00,6,113,8162,87534,119,95696,MONDAY,0,0,3.3,73,9.4,1009.1,Cloudy
2/13/2023 7:00,34,299,27529,546217,333,573746,MONDAY,0,0,3.3,73,9.4,1009.1,Cloudy
2/13/2023 8:00,52,651,66528,480973,703,547501,MONDAY,0,0,3.9,86,20.5,1006.3,Cloudy
2/13/2023 9:00,52,356,58020,368597,408,426617,MONDAY,0,0,3.9,82,18.4,1005.9,Cloudy
2/13/2023 10:00,20,256,40380,219182,276,259562,MONDAY,0,0,4.4,76,18.4,1005,Cloudy
2/13/2023 11:00,38,255,45875,176396,293,222271,MONDAY,0,0,4.4,76,27.7,1005,Cloudy
2/13/2023 12:00,46,284,213537,168025,330,381562,MONDAY,0,0,4.4,79,22.3,1004.6,Cloudy
2/13/2023 13:00,39,232,68590,146791,271,215381,MONDAY,0,0,5.6,73,22.3,1004,Cloudy
2/13/2023 14:00,48,236,49432,150974,284,200406,MONDAY,0,0,5.6,73,20.5,1003.1,Cloudy
2/13/2023 15:00,65,280,93789,243272,345,337061,MONDAY,0,0,6.1,73,20.5,1003,Cloudy
2/13/2023 16:00,48,472,107608,331483,520,439091,MONDAY,0,0,6.1,73,31.7,1003,Cloudy
2/13/2023 17:00,76,669,70579,490595,745,561174,MONDAY,0,0,5.6,70,24.1,1002.2,Cloudy
2/13/2023 18:00,49,508,2000311,350789,557,2351100,MONDAY,0,0,5.6,67,22.3,1002.1,Cloudy
2/13/2023 19:00,46,331,58630,219839,377,278469,MONDAY,0,0,5.6,67,22.3,1002.1,Cloudy
2/13/2023 20:00,21,231,15638,141264,252,156902,MONDAY,0,0,5.6,64,20.5,1001.3,Cloudy
2/13/2023 21:00,25,146,31939,101001,171,132940,MONDAY,0,0,5.6,64,20.5,1001.3,Cloudy
2/13/2023 22:00,20,103,21701,70899,123,92600,MONDAY,0,0,3.3,70,9.4,1002,Cloudy
2/13/2023 23:00,15,50,10375,32672,65,43047,MONDAY,0,0,3.3,70,9.4,1002,Cloudy
2/14/2023 0:00,9,25,11097,14429,34,25526,TUESDAY,0,0,3.3,76,11.2,1002.6,Cloudy
2/14/2023 1:00,4,23,28638,16161,27,44799,TUESDAY,0,0,3.3,76,9.4,1003,Cloudy
2/14/2023 2:00,0,5,0,1934,5,1934,TUESDAY,0,0,3.3,79,13,1002.7,Cloudy
2/14/2023 3:00,2,3,1121,2926,5,4047,TUESDAY,0,0,2.8,82,9.4,1002.7,Cloudy
2/14/2023 4:00,1,5,954,3795,6,4749,TUESDAY,0,0,2.8,82,9.4,1002.7,Cloudy
2/14/2023 5:00,7,43,4126,26754,50,30880,TUESDAY,0,0,2.8,82,7.6,1003.5,Cloudy
2/14/2023 6:00,15,151,10580,108639,166,119219,TUESDAY,0,0,2.2,85,9.4,1003.9,Cloudy
2/14/2023 7:00,40,368,30761,266464,408,297225,TUESDAY,0,0,2.8,82,9.4,1004,Cloudy
2/14/2023 8:00,78,813,68803,584693,891,653496,TUESDAY,0,0,3.9,70,16.6,1004.7,Cloudy
2/14/2023 9:00,48,397,47865,296064,445,343929,TUESDAY,0,0,3.9,70,16.6,1004.7,Cloudy
2/14/2023 10:00,42,256,53445,184863,298,238308,TUESDAY,0,0,3.9,70,18.4,1007.8,Cloudy
2/14/2023 11:00,43,302,50170,246867,345,297037,TUESDAY,0,0,3.9,70,14.8,1009.5,Cloudy
2/14/2023 12:00,66,308,108408,195860,374,304268,TUESDAY,0,0,5.6,64,14.8,1010.9,Cloudy
2/14/2023 13:00,41,308,105593,218714,349,324307,TUESDAY,0,0,6.7,58,22.3,1012,Cloudy
2/14/2023 14:00,72,337,101710,232684,409,334394,TUESDAY,0,0,6.7,58,22.3,1012,Fair
2/14/2023 15:00,87,411,102290,302472,498,404762,TUESDAY,0,0,8.9,42,22.3,1013.8,Fair
2/14/2023 16:00,111,599,158140,436929,710,595069,TUESDAY,0,0,8.3,42,20.5,1014.2,Rain
2/14/2023 17:00,152,836,152326,648395,988,800721,TUESDAY,0,0,10,37,18.4,1014.8,Fair
2/14/2023 18:00,93,552,173402,405221,645,578623,TUESDAY,0,0,10,34,11.2,1014.9,Fair
2/14/2023 19:00,60,355,2143537,253440,415,2396977,TUESDAY,0,0,10.6,29,22.3,1015.8,Fair
2/14/2023 20:00,43,223,66087,247886,266,313973,TUESDAY,0,0,10.6,29,22.3,1015.8,Fair
2/14/2023 21:00,42,150,53062,95488,192,148550,TUESDAY,0,0,9.4,29,14.8,1018.2,Fair
2/14/2023 22:00,20,118,43178,72310,138,115488,TUESDAY,0,0,8.9,30,7.6,1019.6,Fair
2/14/2023 23:00,15,73,14829,45634,88,60463,TUESDAY,0,0,6.7,38,7.6,1021.3,Fair
2/15/2023 0:00,7,28,5821,18765,35,24586,WEDNESDAY,0,0,6.1,39,7.6,1021.9,Fair
2/15/2023 1:00,5,13,2356,7657,18,10013,WEDNESDAY,0,0,6.1,39,7.6,1021.9,Fair
2/15/2023 2:00,4,8,3099,8724,12,11823,WEDNESDAY,0,0,4.4,62,11.2,1022.4,Clear
2/15/2023 3:00,0,4,0,1890,4,1890,WEDNESDAY,0,0,2.8,70,11.2,1022.8,Clear
2/15/2023 4:00,1,3,734,3954,4,4688,WEDNESDAY,0,0,2.8,70,11.2,1022.8,Clear
2/15/2023 5:00,2,29,1123,22947,31,24070,WEDNESDAY,0,0,1.7,72,5.4,1022.3,Fair
2/15/2023 6:00,15,145,15030,98898,160,113928,WEDNESDAY,0,0,1.7,72,7.6,1022.6,Fair
2/15/2023 7:00,31,380,62180,284029,411,346209,WEDNESDAY,0,0,1.7,72,7.6,1022.6,Fair
2/15/2023 8:00,68,779,73454,530530,847,603984,WEDNESDAY,0,0,1.7,72,9.4,1022.5,Fair
2/15/2023 9:00,46,464,66185,314039,510,380224,WEDNESDAY,0,0,1.7,72,9.4,1022.5,Cloudy
2/15/2023 10:00,44,266,45865,214406,310,260271,WEDNESDAY,0,0,2.8,78,14.8,1021.9,Fair
2/15/2023 11:00,49,227,140687,173323,276,314010,WEDNESDAY,0,0,2.8,76,11.2,1022.1,Cloudy
2/15/2023 12:00,57,294,156703,199339,351,356042,WEDNESDAY,0,0,3.3,76,9.4,1022,Cloudy
2/15/2023 13:00,52,278,2335010,211113,330,2546123,WEDNESDAY,0,0,3.3,76,9.4,1022,Cloudy
2/15/2023 14:00,63,326,925296,227858,389,1153154,WEDNESDAY,0,0,6.7,73,20.5,1020.9,Cloudy
2/15/2023 15:00,87,383,933123,273873,470,1206996,WEDNESDAY,0,0,8.3,71,20.5,1019.6,Cloudy
2/15/2023 16:00,122,601,222396,470704,723,693100,WEDNESDAY,0,0,10,58,22.3,1017.9,Rain
2/15/2023 17:00,133,839,1605485,683468,972,2288953,WEDNESDAY,0,0,12.2,47,22.3,1015.6,Cloudy
2/15/2023 18:00,91,571,97663,559841,662,657504,WEDNESDAY,0,0,12.2,47,33.5,1015.6,Cloudy
2/15/2023 19:00,70,407,188055,262000,477,450055,WEDNESDAY,0,0,13.9,49,33.5,1012.2,Cloudy
2/15/2023 20:00,71,278,136770,237162,349,373932,WEDNESDAY,0,0,13.3,62,40.7,1011.3,Cloudy
2/15/2023 21:00,51,208,1744061,228606,259,1972667,WEDNESDAY,0,0,12.8,69,29.5,1010.3,Cloudy
2/15/2023 22:00,38,161,53828,174825,199,228653,WEDNESDAY,0,0,11.7,77,29.5,1010.1,Fair
2/15/2023 23:00,27,77,19681,122673,104,142354,WEDNESDAY,0,0,11.7,77,22.3,1010.1,Fair
2/16/2023 0:00,8,40,7782,27589,48,35371,THURSDAY,0,0,11.1,77,18.4,1010.7,Fair
2/16/2023 1:00,7,17,10050,13566,24,23616,THURSDAY,0,0,11.1,77,18.4,1010.7,Fair
2/16/2023 2:00,2,12,845,13974,14,14819,THURSDAY,0,0,10,80,16.6,1010.6,Fair
2/16/2023 3:00,0,6,0,6573,6,6573,THURSDAY,0,0,10,77,20.5,1010.3,Clear
2/16/2023 4:00,0,9,0,7675,9,7675,THURSDAY,0,0,10,77,20.5,1010.3,Clear
2/16/2023 5:00,5,43,3126,26462,48,29588,THURSDAY,0,0,10.6,68,18.4,1009.8,Clear
2/16/2023 6:00,20,158,16145,108792,178,124937,THURSDAY,0,0,11.7,64,24.1,1009.9,Clear
2/16/2023 7:00,44,414,43435,298212,458,341647,THURSDAY,0,0,11.7,64,24.1,1009.9,Clear
2/16/2023 8:00,97,833,92801,1143743,930,1236544,THURSDAY,0,0,10.6,66,11.2,1010.4,Clear
2/16/2023 9:00,73,510,113527,389876,583,503403,THURSDAY,0,0,10.6,66,16.6,1012.3,Clear
2/16/2023 10:00,52,263,69544,247069,315,316613,THURSDAY,0,0,10.6,66,16.6,1012.7,Clear
2/16/2023 11:00,60,321,186739,223271,381,410010,THURSDAY,0,0,10.6,63,13,1013.5,Fair
2/16/2023 12:00,78,344,150443,248144,422,398587,THURSDAY,0,0,13.3,53,16.6,1014.4,Fair
2/16/2023 13:00,80,347,142662,270927,427,413589,THURSDAY,0,0,13.3,53,16.6,1014.4,Fair
2/16/2023 14:00,90,325,99919,248716,415,348635,THURSDAY,0,0,15.6,41,16.6,1014.6,Fair
2/16/2023 15:00,118,454,220575,336348,572,556923,THURSDAY,0,0,16.1,38,20.5,1015.2,Cloudy
2/16/2023 16:00,159,599,273432,449940,758,723372,THURSDAY,0,0,16.7,36,20.5,1014.7,Cloudy
2/16/2023 17:00,141,804,359123,631217,945,990340,THURSDAY,0,0,16.1,36,18.4,1014,Cloudy
2/16/2023 18:00,107,639,204885,520756,746,725641,THURSDAY,0,0,16.1,36,18.4,1014,Cloudy
2/16/2023 19:00,55,367,67203,241796,422,308999,THURSDAY,0,0,16.7,35,18.4,1014,Cloudy
2/16/2023 20:00,45,295,175604,247524,340,423128,THURSDAY,0,0,16.7,35,11.2,1013.6,Cloudy
2/16/2023 21:00,52,227,64600,156107,279,220707,THURSDAY,0,0,16.1,36,9.4,1013.4,Cloudy
2/16/2023 22:00,38,136,66067,91274,174,157341,THURSDAY,0,0,16.1,36,9.4,1013.4,Cloudy
2/16/2023 23:00,19,101,15508,80855,120,96363,THURSDAY,0,0,15.6,39,7.6,1013.5,Cloudy
2/17/2023 0:00,36,53,1096437,38598,89,1135035,FRIDAY,0,0,13.3,49,9.4,1012.7,Cloudy
2/17/2023 1:00,18,24,16334,18308,42,34642,FRIDAY,0,0,10.6,63,9.4,1012.7,Cloudy
2/17/2023 2:00,11,17,13849,9834,28,23683,FRIDAY,0,0,10,68,11.2,1011.5,Cloudy
2/17/2023 3:00,4,3,2676,2924,7,5600,FRIDAY,0,0,9.4,66,7.6,1011.1,Rain
2/17/2023 4:00,3,8,8982,5008,11,13990,FRIDAY,0,0,9.4,66,7.6,1011.1,Rain
2/17/2023 5:00,7,33,3876,21752,40,25628,FRIDAY,0,0,7.8,79,5.4,1008.9,Cloudy
2/17/2023 6:00,15,135,16503,97255,150,113758,FRIDAY,0,0,7.8,83,0,1008.1,Cloudy
2/17/2023 7:00,29,292,20665,337669,321,358334,FRIDAY,0,0,6.7,85,0,1006.7,Cloudy
2/17/2023 8:00,51,567,43834,415152,618,458986,FRIDAY,0,0,6.7,85,0,1006.7,Cloudy
2/17/2023 9:00,53,426,58567,294981,479,353548,FRIDAY,0,0,8.3,93,11.2,1004.6,Cloudy
2/17/2023 10:00,33,197,34184,122796,230,156980,FRIDAY,0,0,8.3,93,7.6,1004.1,Cloudy
2/17/2023 11:00,24,197,25258,122271,221,147529,FRIDAY,0,0,8.3,93,7.6,1004.1,Cloudy
2/17/2023 12:00,43,252,46873,177260,295,224133,FRIDAY,0,0,10.6,92,11.2,1002.4,Rain
2/17/2023 13:00,70,316,89569,186849,386,276418,FRIDAY,0,0,10.6,92,20.5,1002.4,Rain
2/17/2023 14:00,69,262,107008,164730,331,271738,FRIDAY,0,0,12.8,87,24.1,1000.2,Rain
2/17/2023 15:00,69,323,91812,215164,392,306976,FRIDAY,0,0,13.3,87,20.5,999.2,Rain
2/17/2023 16:00,59,373,69056,257219,432,326275,FRIDAY,0,0,13.9,90,24.1,997.7,Rain
2/17/2023 17:00,32,274,51502,197911,306,249413,FRIDAY,0,0,13.9,90,24.1,997.7,Rain
2/17/2023 18:00,29,214,27866,166119,243,193985,FRIDAY,0,0,15,87,29.5,996.5,Rain
2/17/2023 19:00,35,166,35117,103282,201,138399,FRIDAY,0,0,12.8,80,18.4,997.8,Rain
2/17/2023 20:00,26,135,25308,78843,161,104151,FRIDAY,0,0,11.1,74,24.1,998.9,Rain
2/17/2023 21:00,21,99,21039,59879,120,80918,FRIDAY,0,0,11.1,74,24.1,998.9,Rain
2/17/2023 22:00,18,86,23621,51751,104,75372,FRIDAY,0,0,8.9,77,37.1,1000.1,Rain
2/17/2023 23:00,17,65,18861,40507,82,59368,FRIDAY,0,0,3.3,83,29.5,1002.4,Cloudy
2/18/2023 0:00,15,41,10905,23228,56,34133,SATURDAY,1,0,2.2,83,38.9,1006.2,Cloudy
2/18/2023 1:00,33,50,272587,30428,83,303015,SATURDAY,1,0,0,66,22.3,1007.5,Cloudy
2/18/2023 2:00,11,36,12533,28522,47,41055,SATURDAY,1,0,-1.7,63,22.3,1009,Cloudy
2/18/2023 3:00,1,3,286,1600,4,1886,SATURDAY,1,0,-1.7,63,35.3,1009,Cloudy
2/18/2023 4:00,1,4,956,3389,5,4345,SATURDAY,1,0,-2.8,53,37.1,1012.5,Cloudy
2/18/2023 5:00,2,10,921,10612,12,11533,SATURDAY,1,0,-3.3,50,35.3,1013.8,Fair
2/18/2023 6:00,10,26,10472,19583,36,30055,SATURDAY,1,0,-3.9,50,27.7,1015.9,Fair
2/18/2023 7:00,17,43,291960,21317,60,313277,SATURDAY,1,0,-3.9,50,27.7,1017,Fair
2/18/2023 8:00,17,92,17059,59157,109,76216,SATURDAY,1,0,-3.9,50,27.7,1017,Clear
2/18/2023 9:00,29,166,43569,110761,195,154330,SATURDAY,1,0,-3.9,48,25.9,1019.9,Clear
2/18/2023 10:00,48,214,74614,144203,262,218817,SATURDAY,1,0,-4.4,52,25.9,1021.2,Clear
2/18/2023 11:00,83,288,1116307,230022,371,1346329,SATURDAY,1,0,-5,59,16.6,1022.5,Fair
2/18/2023 12:00,103,325,176413,267349,428,443762,SATURDAY,1,0,-4.4,57,20.5,1023.7,Fair
2/18/2023 13:00,158,335,262208,277152,493,539360,SATURDAY,1,0,-4.4,57,20.5,1023.7,Fair
2/18/2023 14:00,130,331,174212,246612,461,420824,SATURDAY,1,0,-2.2,48,16.6,1024.7,Fair
2/18/2023 15:00,142,359,220908,296779,501,517687,SATURDAY,1,0,-1.1,44,14.8,1024.4,Fair
2/18/2023 16:00,159,366,317283,300203,525,617486,SATURDAY,1,0,0.6,36,13,1024.1,Fair
2/18/2023 17:00,103,318,554601,251050,421,805651,SATURDAY,1,0,0.6,36,13,1024.1,Fair
2/18/2023 18:00,70,305,136930,225007,375,361937,SATURDAY,1,0,1.7,35,20.5,1023,Fair
2/18/2023 19:00,57,237,97247,158034,294,255281,SATURDAY,1,0,3.3,35,14.8,1022.8,Fair
2/18/2023 20:00,45,181,34224,131879,226,166103,SATURDAY,1,0,4.4,16,20.5,1022.9,Fair
2/18/2023 21:00,36,124,57386,112518,160,169904,SATURDAY,1,0,3.9,30,20.5,1023.4,Fair
2/18/2023 22:00,32,112,1919412,71089,144,1990501,SATURDAY,1,0,3.9,30,20.5,1023.4,Fair
2/18/2023 23:00,29,83,29733,58611,112,88344,SATURDAY,1,0,2.8,35,16.6,1024.4,Fair
2/19/2023 0:00,38,74,35140,53807,112,88947,SUNDAY,1,0,2.2,40,14.8,1025.4,Fair
2/19/2023 1:00,76,58,231757,48929,134,280686,SUNDAY,1,0,2.2,40,14.8,1025.4,Clear
2/19/2023 2:00,24,32,1749120,25818,56,1774938,SUNDAY,1,0,0.6,47,16.6,1026.5,Clear
2/19/2023 3:00,4,9,5379,7935,13,13314,SUNDAY,1,0,0.6,53,18.4,1026.5,Clear
2/19/2023 4:00,2,8,910,4639,10,5549,SUNDAY,1,0,0.6,56,20.5,1026.5,Clear
2/19/2023 5:00,5,17,7736,14337,22,22073,SUNDAY,1,0,1.1,54,20.5,1026.6,Fair
2/19/2023 6:00,3,35,2302,21910,38,24212,SUNDAY,1,0,1.1,54,20.5,1026.6,Fair
2/19/2023 7:00,16,56,31923,31111,72,63034,SUNDAY,1,0,2.2,48,16.6,1027,Fair
2/19/2023 8:00,29,101,47044,68461,130,115505,SUNDAY,1,0,2.2,46,16.6,1027.5,Fair
2/19/2023 9:00,56,189,73193,126009,245,199202,SUNDAY,1,0,0.6,56,9.4,1027.8,Fair
2/19/2023 10:00,116,274,220293,193813,390,414106,SUNDAY,1,0,0.6,56,9.4,1027.8,Fair
2/19/2023 11:00,128,310,247614,256813,438,504427,SUNDAY,1,0,0.6,56,11.2,1029,Cloudy
2/19/2023 12:00,118,315,163662,259349,433,423011,SUNDAY,1,0,2.8,48,5.4,1029.4,Cloudy
2/19/2023 13:00,187,325,1185452,696213,512,1881665,SUNDAY,1,0,2.8,48,5.4,1029.4,Cloudy
2/19/2023 14:00,143,359,512352,284565,502,796917,SUNDAY,1,0,5,43,9.4,1028.2,Cloudy
2/19/2023 15:00,120,302,399618,253949,422,653567,SUNDAY,1,0,4.4,46,9.4,1028.6,Cloudy
2/19/2023 16:00,145,334,202682,686543,479,889225,SUNDAY,1,0,4.4,46,9.4,1028.6,Cloudy
2/19/2023 17:00,101,337,144670,243289,438,387959,SUNDAY,1,0,5,62,20.5,1026,Cloudy
2/19/2023 18:00,73,278,226431,193674,351,420105,SUNDAY,1,0,7.8,45,16.6,1024.1,Cloudy
2/19/2023 19:00,63,210,68272,148496,273,216768,SUNDAY,1,0,7.8,40,16.6,1023.3,Cloudy
2/19/2023 20:00,43,141,58952,100246,184,159198,SUNDAY,1,0,7.8,40,25.9,1023.3,Cloudy
2/19/2023 21:00,53,136,66934,88891,189,155825,SUNDAY,1,0,6.7,55,22.3,1021,Cloudy
2/19/2023 22:00,38,88,130648,65193,126,195841,SUNDAY,1,0,5.6,64,20.5,1020.7,Cloudy
2/19/2023 23:00,47,73,1387139,43419,120,1430558,SUNDAY,1,0,5.6,73,18.4,1019.9,Cloudy
2/20/2023 0:00,23,44,108587,29585,67,138172,MONDAY,0,1,5.6,73,18.4,1019.9,Cloudy
2/20/2023 1:00,24,25,36449,15278,49,51727,MONDAY,0,1,5,76,18.4,1017.5,Cloudy
2/20/2023 2:00,10,20,17077,12525,30,29602,MONDAY,0,1,5.6,76,16.6,1017,Cloudy
2/20/2023 3:00,10,7,17897,5648,17,23545,MONDAY,0,1,5.6,76,16.6,1017,Cloudy
2/20/2023 4:00,1,8,211,8940,9,9151,MONDAY,0,1,5.6,79,14.8,1015.7,Cloudy
2/20/2023 5:00,3,20,837,8814,23,9651,MONDAY,0,1,8.3,83,14.8,1013.8,Cloudy
2/20/2023 6:00,8,65,10237,37128,73,47365,MONDAY,0,1,8.3,83,14.8,1013.8,Cloudy
2/20/2023 7:00,21,107,34937,79456,128,114393,MONDAY,0,1,8.9,86,13,1011.5,Cloudy
2/20/2023 8:00,30,198,28802,139365,228,168167,MONDAY,0,1,8.9,89,13,1010.4,Cloudy
2/20/2023 9:00,71,226,105857,149053,297,254910,MONDAY,0,1,7.8,89,14.8,1009.1,Cloudy
2/20/2023 10:00,87,256,163497,198642,343,362139,MONDAY,0,1,7.8,89,14.8,1009.1,Cloudy
2/20/2023 11:00,152,353,277540,255721,505,533261,MONDAY,0,1,7.8,93,14.8,1007.5,Cloudy
2/20/2023 12:00,188,408,941977,320433,596,1262410,MONDAY,0,1,8.9,89,16.6,1006.8,Cloudy
2/20/2023 13:00,236,370,588341,312788,606,901129,MONDAY,0,1,10,83,16.6,1006.1,Cloudy
2/20/2023 14:00,245,377,688364,343901,622,1032265,MONDAY,0,1,11.1,71,14.8,1005.1,Cloudy
2/20/2023 15:00,273,453,1380358,408980,726,1789338,MONDAY,0,1,11.1,71,14.8,1005.1,Cloudy
2/20/2023 16:00,225,469,530302,370613,694,900915,MONDAY,0,1,15.6,42,22.3,1002.6,Cloudy
2/20/2023 17:00,179,483,247037,371250,662,618287,MONDAY,0,1,14.4,40,22.3,1002,Cloudy
2/20/2023 18:00,98,423,132286,297122,521,429408,MONDAY,0,1,15.6,33,20.5,1000.6,Cloudy
2/20/2023 19:00,64,306,125852,269509,370,395361,MONDAY,0,1,15.6,33,14.8,1000.7,Cloudy
2/20/2023 20:00,45,212,55035,130776,257,185811,MONDAY,0,1,15.6,33,14.8,1000.7,Cloudy
2/20/2023 21:00,36,156,301022,101098,192,402120,MONDAY,0,1,13.9,36,22.3,1001.7,Cloudy
2/20/2023 22:00,21,101,23556,62482,122,86038,MONDAY,0,1,12.8,38,16.6,1002.6,Cloudy
2/20/2023 23:00,18,44,20375,29790,62,50165,MONDAY,0,1,11.7,38,18.4,1003.2,Cloudy
2/21/2023 0:00,13,40,197224,17814,53,215038,TUESDAY,0,0,11.7,38,18.4,1003.2,Cloudy
2/21/2023 1:00,6,13,5796,6165,19,11961,TUESDAY,0,0,9.4,39,24.1,1004.3,Cloudy
2/21/2023 2:00,3,7,1591,3853,10,5444,TUESDAY,0,0,8.9,40,18.4,1004.4,Cloudy
2/21/2023 3:00,5,2,34133,1307,7,35440,TUESDAY,0,0,7.8,43,14.8,1004.7,Cloudy
2/21/2023 4:00,1,6,867,5055,7,5922,TUESDAY,0,0,7.8,43,14.8,1004.3,Cloudy
2/21/2023 5:00,6,36,2500,20576,42,23076,TUESDAY,0,0,7.8,43,14.8,1004.3,Cloudy
2/21/2023 6:00,7,73,5359,43026,80,48385,TUESDAY,0,0,6.1,53,13,1004.7,Cloudy
2/21/2023 7:00,12,148,9906,95006,160,104912,TUESDAY,0,0,5,65,14.8,1004.8,Cloudy
2/21/2023 8:00,14,322,16595,213284,336,229879,TUESDAY,0,0,5,65,14.8,1004.8,Cloudy
2/21/2023 9:00,17,243,15360,145945,260,161305,TUESDAY,0,0,5,57,11.2,1005.4,Snow
2/21/2023 10:00,10,164,10177,112258,174,122435,TUESDAY,0,0,1.7,89,11.2,1005.5,Rain
2/21/2023 11:00,28,203,30467,131943,231,162410,TUESDAY,0,0,1.1,92,9.4,1005.3,Rain
2/21/2023 12:00,25,223,21043,126777,248,147820,TUESDAY,0,0,1.1,92,11.2,1005.9,Snow
2/21/2023 13:00,27,226,39788,152617,253,192405,TUESDAY,0,0,1.1,92,11.2,1005.9,Snow
2/21/2023 14:00,29,244,41357,138167,273,179524,TUESDAY,0,0,1.1,97,14.8,1005.5,Snow
2/21/2023 15:00,52,279,117331,165877,331,283208,TUESDAY,0,0,3.3,93,25.9,1004.2,Snow
2/21/2023 16:00,49,391,55826,271327,440,327153,TUESDAY,0,0,3.3,93,25.9,1004.2,Cloudy
2/21/2023 17:00,66,642,82911,508541,708,591452,TUESDAY,0,0,3.3,93,18.4,1003.1,Cloudy
2/21/2023 18:00,54,473,43963,311611,527,355574,TUESDAY,0,0,3.9,89,13,1002.4,Cloudy
2/21/2023 19:00,27,266,251278,170259,293,421537,TUESDAY,0,0,3.9,89,13,1002.4,Cloudy
2/21/2023 20:00,20,175,27692,126662,195,154354,TUESDAY,0,0,3.9,86,9.4,1003.2,Cloudy
2/21/2023 21:00,17,175,16379,126703,192,143082,TUESDAY,0,0,3.9,86,13,1003.5,Cloudy
2/21/2023 22:00,10,95,12248,96089,105,108337,TUESDAY,0,0,3.9,86,11.2,1004.8,Cloudy
2/21/2023 23:00,11,45,10862,27406,56,38268,TUESDAY,0,0,3.9,89,11.2,1005.5,Cloudy
2/22/2023 0:00,6,28,4213,18304,34,22517,WEDNESDAY,0,0,3.9,89,11.2,1005.5,Cloudy
2/22/2023 1:00,9,11,12926,9434,20,22360,WEDNESDAY,0,0,3.9,89,16.6,1007.2,Cloudy
2/22/2023 2:00,3,4,2199,1181,7,3380,WEDNESDAY,0,0,4.4,89,18.4,1008,Cloudy
2/22/2023 3:00,1,5,1898,7132,6,9030,WEDNESDAY,0,0,4.4,89,22.3,1008.5,Cloudy
2/22/2023 4:00,0,2,0,1324,2,1324,WEDNESDAY,0,0,4.4,76,24.1,1009.8,Cloudy
2/22/2023 5:00,6,38,3786,20943,44,24729,WEDNESDAY,0,0,4.4,76,24.1,1009.8,Fair
2/22/2023 6:00,12,133,642786,89248,145,732034,WEDNESDAY,0,0,3.3,59,24.1,1011.7,Fair
2/22/2023 7:00,29,355,19623,255508,384,275131,WEDNESDAY,0,0,2.8,61,16.6,1012.5,Fair
2/22/2023 8:00,56,739,74057,624808,795,698865,WEDNESDAY,0,0,2.8,59,18.4,1013.9,Clear
2/22/2023 9:00,43,427,83534,312102,470,395636,WEDNESDAY,0,0,2.8,59,18.4,1013.9,Clear
2/22/2023 10:00,41,286,64678,190382,327,255060,WEDNESDAY,0,0,2.8,59,18.4,1016.1,Fair
2/22/2023 11:00,41,270,47119,158596,311,205715,WEDNESDAY,0,0,2.8,57,16.6,1017.2,Fair
2/22/2023 12:00,32,292,49647,193162,324,242809,WEDNESDAY,0,0,3.3,57,18.4,1018.9,Fair
2/22/2023 13:00,65,262,386919,198069,327,584988,WEDNESDAY,0,0,4.4,51,16.6,1019.3,Fair
2/22/2023 14:00,37,277,45287,173654,314,218941,WEDNESDAY,0,0,4.4,51,16.6,1019.3,Fair
2/22/2023 15:00,65,315,114562,203381,380,317943,WEDNESDAY,0,0,5.6,41,14.8,1020,Cloudy
2/22/2023 16:00,80,475,115152,324990,555,440142,WEDNESDAY,0,0,6.1,43,20.5,1019.6,Cloudy
2/22/2023 17:00,84,705,98738,523918,789,622656,WEDNESDAY,0,0,6.1,39,14.8,1019.6,Cloudy
2/22/2023 18:00,73,511,82895,391224,584,474119,WEDNESDAY,0,0,6.1,41,16.6,1019.4,Cloudy
2/22/2023 19:00,38,330,34940,222600,368,257540,WEDNESDAY,0,0,6.1,41,16.6,1019.4,Cloudy
2/22/2023 20:00,35,192,36094,112764,227,148858,WEDNESDAY,0,0,6.1,43,14.8,1019.8,Cloudy
2/22/2023 21:00,10,113,6948,64961,123,71909,WEDNESDAY,0,0,6.1,43,14.8,1019.8,Cloudy
2/22/2023 22:00,4,65,2880,45347,69,48227,WEDNESDAY,0,0,5,46,9.4,1020.4,Cloudy
2/22/2023 23:00,3,28,3512,16179,31,19691,WEDNESDAY,0,0,5,46,9.4,1020.4,Snow
2/23/2023 0:00,3,5,5201,3304,8,8505,THURSDAY,0,0,3.3,62,9.4,1020.6,Snow
2/23/2023 1:00,4,6,5245,6501,10,11746,THURSDAY,0,0,1.7,78,9.4,1019.8,Snow
2/23/2023 2:00,1,2,1719,1854,3,3573,THURSDAY,0,0,1.7,78,9.4,1019.8,Snow
2/23/2023 3:00,0,1,0,451,1,451,THURSDAY,0,0,0.6,92,14.8,1019.6,Rain
2/23/2023 4:00,0,4,0,3995,4,3995,THURSDAY,0,0,0.6,92,14.8,1019.6,Snow
2/23/2023 5:00,0,21,0,18593,21,18593,THURSDAY,0,0,0.6,96,18.4,1018.9,Snow
2/23/2023 6:00,2,37,2525,24270,39,26795,THURSDAY,0,0,1.1,92,20.5,1018.7,Snow
2/23/2023 7:00,2,88,1627,67511,90,69138,THURSDAY,0,0,1.1,92,25.9,1017,Snow
2/23/2023 8:00,5,178,7865,136501,183,144366,THURSDAY,0,0,0.6,96,29.5,1015.8,Snow
2/23/2023 9:00,10,158,12738,110751,168,123489,THURSDAY,0,0,1.1,97,31.7,1014.9,Snow
2/23/2023 10:00,3,77,3533,72250,80,75783,THURSDAY,0,0,1.1,100,38.9,1013.2,Snow
2/23/2023 11:00,4,58,4615,37008,62,41623,THURSDAY,0,0,1.1,100,37.1,1013.2,Snow
2/23/2023 12:00,10,77,8534,48362,87,56896,THURSDAY,0,0,0.6,100,35.3,1014.2,Snow
2/23/2023 13:00,5,86,4945,71393,91,76338,THURSDAY,0,0,0.6,100,40.7,1014.4,Snow
2/23/2023 14:00,10,78,22005,47102,88,69107,THURSDAY,0,0,1.1,97,40.7,1014.7,Cloudy
2/23/2023 15:00,17,127,10734,75628,144,86362,THURSDAY,0,0,0.6,96,25.9,1015.1,Snow
2/23/2023 16:00,8,144,6118,103576,152,109694,THURSDAY,0,0,0,96,27.7,1015.1,Snow
2/23/2023 17:00,12,226,15848,179100,238,194948,THURSDAY,0,0,-0.6,100,29.5,1015.4,Snow
2/23/2023 18:00,16,183,14907,135271,199,150178,THURSDAY,0,0,-0.6,96,29.5,1015.3,Snow
2/23/2023 19:00,7,130,8150,93627,137,101777,THURSDAY,0,0,-0.6,96,27.7,1016.2,Snow
2/23/2023 20:00,5,106,2919,74417,111,77336,THURSDAY,0,0,-2.2,96,14.8,1017.3,Snow
2/23/2023 21:00,2,95,1866,59594,97,61460,THURSDAY,0,0,-1.1,92,20.5,1017.2,Snow
2/23/2023 22:00,2,45,973,34545,47,35518,THURSDAY,0,0,-1.7,96,11.2,1017,Snow
2/23/2023 23:00,1,19,855,14377,20,15232,THURSDAY,0,0,-1.7,96,11.2,1017,Snow
2/24/2023 0:00,2,17,2110,9179,19,11289,FRIDAY,0,0,-2.2,88,11.2,1017,Snow
2/24/2023 1:00,10,7,18398,11396,17,29794,FRIDAY,0,0,-3.3,92,14.8,1015.1,Snow
2/24/2023 2:00,4,4,3876,5233,8,9109,FRIDAY,0,0,-2.8,92,9.4,1013.9,Snow
2/24/2023 3:00,2,1,2670,774,3,3444,FRIDAY,0,0,-2.8,92,16.6,1014,Snow
2/24/2023 4:00,2,8,1664,7481,10,9145,FRIDAY,0,0,-2.8,92,16.6,1014,Snow
2/24/2023 5:00,0,11,0,7573,11,7573,FRIDAY,0,0,-2.2,92,7.6,1013.2,Cloudy
2/24/2023 6:00,12,73,9010,57812,85,66822,FRIDAY,0,0,-2.2,92,7.6,1013.2,Cloudy
2/24/2023 7:00,5,134,6074,98219,139,104293,FRIDAY,0,0,-1.7,89,7.6,1012.8,Cloudy
2/24/2023 8:00,21,273,18592,213159,294,231751,FRIDAY,0,0,-1.7,92,0,1012.3,Cloudy
2/24/2023 9:00,22,249,24897,167189,271,192086,FRIDAY,0,0,-0.6,89,14.8,1012,Cloudy
2/24/2023 10:00,27,186,36053,110965,213,147018,FRIDAY,0,0,2.8,70,20.5,1011.8,Cloudy
2/24/2023 11:00,22,170,17613,131972,192,149585,FRIDAY,0,0,3.3,64,33.5,1012.7,Cloudy
2/24/2023 12:00,31,194,46830,125872,225,172702,FRIDAY,0,0,3.3,64,33.5,1012.7,Cloudy
2/24/2023 13:00,25,172,26457,125350,197,151807,FRIDAY,0,0,1.7,72,16.6,1015.9,Cloudy
2/24/2023 14:00,30,180,36403,108711,210,145114,FRIDAY,0,0,1.7,72,16.6,1015.9,Fair
2/24/2023 15:00,28,229,25396,161666,257,187062,FRIDAY,0,0,0,61,25.9,1018.4,Fair
2/24/2023 16:00,31,308,46607,221029,339,267636,FRIDAY,0,0,0,51,38.9,1019.5,Cloudy
2/24/2023 17:00,35,363,31595,269131,398,300726,FRIDAY,0,0,-1.1,51,51.8,1020.8,Cloudy
2/24/2023 18:00,33,274,30196,242407,307,272603,FRIDAY,0,0,-1.1,44,37.1,1022.2,Cloudy
2/24/2023 19:00,21,195,31464,148554,216,180018,FRIDAY,0,0,-1.1,44,37.1,1022.2,Cloudy
2/24/2023 20:00,17,136,14024,86784,153,100808,FRIDAY,0,0,-1.1,43,31.7,1024.6,Fair
2/24/2023 21:00,14,82,11873,52999,96,64872,FRIDAY,0,0,-1.7,43,27.7,1026.1,Fair
2/24/2023 22:00,19,82,18232,51255,101,69487,FRIDAY,0,0,-2.8,46,22.3,1027.6,Fair
2/24/2023 23:00,14,43,55893,28856,57,84749,FRIDAY,0,0,-2.8,46,22.3,1027.6,Fair
2/25/2023 0:00,13,38,32077,21209,51,53286,SATURDAY,1,0,-4.4,48,25.9,1030.2,Fair
2/25/2023 1:00,11,48,22491,36106,59,58597,SATURDAY,1,0,-5,48,16.6,1031.5,Fair
2/25/2023 2:00,8,12,27274,9283,20,36557,SATURDAY,1,0,-6.1,54,14.8,1032.4,Fair
2/25/2023 3:00,0,6,0,2438,6,2438,SATURDAY,1,0,-6.7,54,14.8,1032.8,Clear
2/25/2023 4:00,2,2,1981,1492,4,3473,SATURDAY,1,0,-6.7,54,14.8,1032.8,Clear
2/25/2023 5:00,5,6,10136,2458,11,12594,SATURDAY,1,0,-8.3,56,20.5,1034,Clear
2/25/2023 6:00,2,20,4490,14882,22,19372,SATURDAY,1,0,-8.9,58,14.8,1034.4,Clear
2/25/2023 7:00,7,35,8814,25194,42,34008,SATURDAY,1,0,-9.4,58,16.6,1034.1,Clear
2/25/2023 8:00,15,56,121084,42230,71,163314,SATURDAY,1,0,-9.4,53,14.8,1034.3,Clear
2/25/2023 9:00,15,107,7968,68760,122,76728,SATURDAY,1,0,-10,56,16.6,1034,Clear
2/25/2023 10:00,19,155,40446,104809,174,145255,SATURDAY,1,0,-10,56,16.6,1034,Clear
2/25/2023 11:00,23,149,39207,93573,172,132780,SATURDAY,1,0,-10,51,16.6,1034.4,Fair
2/25/2023 12:00,24,172,25498,112001,196,137499,SATURDAY,1,0,-10,48,18.4,1033.9,Cloudy
2/25/2023 13:00,39,181,39302,127730,220,167032,SATURDAY,1,0,-10,48,18.4,1033.9,Cloudy
2/25/2023 14:00,36,155,35881,97748,191,133629,SATURDAY,1,0,-9.4,40,9.4,1033,Cloudy
2/25/2023 15:00,29,182,37660,122395,211,160055,SATURDAY,1,0,-9.4,40,9.4,1033,Cloudy
2/25/2023 16:00,13,148,15211,126420,161,141631,SATURDAY,1,0,-8.3,42,11.2,1032.1,Cloudy
2/25/2023 17:00,15,121,15303,161950,136,177253,SATURDAY,1,0,-7.8,41,7.6,1028.6,Cloudy
2/25/2023 18:00,13,107,12371,84122,120,96493,SATURDAY,1,0,-7.8,41,7.6,1028.6,Cloudy
2/25/2023 19:00,8,103,7050,74464,111,81514,SATURDAY,1,0,-6.7,45,11.2,1027.6,Cloudy
2/25/2023 20:00,7,72,5934,61489,79,67423,SATURDAY,1,0,-6.7,45,11.2,1027.6,Cloudy
2/25/2023 21:00,8,50,8756,41607,58,50363,SATURDAY,1,0,-7.2,70,0,1025.3,Cloudy
2/25/2023 22:00,2,42,1550,43159,44,44709,SATURDAY,1,0,-7.2,70,0,1025.3,Cloudy
2/25/2023 23:00,7,46,6660,36366,53,43026,SATURDAY,1,0,-7.2,77,7.6,1025.2,Snow
2/26/2023 0:00,14,39,11338,29583,53,40921,SUNDAY,1,0,-7.2,77,11.2,1024.3,Snow
2/26/2023 1:00,18,26,19052,22463,44,41515,SUNDAY,1,0,-7.2,77,11.2,1023.9,Snow
2/26/2023 2:00,10,21,290125,18613,31,308738,SUNDAY,1,0,-7.8,80,9.4,1023,Snow
2/26/2023 3:00,1,5,323,2512,6,2835,SUNDAY,1,0,-7.2,80,11.2,1022.2,Cloudy
2/26/2023 4:00,1,6,1222,6525,7,7747,SUNDAY,1,0,-7.2,80,11.2,1022.2,Cloudy
2/26/2023 5:00,1,8,184,5508,9,5692,SUNDAY,1,0,-7.2,80,7.6,1021.2,Cloudy
2/26/2023 6:00,2,26,1113,16247,28,17360,SUNDAY,1,0,-7.2,80,7.6,1021.2,Cloudy
2/26/2023 7:00,2,28,1678,16181,30,17859,SUNDAY,1,0,-6.7,88,5.4,1019.5,Cloudy
2/26/2023 8:00,10,74,698100,47965,84,746065,SUNDAY,1,0,-6.7,88,5.4,1019.5,Cloudy
2/26/2023 9:00,19,131,21351,75159,150,96510,SUNDAY,1,0,-5.6,81,9.4,1018.7,Cloudy
2/26/2023 10:00,28,151,50454,104507,179,154961,SUNDAY,1,0,-6.1,84,5.4,1017.8,Cloudy
2/26/2023 11:00,32,186,27324,121415,218,148739,SUNDAY,1,0,-5.6,85,0,1017.8,Cloudy
2/26/2023 12:00,35,231,51462,166960,266,218422,SUNDAY,1,0,-5,81,13,1017.4,Cloudy
2/26/2023 13:00,51,228,65347,162390,279,227737,SUNDAY,1,0,-5,81,13,1017.4,Cloudy
2/26/2023 14:00,42,261,56848,173001,303,229849,SUNDAY,1,0,-3.9,81,11.2,1014.6,Cloudy
2/26/2023 15:00,49,242,70137,162590,291,232727,SUNDAY,1,0,-3.3,84,9.4,1013,Cloudy
2/26/2023 16:00,43,257,57827,181942,300,239769,SUNDAY,1,0,-1.7,78,16.6,1010.9,Cloudy
2/26/2023 17:00,42,281,56761,189155,323,245916,SUNDAY,1,0,-0.6,78,14.8,1009.3,Cloudy
2/26/2023 18:00,32,265,389188,182550,297,571738,SUNDAY,1,0,-0.6,78,14.8,1009.3,Cloudy
2/26/2023 19:00,17,182,19289,112290,199,131579,SUNDAY,1,0,1.1,79,16.6,1006.7,Cloudy
2/26/2023 20:00,16,139,13118,86867,155,99985,SUNDAY,1,0,2.2,70,22.3,1006.2,Cloudy
2/26/2023 21:00,14,100,14519,57263,114,71782,SUNDAY,1,0,2.8,67,18.4,1006,Cloudy
2/26/2023 22:00,8,70,7978,44066,78,52044,SUNDAY,1,0,2.8,67,18.4,1006,Cloudy
2/26/2023 23:00,3,36,2849,25673,39,28522,SUNDAY,1,0,2.8,64,13,1007,Cloudy
2/27/2023 0:00,3,17,4068,7979,20,12047,MONDAY,0,0,1.7,69,16.6,1007.4,Cloudy
2/27/2023 1:00,4,17,7592,7519,21,15111,MONDAY,0,0,-2.8,81,14.8,1007.9,Fair
2/27/2023 2:00,3,2,2784,1900,5,4684,MONDAY,0,0,-3.9,81,14.8,1009,Fair
2/27/2023 3:00,0,1,0,458,1,458,MONDAY,0,0,-3.9,81,24.1,1009,Fair
2/27/2023 4:00,2,6,4394,7053,8,11447,MONDAY,0,0,-2.2,71,13,1009.5,Cloudy
2/27/2023 5:00,3,40,2116,20046,43,22162,MONDAY,0,0,-2.2,69,11.2,1010.2,Cloudy
2/27/2023 6:00,8,116,15270,61051,124,76321,MONDAY,0,0,-2.2,69,14.8,1010.9,Cloudy
2/27/2023 7:00,18,258,81307,177124,276,258431,MONDAY,0,0,-2.2,66,16.6,1011.4,Fair
2/27/2023 8:00,34,554,32478,406583,588,439061,MONDAY,0,0,-2.2,66,16.6,1011.4,Fair
2/27/2023 9:00,29,353,19619,229798,382,249417,MONDAY,0,0,-2.8,69,20.5,1013.6,Fair
2/27/2023 10:00,29,233,40503,149701,262,190204,MONDAY,0,0,-2.8,63,20.5,1014.6,Fair
2/27/2023 11:00,27,212,43867,155901,239,199768,MONDAY,0,0,-2.8,66,18.4,1015.6,Fair
2/27/2023 12:00,32,244,113603,152491,276,266094,MONDAY,0,0,-1.7,63,16.6,1016.1,Fair
2/27/2023 13:00,33,206,51809,138412,239,190221,MONDAY,0,0,-1.7,56,24.1,1017.2,Fair
2/27/2023 14:00,20,223,23786,151116,243,174902,MONDAY,0,0,-1.7,56,24.1,1017.2,Fair
2/27/2023 15:00,37,267,29382,189559,304,218941,MONDAY,0,0,-0.6,54,11.2,1017.1,Fair
2/27/2023 16:00,42,450,34896,325079,492,359975,MONDAY,0,0,-1.1,58,14.8,1017,Fair
2/27/2023 17:00,49,591,65110,932491,640,997601,MONDAY,0,0,-1.1,60,14.8,1017.1,Cloudy
2/27/2023 18:00,37,406,33555,294460,443,328015,MONDAY,0,0,-1.1,60,14.8,1017.1,Cloudy
2/27/2023 19:00,36,296,97802,192295,332,290097,MONDAY,0,0,-1.1,63,16.6,1016.1,Cloudy
2/27/2023 20:00,34,202,26177,136089,236,162266,MONDAY,0,0,-1.1,63,16.6,1016.1,Cloudy
2/27/2023 21:00,16,147,14911,97774,163,112685,MONDAY,0,0,-1.7,63,18.4,1016.1,Cloudy
2/27/2023 22:00,18,96,13423,115226,114,128649,MONDAY,0,0,-1.7,63,18.4,1016.1,Cloudy
2/27/2023 23:00,6,36,35718,21439,42,57157,MONDAY,0,0,-1.1,63,25.9,1015.4,Cloudy
2/28/2023 0:00,0,16,0,6666,16,6666,TUESDAY,0,0,-1.1,60,22.3,1015,Cloudy
2/28/2023 1:00,1,7,1258,7629,8,8887,TUESDAY,0,0,-1.1,63,22.3,1014.1,Cloudy
2/28/2023 2:00,0,2,0,498,2,498,TUESDAY,0,0,-1.1,63,25.9,1015.1,Cloudy
2/28/2023 4:00,0,7,0,5505,7,5505,TUESDAY,0,0,-0.6,66,18.4,1013.1,Snow
2/28/2023 5:00,1,14,631,11649,15,12280,TUESDAY,0,0,-0.6,69,24.1,1012.3,Snow
2/28/2023 6:00,4,53,2704,46950,57,49654,TUESDAY,0,0,-0.6,69,24.1,1012.3,Snow
2/28/2023 7:00,7,132,5850,93498,139,99348,TUESDAY,0,0,-1.1,75,27.7,1011.2,Snow
2/28/2023 8:00,14,282,10685,198365,296,209050,TUESDAY,0,0,-1.1,78,27.7,1009.9,Snow
2/28/2023 9:00,13,197,7903,120837,210,128740,TUESDAY,0,0,0,81,24.1,1008.9,Snow
2/28/2023 10:00,9,107,3697,58186,116,61883,TUESDAY,0,0,0,81,27.7,1008.9,Snow
2/28/2023 11:00,6,90,2908,58241,96,61149,TUESDAY,0,0,0,88,25.9,1008.9,Snow
2/28/2023 12:00,6,117,29571,71485,123,101056,TUESDAY,0,0,1.1,92,29.5,1008.9,Snow
2/28/2023 13:00,7,86,5005,43571,93,48576,TUESDAY,0,0,1.1,92,38.9,1009.2,Snow
2/28/2023 14:00,7,91,3486,44426,98,47912,TUESDAY,0,0,1.1,92,44.6,1008.4,Snow
2/28/2023 15:00,13,104,15593,62723,117,78316,TUESDAY,0,0,1.7,89,37.1,1008.7,Snow
2/28/2023 16:00,19,165,16586,97151,184,113737,TUESDAY,0,0,1.7,92,31.7,1008.6,Snow
2/28/2023 17:00,21,261,19194,182167,282,201361,TUESDAY,0,0,1.7,92,35.3,1008.6,Snow
2/28/2023 18:00,20,238,13426,156994,258,170420,TUESDAY,0,0,2.2,92,29.5,1008.6,Snow
2/28/2023 19:00,11,162,7112,106567,173,113679,TUESDAY,0,0,2.2,92,29.5,1008.6,Snow
2/28/2023 20:00,10,157,13771,102200,167,115971,TUESDAY,0,0,2.2,92,25.9,1009.9,Snow
2/28/2023 21:00,15,111,9559,75184,126,84743,TUESDAY,0,0,2.2,92,25.9,1010.9,Snow
2/28/2023 22:00,10,78,45177,50794,88,95971,TUESDAY,0,0,2.2,92,22.3,1010.9,Snow
2/28/2023 23:00,11,50,7700,72662,61,80362,TUESDAY,0,0,2.2,97,14.8,1012.3,Rain
3/1/2023 0:00,11,50,7700,72662,61,80362,WEDNESDAY,0,0,2.2,97,14.8,1012.3,Rain
3/1/2023 1:00,7,23,8287,15372,30,23659,WEDNESDAY,0,0,2.2,92,0,1013.7,Snow
3/1/2023 2:00,3,10,2423,8737,13,11160,WEDNESDAY,0,0,1.7,92,13,1014.3,Snow
3/1/2023 3:00,4,3,4770,1251,7,6021,WEDNESDAY,0,0,1.7,92,13,1014.3,Snow
3/1/2023 4:00,0,1,0,625,1,625,WEDNESDAY,0,0,1.7,92,11.2,1015.1,Rain
3/1/2023 5:00,0,3,0,2000,3,2000,WEDNESDAY,0,0,1.7,89,14.8,1015.2,Cloudy
3/1/2023 6:00,4,38,2754,49550,42,52304,WEDNESDAY,0,0,1.1,92,13,1015.9,Fair
3/1/2023 7:00,10,110,52996,72406,120,125402,WEDNESDAY,0,0,1.1,92,13,1015.9,Fair
3/1/2023 8:00,23,322,21349,223257,345,244606,WEDNESDAY,0,0,1.1,82,14.8,1017.7,Fair
3/1/2023 9:00,63,731,71284,515535,794,586819,WEDNESDAY,0,0,1.1,79,14.8,1018.9,Clear
3/1/2023 10:00,43,425,39018,307926,468,346944,WEDNESDAY,0,0,0.6,82,14.8,1019.7,Fair
3/1/2023 11:00,38,257,70715,209790,295,280505,WEDNESDAY,0,0,1.1,73,14.8,1020.9,Fair
3/1/2023 12:00,35,284,39245,201021,319,240266,WEDNESDAY,0,0,1.1,73,16.6,1021.7,Fair
3/1/2023 13:00,42,276,42069,176235,318,218304,WEDNESDAY,0,0,1.1,73,16.6,1021.7,Fair
3/1/2023 14:00,59,274,116646,185564,333,302210,WEDNESDAY,0,0,3.9,59,13,1021.2,Fair
3/1/2023 15:00,46,285,1264738,182189,331,1446927,WEDNESDAY,0,0,4.4,51,0,1021.4,Cloudy
3/1/2023 16:00,56,312,62684,204848,368,267532,WEDNESDAY,0,0,5,53,9.4,1020.5,Cloudy
3/1/2023 17:00,68,468,69049,347685,536,416734,WEDNESDAY,0,0,5.6,53,7.6,1020.1,Cloudy
3/1/2023 18:00,97,720,1700694,579844,817,2280538,WEDNESDAY,0,0,5.6,53,7.6,1020.1,Cloudy
3/1/2023 19:00,57,520,110658,368062,577,478720,WEDNESDAY,0,0,3.9,59,16.6,1019.9,Cloudy
3/1/2023 20:00,46,361,133978,304923,407,438901,WEDNESDAY,0,0,3.3,64,16.6,1019.5,Cloudy
3/1/2023 21:00,28,237,23734,164140,265,187874,WEDNESDAY,0,0,2.8,64,14.8,1019.7,Cloudy
3/1/2023 22:00,25,187,31897,128917,212,160814,WEDNESDAY,0,0,2.8,67,14.8,1019.6,Cloudy
3/1/2023 23:00,23,137,22759,99694,160,122453,WEDNESDAY,0,0,2.8,67,14.8,1019.6,Cloudy
3/2/2023 0:00,12,70,1020779,37783,82,1058562,THURSDAY,0,0,2.8,72,20.5,1018.8,Cloudy
3/2/2023 1:00,15,28,28670,19936,43,48606,THURSDAY,0,0,2.8,76,18.4,1018.3,Cloudy
3/2/2023 2:00,7,18,7094,10996,25,18090,THURSDAY,0,0,2.8,78,13,1018,Cloudy
3/2/2023 3:00,5,4,15308,3376,9,18684,THURSDAY,0,0,2.8,78,13,1018,Cloudy
3/2/2023 4:00,7,6,18741,7070,13,25811,THURSDAY,0,0,2.8,78,9.4,1016.2,Cloudy
3/2/2023 5:00,0,8,0,4300,8,4300,THURSDAY,0,0,2.8,78,7.6,1015.3,Cloudy
3/2/2023 6:00,0,11,0,5749,11,5749,THURSDAY,0,0,2.8,82,13,1013.9,Rain
3/2/2023 7:00,4,46,1877,24992,50,26869,THURSDAY,0,0,3.3,79,11.2,1012.3,Rain
3/2/2023 8:00,5,123,5255,89163,128,94418,THURSDAY,0,0,3.3,79,11.2,1012.3,Rain
3/2/2023 9:00,17,238,13362,159295,255,172657,THURSDAY,0,0,3.9,86,20.5,1009.6,Rain
3/2/2023 10:00,20,274,52559,165055,294,217614,THURSDAY,0,0,3.9,93,18.4,1008.4,Rain
3/2/2023 11:00,22,244,23317,150841,266,174158,THURSDAY,0,0,3.9,96,18.4,1006.6,Rain
3/2/2023 12:00,26,216,28782,151742,242,180524,THURSDAY,0,0,3.9,96,27.7,1006.6,Rain
3/2/2023 13:00,28,230,32247,155789,258,188036,THURSDAY,0,0,4.4,97,16.6,1003.9,Rain
3/2/2023 14:00,34,263,28834,178474,297,207308,THURSDAY,0,0,4.4,97,16.6,1003.9,Cloudy
3/2/2023 15:00,48,245,654980,156570,293,811550,THURSDAY,0,0,5,100,13,1002,Cloudy
3/2/2023 16:00,69,322,85190,208532,391,293722,THURSDAY,0,0,5.6,96,18.4,1001,Cloudy
3/2/2023 17:00,72,475,170640,352088,547,522728,THURSDAY,0,0,5.6,96,18.4,1001,Cloudy
3/2/2023 18:00,128,671,207897,515179,799,723076,THURSDAY,0,0,5.6,92,18.4,1000.4,Rain
3/2/2023 19:00,75,540,76409,369433,615,445842,THURSDAY,0,0,5,93,16.6,1001.1,Rain
3/2/2023 20:00,48,350,97527,232161,398,329688,THURSDAY,0,0,5,93,16.6,1001.1,Cloudy
3/2/2023 21:00,33,250,2354450,159115,283,2513565,THURSDAY,0,0,6.1,79,14.8,1001.8,Cloudy
3/2/2023 22:00,31,184,25933,153813,215,179746,THURSDAY,0,0,6.1,79,14.8,1001.8,Fair
3/2/2023 23:00,22,122,18684,87828,144,106512,THURSDAY,0,0,6.1,73,16.6,1003.9,Fair
3/3/2023 0:00,19,78,14603,64632,97,79235,FRIDAY,0,0,5,70,24.1,1004,Fair
3/3/2023 1:00,15,52,15937,35598,67,51535,FRIDAY,0,0,5,70,20.5,1005.8,Fair
3/3/2023 2:00,9,13,10797,8877,22,19674,FRIDAY,0,0,4.4,70,20.5,1007,Fair
3/3/2023 3:00,4,18,5690,11163,22,16853,FRIDAY,0,0,4.4,70,20.5,1007,Fair
3/3/2023 4:00,7,2,38081,1758,9,39839,FRIDAY,0,0,3.3,62,22.3,1009,Fair
3/3/2023 5:00,2,10,2115,6053,12,8168,FRIDAY,0,0,2.8,61,20.5,1009.9,Fair
3/3/2023 6:00,3,36,3386,29125,39,32511,FRIDAY,0,0,2.2,64,16.6,1010.3,Fair
3/3/2023 7:00,15,113,12421,112737,128,125158,FRIDAY,0,0,2.2,64,16.6,1010.3,Fair
3/3/2023 8:00,21,260,15780,178885,281,194665,FRIDAY,0,0,1.1,67,14.8,1012.6,Fair
3/3/2023 9:00,45,501,46776,406309,546,453085,FRIDAY,0,0,1.1,67,13,1014.1,Fair
3/3/2023 10:00,40,386,224458,247785,426,472243,FRIDAY,0,0,1.7,64,16.6,1015.7,Fair
3/3/2023 11:00,43,245,61237,179643,288,240880,FRIDAY,0,0,1.7,64,11.2,1016.9,Fair
3/3/2023 12:00,40,272,65939,208193,312,274132,FRIDAY,0,0,1.7,64,11.2,1016.9,Fair
3/3/2023 13:00,95,331,217418,258860,426,476278,FRIDAY,0,0,3.3,52,18.4,1017.9,Fair
3/3/2023 14:00,65,313,116909,216682,378,333591,FRIDAY,0,0,4.4,48,9.4,1018.9,Fair
3/3/2023 15:00,78,326,2694934,244864,404,2939798,FRIDAY,0,0,5,51,13,1018.9,Fair
3/3/2023 16:00,116,386,175554,289560,502,465114,FRIDAY,0,0,5,51,13,1018.9,Fair
3/3/2023 17:00,127,485,215618,372583,612,588201,FRIDAY,0,0,4.4,57,16.6,1019.4,Cloudy
3/3/2023 18:00,105,602,128600,443354,707,571954,FRIDAY,0,0,6.1,47,11.2,1018.4,Cloudy
3/3/2023 19:00,82,447,523064,359011,529,882075,FRIDAY,0,0,5.6,55,13,1018.7,Cloudy
3/3/2023 20:00,58,356,174698,262380,414,437078,FRIDAY,0,0,5.6,43,14.8,1018.1,Cloudy
3/3/2023 21:00,54,211,214411,143717,265,358128,FRIDAY,0,0,4.4,57,20.5,1018,Cloudy
3/3/2023 22:00,48,142,47192,105308,190,152500,FRIDAY,0,0,4.4,57,20.5,1018,Cloudy
3/3/2023 23:00,49,118,63037,99185,167,162222,FRIDAY,0,0,3.9,70,18.4,1017.2,Cloudy
3/4/2023 0:00,22,87,21083,51776,109,72859,SATURDAY,1,0,3.3,64,14.8,1017.5,Cloudy
3/4/2023 1:00,21,57,18729,36676,78,55405,SATURDAY,1,0,2.8,67,14.8,1016.6,Cloudy
3/4/2023 2:00,10,37,14463,24052,47,38515,SATURDAY,1,0,2.8,67,14.8,1016.6,Cloudy
3/4/2023 3:00,4,10,2348,8422,14,10770,SATURDAY,1,0,2.8,61,20.5,1014.9,Snow
3/4/2023 4:00,2,0,2593,0,2,2593,SATURDAY,1,0,2.8,61,20.5,1014.9,Snow
3/4/2023 5:00,2,5,2506,2311,7,4817,SATURDAY,1,0,1.1,88,18.4,1012.7,Snow
3/4/2023 6:00,1,8,820,9875,9,10695,SATURDAY,1,0,1.1,88,18.4,1012.7,Snow
3/4/2023 7:00,0,13,0,6252,13,6252,SATURDAY,1,0,0.6,92,35.3,1011.3,Snow
3/4/2023 8:00,3,20,1488,9866,23,11354,SATURDAY,1,0,1.1,97,40.7,1004.3,Snow
3/4/2023 9:00,4,26,1936,18606,30,20542,SATURDAY,1,0,1.1,100,38.9,1003.6,Snow
3/4/2023 10:00,9,49,9631,24382,58,34013,SATURDAY,1,0,1.7,100,38.9,1002,Snow
3/4/2023 11:00,4,72,3301,47504,76,50805,SATURDAY,1,0,1.7,100,46.4,999.4,Snow
3/4/2023 12:00,8,63,9217,33872,71,43089,SATURDAY,1,0,1.7,100,53.6,999.4,Rain
3/4/2023 13:00,21,94,28883,50549,115,79432,SATURDAY,1,0,2.2,97,50,997.1,Rain
3/4/2023 14:00,20,139,17455,88889,159,106344,SATURDAY,1,0,2.2,97,48.2,997.6,Rain
3/4/2023 15:00,13,142,11249,96955,155,108204,SATURDAY,1,0,0.6,100,25.9,998.5,Rain
3/4/2023 16:00,22,154,28360,104565,176,132925,SATURDAY,1,0,0.6,100,25.9,998.5,Rain
3/4/2023 17:00,41,159,42099,111049,200,153148,SATURDAY,1,0,2.2,100,33.5,999.7,Snow
3/4/2023 18:00,28,173,32802,133323,201,166125,SATURDAY,1,0,2.2,97,44.6,1001.5,Snow
3/4/2023 19:00,29,207,24304,125443,236,149747,SATURDAY,1,0,2.2,92,40.7,1003.6,Snow
3/4/2023 20:00,19,157,19877,102644,176,122521,SATURDAY,1,0,2.2,92,33.5,1003.6,Snow
3/4/2023 21:00,18,137,18231,90569,155,108800,SATURDAY,1,0,1.7,92,31.7,1005.7,Snow
3/4/2023 22:00,24,92,28525,66945,116,95470,SATURDAY,1,0,1.7,89,35.3,1007.2,Snow
3/4/2023 23:00,27,84,25793,47845,111,73638,SATURDAY,1,0,0.6,85,20.5,1011.4,Snow
3/5/2023 0:00,12,84,18817,294169,96,312986,SUNDAY,1,0,0.6,85,20.5,1011.4,Snow
3/5/2023 1:00,25,58,455939,44788,83,500727,SUNDAY,1,0,0.6,82,22.3,1012.4,Snow
3/5/2023 2:00,50,70,69392,523263,120,592655,SUNDAY,1,0,0,85,22.3,1013,Snow
3/5/2023 3:00,16,24,47987,17035,40,65022,SUNDAY,1,0,-0.6,82,14.8,1015.3,Snow
3/5/2023 4:00,2,15,1530,12173,17,13703,SUNDAY,1,0,-0.6,82,14.8,1015.6,Snow
3/5/2023 5:00,6,6,11573,4194,12,15767,SUNDAY,1,0,-0.6,78,11.2,1016.2,Cloudy
3/5/2023 6:00,1,13,2518,10361,14,12879,SUNDAY,1,0,-0.6,78,11.2,1016.4,Cloudy
3/5/2023 7:00,4,33,3815,19587,37,23402,SUNDAY,1,0,-0.6,78,11.2,1016.4,Cloudy
3/5/2023 8:00,7,51,9928,30976,58,40904,SUNDAY,1,0,0,75,11.2,1016.8,Cloudy
3/5/2023 9:00,20,111,25200,77031,131,102231,SUNDAY,1,0,0,75,9.4,1017.1,Cloudy
3/5/2023 10:00,43,176,60160,119639,219,179799,SUNDAY,1,0,0.6,75,11.2,1017.2,Cloudy
3/5/2023 11:00,76,272,712773,179964,348,892737,SUNDAY,1,0,0.6,75,11.2,1017.2,Cloudy
3/5/2023 12:00,77,292,99605,225521,369,325126,SUNDAY,1,0,1.1,75,16.6,1017.4,Cloudy
3/5/2023 13:00,118,310,231645,240597,428,472242,SUNDAY,1,0,2.8,72,20.5,1017.1,Cloudy
3/5/2023 14:00,126,349,228499,281558,475,510057,SUNDAY,1,0,2.8,76,18.4,1017.4,Cloudy
3/5/2023 15:00,134,347,367767,269799,481,637566,SUNDAY,1,0,4.4,70,20.5,1016.7,Cloudy
3/5/2023 16:00,101,353,153536,268561,454,422097,SUNDAY,1,0,4.4,70,20.5,1016.7,Cloudy
3/5/2023 17:00,133,339,833290,271584,472,1104874,SUNDAY,1,0,5,62,18.4,1015.6,Cloudy
3/5/2023 18:00,96,365,223227,274871,461,498098,SUNDAY,1,0,5,60,20.5,1015.7,Cloudy
3/5/2023 19:00,42,316,37357,221815,358,259172,SUNDAY,1,0,5,60,20.5,1016,Cloudy
3/5/2023 20:00,33,216,85735,148168,249,233903,SUNDAY,1,0,5.6,55,24.1,1016.3,Cloudy
3/5/2023 21:00,18,160,19696,104857,178,124553,SUNDAY,1,0,5.6,55,24.1,1016.3,Cloudy
3/5/2023 22:00,8,105,5859,62357,113,68216,SUNDAY,1,0,4.4,60,20.5,1016.9,Fair
3/5/2023 23:00,21,94,28828,57891,115,86719,SUNDAY,1,0,4.4,57,24.1,1017.2,Fair
3/6/2023 0:00,19,56,240787,36173,75,276960,MONDAY,0,0,3.9,64,24.1,1017.3,Fair
3/6/2023 1:00,7,31,6877,18270,38,25147,MONDAY,0,0,3.3,67,18.4,1017,Fair
3/6/2023 2:00,2,10,812,10397,12,11209,MONDAY,0,0,3.3,67,18.4,1017,Fair
3/6/2023 3:00,2,7,1451,3065,9,4516,MONDAY,0,0,3.3,67,20.5,1016.5,Fair
3/6/2023 4:00,1,4,1061,3587,5,4648,MONDAY,0,0,3.3,67,24.1,1016.2,Clear
3/6/2023 5:00,2,10,1798,5417,12,7215,MONDAY,0,0,3.3,67,24.1,1016,Clear
3/6/2023 6:00,5,32,3323,23202,37,26525,MONDAY,0,0,3.3,64,22.3,1015.8,Clear
3/6/2023 7:00,7,141,4475,78304,148,82779,MONDAY,0,0,3.3,64,22.3,1015.8,Clear
3/6/2023 8:00,25,339,38459,242109,364,280568,MONDAY,0,0,2.8,67,22.3,1016.3,Clear
3/6/2023 9:00,40,620,46707,435285,660,481992,MONDAY,0,0,2.8,64,22.3,1016.3,Clear
3/6/2023 10:00,41,412,2081799,283532,453,2365331,MONDAY,0,0,2.8,61,25.9,1016.1,Fair
3/6/2023 11:00,38,241,43676,175190,279,218866,MONDAY,0,0,3.3,55,22.3,1016.5,Fair
3/6/2023 12:00,38,240,49721,180868,278,230589,MONDAY,0,0,3.3,55,22.3,1016.5,Fair
3/6/2023 13:00,56,256,394749,185628,312,580377,MONDAY,0,0,5.6,41,31.7,1015.3,Fair
3/6/2023 14:00,67,219,110388,919257,286,1029645,MONDAY,0,0,6.7,33,27.7,1014.8,Fair
3/6/2023 15:00,45,272,85806,171414,317,257220,MONDAY,0,0,7.2,31,27.7,1014.2,Fair
3/6/2023 16:00,54,319,87653,219549,373,307202,MONDAY,0,0,7.2,31,33.5,1014.2,Fair
3/6/2023 17:00,76,470,332367,341487,546,673854,MONDAY,0,0,8.9,24,29.5,1012.3,Fair
3/6/2023 18:00,93,636,119260,484213,729,603473,MONDAY,0,0,8.9,21,37.1,1011.3,Fair
3/6/2023 19:00,64,528,71340,377034,592,448374,MONDAY,0,0,8.9,21,29.5,1011.3,Fair
3/6/2023 20:00,47,329,50141,218264,376,268405,MONDAY,0,0,6.7,23,35.3,1010.1,Fair
3/6/2023 21:00,27,262,27005,177833,289,204838,MONDAY,0,0,6.7,21,35.3,1009.9,Fair
3/6/2023 22:00,17,157,13044,110178,174,123222,MONDAY,0,0,6.7,21,35.3,1009.9,Fair
3/6/2023 23:00,19,90,16938,58913,109,75851,MONDAY,0,0,5.6,24,31.7,1010.1,Fair
3/7/2023 0:00,5,58,4470,2280775,63,2285245,TUESDAY,0,0,5,25,31.7,1009.2,Fair
3/7/2023 1:00,1,20,571,11162,21,11733,TUESDAY,0,0,5,25,27.7,1009.2,Fair
3/7/2023 2:00,2,12,1961,6848,14,8809,TUESDAY,0,0,3.3,29,22.3,1008.8,Fair
3/7/2023 3:00,3,4,2304,1181,7,3485,TUESDAY,0,0,3.3,30,22.3,1008.5,Fair
3/7/2023 4:00,0,2,0,3275,2,3275,TUESDAY,0,0,2.8,31,20.5,1008.4,Fair
3/7/2023 5:00,5,6,6451,5620,11,12071,TUESDAY,0,0,2.8,31,20.5,1007.4,Fair
3/7/2023 6:00,3,36,3421,24866,39,28287,TUESDAY,0,0,2.8,31,20.5,1007.4,Fair
3/7/2023 7:00,10,131,8445,142472,141,150917,TUESDAY,0,0,1.7,35,16.6,1006.2,Fair
3/7/2023 8:00,19,363,38909,259759,382,298668,TUESDAY,0,0,1.1,38,18.4,1005.7,Fair
3/7/2023 9:00,52,722,87028,552081,774,639109,TUESDAY,0,0,1.1,40,20.5,1005.3,Fair
3/7/2023 10:00,30,387,26451,270579,417,297030,TUESDAY,0,0,0.6,41,18.4,1005.2,Fair
3/7/2023 11:00,32,228,28064,175884,260,203948,TUESDAY,0,0,0.6,43,22.3,1005.3,Cloudy
3/7/2023 12:00,33,238,52301,154074,271,206375,TUESDAY,0,0,0.6,43,22.3,1005.3,Cloudy
3/7/2023 13:00,45,286,42839,180722,331,223561,TUESDAY,0,0,2.2,42,27.7,1005.1,Cloudy
3/7/2023 14:00,42,210,71581,132464,252,204045,TUESDAY,0,0,2.8,42,29.5,1004.9,Cloudy
3/7/2023 15:00,42,234,676889,148932,276,825821,TUESDAY,0,0,2.8,44,20.5,1005,Cloudy
3/7/2023 16:00,50,293,214922,190030,343,404952,TUESDAY,0,0,2.8,44,20.5,1005,Cloudy
3/7/2023 17:00,50,435,41895,456253,485,498148,TUESDAY,0,0,3.3,46,22.3,1005.1,Cloudy
3/7/2023 18:00,67,638,62786,446148,705,508934,TUESDAY,0,0,3.9,46,22.3,1005.7,Cloudy
3/7/2023 19:00,43,488,44571,324734,531,369305,TUESDAY,0,0,3.9,44,25.9,1006.6,Cloudy
3/7/2023 20:00,19,277,19792,182004,296,201796,TUESDAY,0,0,2.8,48,27.7,1007.7,Cloudy
3/7/2023 21:00,18,191,13578,120687,209,134265,TUESDAY,0,0,2.8,48,27.7,1007.7,Cloudy
3/7/2023 22:00,9,117,6141,126863,126,133004,TUESDAY,0,0,1.1,59,29.5,1009.3,Cloudy
3/7/2023 23:00,6,76,4321,45635,82,49956,TUESDAY,0,0,0,66,31.7,1010.7,Cloudy
3/8/2023 0:00,3,48,2073,26665,51,28738,WEDNESDAY,0,0,-1.1,69,35.3,1012.4,Cloudy
3/8/2023 1:00,2,20,1287,10471,22,11758,WEDNESDAY,0,0,-1.1,69,37.1,1012.4,Cloudy
3/8/2023 2:00,0,5,0,2523,5,2523,WEDNESDAY,0,0,-1.1,60,31.7,1013,Cloudy
3/8/2023 3:00,1,8,916,3030,9,3946,WEDNESDAY,0,0,-1.1,58,22.3,1013.3,Cloudy
3/8/2023 4:00,0,8,0,4544,8,4544,WEDNESDAY,0,0,-0.6,56,22.3,1013.4,Cloudy
3/8/2023 5:00,2,3,2045,1454,5,3499,WEDNESDAY,0,0,-0.6,56,25.9,1013.4,Cloudy
3/8/2023 6:00,2,34,1492,19535,36,21027,WEDNESDAY,0,0,-1.1,58,27.7,1013.8,Cloudy
3/8/2023 7:00,10,138,5144,118480,148,123624,WEDNESDAY,0,0,-1.1,60,25.9,1014,Cloudy
3/8/2023 8:00,21,336,18160,244865,357,263025,WEDNESDAY,0,0,-1.1,60,27.7,1014.4,Cloudy
3/8/2023 9:00,41,647,37975,455545,688,493520,WEDNESDAY,0,0,-1.1,63,27.7,1014.9,Cloudy
3/8/2023 10:00,28,404,27520,327159,432,354679,WEDNESDAY,0,0,-1.1,63,25.9,1014.9,Cloudy
3/8/2023 11:00,33,255,48979,180836,288,229815,WEDNESDAY,0,0,-0.6,63,24.1,1015.5,Cloudy
3/8/2023 12:00,34,215,32522,158099,249,190621,WEDNESDAY,0,0,0,64,24.1,1016,Cloudy
3/8/2023 13:00,27,255,56460,170543,282,227003,WEDNESDAY,0,0,0,64,29.5,1016,Cloudy
3/8/2023 14:00,47,225,71530,150975,272,222505,WEDNESDAY,0,0,1.1,64,25.9,1016.3,Cloudy
3/8/2023 15:00,46,257,70615,171808,303,242423,WEDNESDAY,0,0,2.8,57,33.5,1016.4,Cloudy
3/8/2023 16:00,58,354,78799,244549,412,323348,WEDNESDAY,0,0,5.6,53,20.5,1016.9,Cloudy
3/8/2023 17:00,91,494,116493,346931,585,463424,WEDNESDAY,0,0,6.1,51,20.5,1016.8,Cloudy
3/8/2023 18:00,126,762,135483,574147,888,709630,WEDNESDAY,0,0,7.2,47,27.7,1016.6,Cloudy
3/8/2023 19:00,73,500,77942,392321,573,470263,WEDNESDAY,0,0,8.3,42,25.9,1016.7,Cloudy
3/8/2023 20:00,41,355,36009,227692,396,263701,WEDNESDAY,0,0,8.3,42,27.7,1016.7,Cloudy
3/8/2023 21:00,36,237,39478,192939,273,232417,WEDNESDAY,0,0,8.3,44,20.5,1016.8,Cloudy
3/8/2023 22:00,20,154,18262,140853,174,159115,WEDNESDAY,0,0,8.3,44,20.5,1016.8,Cloudy
3/8/2023 23:00,15,113,15617,77861,128,93478,WEDNESDAY,0,0,7.8,45,16.6,1017.7,Cloudy
3/9/2023 0:00,28,62,22620,38760,90,61380,THURSDAY,0,0,6.1,51,27.7,1018.2,Cloudy
3/9/2023 1:00,7,21,7686,14813,28,22499,THURSDAY,0,0,6.1,51,27.7,1018.2,Cloudy
3/9/2023 2:00,2,18,1173,11262,20,12435,THURSDAY,0,0,4.4,60,24.1,1018.7,Cloudy
3/9/2023 3:00,2,6,2862,5010,8,7872,THURSDAY,0,0,3.9,62,24.1,1018.6,Cloudy
3/9/2023 4:00,2,4,34656,3381,6,38037,THURSDAY,0,0,3.3,62,24.1,1018.7,Rain
3/9/2023 5:00,0,9,0,4303,9,4303,THURSDAY,0,0,2.8,64,27.7,1019.1,Cloudy
3/9/2023 6:00,6,32,3817,15672,38,19489,THURSDAY,0,0,2.8,64,25.9,1019.1,Cloudy
3/9/2023 7:00,14,150,12231,93104,164,105335,THURSDAY,0,0,2.2,64,20.5,1018.5,Cloudy
3/9/2023 8:00,38,373,26137,267824,411,293961,THURSDAY,0,0,1.7,64,22.3,1018.7,Cloudy
3/9/2023 9:00,54,716,45180,504582,770,549762,THURSDAY,0,0,1.7,61,24.1,1018.7,Cloudy
3/9/2023 10:00,38,415,39117,266046,453,305163,THURSDAY,0,0,1.7,61,24.1,1018.8,Cloudy
3/9/2023 11:00,42,254,82667,2273652,296,2356319,THURSDAY,0,0,1.7,61,25.9,1018.8,Cloudy
3/9/2023 12:00,56,263,98877,181145,319,280022,THURSDAY,0,0,2.2,59,20.5,1019.2,Cloudy
3/9/2023 13:00,52,293,104535,209438,345,313973,THURSDAY,0,0,3.9,55,20.5,1019.2,Cloudy
3/9/2023 14:00,48,269,89117,174753,317,263870,THURSDAY,0,0,3.9,55,20.5,1019.2,Cloudy
3/9/2023 15:00,56,263,90908,178980,319,269888,THURSDAY,0,0,5,51,20.5,1019.1,Cloudy
3/9/2023 16:00,83,328,328139,219517,411,547656,THURSDAY,0,0,8.3,44,13,1018.5,Cloudy
3/9/2023 17:00,108,538,192830,379863,646,572693,THURSDAY,0,0,8.3,49,18.4,1018.3,Cloudy
3/9/2023 18:00,79,706,145000,543390,785,688390,THURSDAY,0,0,8.3,54,20.5,1018.2,Cloudy
3/9/2023 19:00,89,552,956742,395265,641,1352007,THURSDAY,0,0,5.6,67,20.5,1018.6,Cloudy
3/9/2023 20:00,51,390,83561,319782,441,403343,THURSDAY,0,0,5.6,67,27.7,1018.6,Cloudy
3/9/2023 21:00,41,262,39322,172870,303,212192,THURSDAY,0,0,5.6,70,22.3,1020,Cloudy
3/9/2023 22:00,35,159,132501,112723,194,245224,THURSDAY,0,0,4.4,73,18.4,1020.4,Cloudy
3/9/2023 23:00,35,132,2370887,94374,167,2465261,THURSDAY,0,0,4.4,73,16.6,1020.8,Cloudy
3/10/2023 0:00,18,78,33622,46257,96,79879,FRIDAY,0,0,4.4,73,5.4,1021.1,Cloudy
3/10/2023 1:00,13,26,14519,17141,39,31660,FRIDAY,0,0,4.4,73,5.4,1021.1,Cloudy
3/10/2023 2:00,9,24,13731,18121,33,31852,FRIDAY,0,0,4.4,65,9.4,1021.4,Cloudy
3/10/2023 3:00,7,7,10182,4735,14,14917,FRIDAY,0,0,3.9,70,13,1021.4,Cloudy
3/10/2023 4:00,1,8,1960,5486,9,7446,FRIDAY,0,0,2.2,70,18.4,1021.6,Fair
3/10/2023 5:00,3,7,28932,5922,10,34854,FRIDAY,0,0,2.2,70,18.4,1021.6,Fair
3/10/2023 6:00,4,28,2366,17595,32,19961,FRIDAY,0,0,1.1,67,14.8,1020.2,Fair
3/10/2023 7:00,11,109,6500,75447,120,81947,FRIDAY,0,0,0.6,69,13,1019.3,Fair
3/10/2023 8:00,27,263,25810,222280,290,248090,FRIDAY,0,0,0,69,14.8,1019.3,Fair
3/10/2023 9:00,50,508,41682,356908,558,398590,FRIDAY,0,0,0,69,16.6,1019.2,Fair
3/10/2023 10:00,41,393,49520,245973,434,295493,FRIDAY,0,0,0,72,14.8,1019.4,Fair
3/10/2023 11:00,51,275,95368,185977,326,281345,FRIDAY,0,0,0,72,14.8,1019.4,Fair
3/10/2023 12:00,74,249,120191,182674,323,302865,FRIDAY,0,0,2.2,64,11.2,1018.1,Fair
3/10/2023 13:00,72,319,171129,560587,391,731716,FRIDAY,0,0,4.4,55,9.4,1017.4,Fair
3/10/2023 14:00,99,337,155254,224198,436,379452,FRIDAY,0,0,5,53,7.6,1017,Fair
3/10/2023 15:00,129,339,213003,232551,468,445554,FRIDAY,0,0,5,53,7.6,1017,Fair
3/10/2023 16:00,131,450,3391539,326735,581,3718274,FRIDAY,0,0,7.8,42,14.8,1015,Cloudy
3/10/2023 17:00,167,531,988563,400621,698,1389184,FRIDAY,0,0,7.8,42,14.8,1015,Cloudy
3/10/2023 18:00,134,615,428528,811538,749,1240066,FRIDAY,0,0,9.4,38,16.6,1012.3,Cloudy
3/10/2023 19:00,90,420,4830856,315878,510,5146734,FRIDAY,0,0,10,33,0,1011.6,Cloudy
3/10/2023 20:00,72,307,300419,216842,379,517261,FRIDAY,0,0,10,33,0,1011.6,Cloudy
3/10/2023 21:00,65,223,1616806,158796,288,1775602,FRIDAY,0,0,5,67,18.4,1010.6,Cloudy
3/10/2023 22:00,34,174,43498,121268,208,164766,FRIDAY,0,0,5,67,11.2,1010.5,Cloudy
3/10/2023 23:00,55,121,1435300,82874,176,1518174,FRIDAY,0,0,4.4,70,14.8,1010,Cloudy
3/11/2023 0:00,37,73,736509,57751,110,794260,SATURDAY,1,0,3.9,73,9.4,1010,Cloudy
3/11/2023 1:00,18,73,11706,50565,91,62271,SATURDAY,1,0,3.9,73,9.4,1010,Cloudy
3/11/2023 2:00,34,49,280207,39934,83,320141,SATURDAY,1,0,4.4,76,11.2,1009.1,Cloudy
3/11/2023 3:00,27,30,30584,24209,57,54793,SATURDAY,1,0,4.4,79,16.6,1008.7,Cloudy
3/11/2023 4:00,4,7,41000,5902,11,46902,SATURDAY,1,0,4.4,86,16.6,1008.3,Cloudy
3/11/2023 5:00,0,9,0,5337,9,5337,SATURDAY,1,0,4.4,86,16.6,1008.3,Cloudy
3/11/2023 6:00,3,10,1947,117026,13,118973,SATURDAY,1,0,3.9,86,13,1007.7,Cloudy
3/11/2023 7:00,5,30,3333,14750,35,18083,SATURDAY,1,0,3.9,86,13,1007.7,Cloudy
3/11/2023 8:00,9,56,10290,33737,65,44027,SATURDAY,1,0,3.9,86,9.4,1006.8,Rain
3/11/2023 9:00,13,113,24435,76540,126,100975,SATURDAY,1,0,3.9,76,27.7,1007.7,Rain
3/11/2023 10:00,54,205,161668,151793,259,313461,SATURDAY,1,0,3.9,76,27.7,1007.7,Snow
3/11/2023 11:00,58,187,88848,137338,245,226186,SATURDAY,1,0,3.3,76,25.9,1007.9,Cloudy
3/11/2023 12:00,54,219,67973,157601,273,225574,SATURDAY,1,0,3.3,76,27.7,1008.2,Rain
3/11/2023 13:00,25,195,23328,121278,220,144606,SATURDAY,1,0,3.3,73,31.7,1008.4,Cloudy
3/11/2023 14:00,46,212,161359,163608,258,324967,SATURDAY,1,0,2.8,78,31.7,1008.7,Cloudy
3/11/2023 15:00,49,255,158188,266035,304,424223,SATURDAY,1,0,2.8,78,27.7,1008.7,Snow
3/11/2023 16:00,57,254,148163,178150,311,326313,SATURDAY,1,0,1.7,89,31.7,1009,Snow
3/11/2023 17:00,73,250,162604,402431,323,565035,SATURDAY,1,0,1.7,92,27.7,1008.8,Rain
3/11/2023 18:00,79,289,143998,196339,368,340337,SATURDAY,1,0,2.2,85,27.7,1008.9,Cloudy
3/11/2023 19:00,68,280,229627,194473,348,424100,SATURDAY,1,0,2.2,85,35.3,1008.9,Cloudy
3/11/2023 20:00,63,213,90783,141833,276,232616,SATURDAY,1,0,2.8,70,35.3,1009.8,Cloudy
3/11/2023 21:00,47,155,56510,127144,202,183654,SATURDAY,1,0,2.8,67,24.1,1010.6,Cloudy
3/11/2023 22:00,28,132,61845,96200,160,158045,SATURDAY,1,0,2.8,67,24.1,1011.2,Cloudy
3/11/2023 23:00,36,97,92809,60412,133,153221,SATURDAY,1,0,2.2,67,18.4,1011.5,Cloudy
3/12/2023 0:00,27,82,26012,52762,109,78774,SUNDAY,1,0,2.2,67,18.4,1011.5,Cloudy
3/12/2023 1:00,39,52,500478,43901,91,544379,SUNDAY,1,0,2.2,70,14.8,1012.3,Cloudy
3/12/2023 2:00,31,47,33338,50337,78,83675,SUNDAY,1,0,2.2,70,16.6,1012.7,Cloudy
3/12/2023 3:00,17,28,20942,21381,45,42323,SUNDAY,1,0,1.7,66,14.8,1012.9,Cloudy
3/12/2023 4:00,2,10,1770,7616,12,9386,SUNDAY,1,0,1.7,61,14.8,1013.4,Cloudy
3/12/2023 5:00,3,17,2582,12667,20,15249,SUNDAY,1,0,1.7,61,14.8,1013.4,Cloudy
3/12/2023 6:00,4,23,2214,16280,27,18494,SUNDAY,1,0,1.1,61,14.8,1013.9,Cloudy
3/12/2023 7:00,10,38,13778,29504,48,43282,SUNDAY,1,0,0.6,61,16.6,1014.2,Cloudy
3/12/2023 8:00,21,80,34049,57107,101,91156,SUNDAY,1,0,0.6,58,18.4,1014.4,Fair
3/12/2023 9:00,34,159,41730,124955,193,166685,SUNDAY,1,0,0.6,58,18.4,1014.7,Fair
3/12/2023 10:00,85,218,129138,157884,303,287022,SUNDAY,1,0,0.6,58,18.4,1014.7,Fair
3/12/2023 11:00,83,296,130624,219248,379,349872,SUNDAY,1,0,0.6,61,18.4,1016.1,Fair
3/12/2023 12:00,115,348,890533,275109,463,1165642,SUNDAY,1,0,2.2,59,20.5,1016.4,Fair
3/12/2023 13:00,154,383,265295,318404,537,583699,SUNDAY,1,0,3.3,62,20.5,1016.5,Fair
3/12/2023 14:00,162,355,308347,278639,517,586986,SUNDAY,1,0,3.3,62,24.1,1016.5,Fair
3/12/2023 15:00,136,353,379680,287853,489,667533,SUNDAY,1,0,4.4,62,22.3,1016.6,Fair
3/12/2023 16:00,129,363,619861,294294,492,914155,SUNDAY,1,0,5,62,22.3,1017.5,Cloudy
3/12/2023 17:00,165,371,1963071,302177,536,2265248,SUNDAY,1,0,5,62,22.3,1017.8,Cloudy
3/12/2023 18:00,90,370,115221,279906,460,395127,SUNDAY,1,0,5,65,22.3,1017.7,Cloudy
3/12/2023 19:00,51,236,67751,177025,287,244776,SUNDAY,1,0,5,65,25.9,1017.7,Cloudy
3/12/2023 20:00,39,165,45749,103287,204,149036,SUNDAY,1,0,3.9,67,22.3,1017.4,Cloudy
3/12/2023 21:00,22,127,19845,70505,149,90350,SUNDAY,1,0,3.3,73,18.4,1017.6,Cloudy
3/12/2023 22:00,23,76,18096,47023,99,65119,SUNDAY,1,0,2.8,72,11.2,1018.2,Cloudy
3/12/2023 23:00,6,50,5730,35401,56,41131,SUNDAY,1,0,2.2,79,9.4,1018.5,Cloudy
3/13/2023 0:00,9,29,7081,15441,38,22522,MONDAY,0,0,2.2,79,9.4,1018.5,Cloudy
3/13/2023 1:00,3,12,2105,7172,15,9277,MONDAY,0,0,2.8,72,7.6,1019.1,Cloudy
3/13/2023 2:00,3,9,1467,6470,12,7937,MONDAY,0,0,3.3,76,9.4,1019.4,Cloudy
3/13/2023 3:00,0,4,0,4308,4,4308,MONDAY,0,0,3.3,76,9.4,1019.4,Cloudy
3/13/2023 4:00,1,5,4071,3517,6,7588,MONDAY,0,0,2.8,82,7.6,1019,Cloudy
3/13/2023 5:00,8,31,5009,18360,39,23369,MONDAY,0,0,2.8,82,7.6,1019,Cloudy
3/13/2023 6:00,6,119,4854,75097,125,79951,MONDAY,0,0,3.3,79,0,1017.9,Cloudy
3/13/2023 7:00,25,295,25117,194420,320,219537,MONDAY,0,0,3.3,79,0,1017.9,Cloudy
3/13/2023 8:00,36,616,34961,444210,652,479171,MONDAY,0,0,2.8,82,0,1017.6,Cloudy
3/13/2023 9:00,24,362,23854,257324,386,281178,MONDAY,0,0,2.8,82,0,1017.6,Cloudy
3/13/2023 10:00,22,236,29368,178834,258,208202,MONDAY,0,0,2.8,78,5.4,1017.6,Cloudy
3/13/2023 11:00,55,231,305501,153461,286,458962,MONDAY,0,0,2.8,85,7.6,1017.6,Cloudy
3/13/2023 12:00,70,257,109617,165321,327,274938,MONDAY,0,0,3.9,79,9.4,1018.1,Cloudy
3/13/2023 13:00,48,190,67236,143588,238,210824,MONDAY,0,0,3.9,79,14.8,1018.1,Cloudy
3/13/2023 14:00,39,212,39719,153775,251,193494,MONDAY,0,0,3.9,79,14.8,1018.1,Cloudy
3/13/2023 15:00,30,214,37418,147074,244,184492,MONDAY,0,0,5,79,16.6,1017.4,Cloudy
3/13/2023 16:00,34,366,39399,236983,400,276382,MONDAY,0,0,5.6,79,16.6,1017,Cloudy
3/13/2023 17:00,51,582,55965,414121,633,470086,MONDAY,0,0,5.6,76,16.6,1016.3,Cloudy
3/13/2023 18:00,31,404,37666,284725,435,322391,MONDAY,0,0,5.6,76,22.3,1016.3,Cloudy
3/13/2023 19:00,11,235,9877,158350,246,168227,MONDAY,0,0,5,79,16.6,1015.5,Cloudy
3/13/2023 20:00,19,147,24027,100828,166,124855,MONDAY,0,0,5,82,18.4,1013.7,Cloudy
3/13/2023 21:00,11,72,9075,42700,83,51775,MONDAY,0,0,5,82,16.6,1013.3,Rain
3/13/2023 22:00,4,28,2898,17343,32,20241,MONDAY,0,0,5,82,20.5,1012.8,Rain
3/13/2023 23:00,4,27,3069,15894,31,18963,MONDAY,0,0,5,82,20.5,1012.8,Rain
3/14/2023 0:00,1,11,866,7418,12,8284,TUESDAY,0,0,5,79,22.3,1012.3,Rain
3/14/2023 1:00,0,8,0,4575,8,4575,TUESDAY,0,0,4.4,89,18.4,1011.4,Rain
3/14/2023 2:00,1,3,3043,1037,4,4080,TUESDAY,0,0,4.4,93,16.6,1010.6,Rain
3/14/2023 3:00,1,1,968,928,2,1896,TUESDAY,0,0,4.4,93,18.4,1009.3,Rain
3/14/2023 5:00,0,5,0,4237,5,4237,TUESDAY,0,0,5,89,29.5,1008.2,Rain
3/14/2023 6:00,0,25,0,12029,25,12029,TUESDAY,0,0,4.4,97,35.3,1005,Rain
3/14/2023 7:00,1,54,1587,33030,55,34617,TUESDAY,0,0,4.4,97,44.6,1005,Rain
3/14/2023 8:00,7,77,5882,51141,84,57023,TUESDAY,0,0,5,93,51.8,1003.1,Rain
3/14/2023 9:00,4,60,10932,36204,64,47136,TUESDAY,0,0,5,93,42.5,1001.8,Rain
3/14/2023 10:00,1,30,1084,17541,31,18625,TUESDAY,0,0,4.4,97,44.6,1000.5,Rain
3/14/2023 11:00,1,34,414,19360,35,19774,TUESDAY,0,0,4.4,100,46.4,998.9,Rain
3/14/2023 12:00,3,45,2991,28481,48,31472,TUESDAY,0,0,4.4,100,31.7,998.9,Rain
3/14/2023 13:00,3,59,1834,29634,62,31468,TUESDAY,0,0,4.4,100,31.7,998.9,Rain
3/14/2023 14:00,5,74,2794,40321,79,43115,TUESDAY,0,0,4.4,100,37.1,997.2,Rain
3/14/2023 15:00,6,89,5358,52939,95,58297,TUESDAY,0,0,3.9,96,44.6,994.8,Rain
3/14/2023 16:00,10,93,29993,66835,103,96828,TUESDAY,0,0,3.9,96,37.1,994.8,Rain
3/14/2023 17:00,8,123,8376,70937,131,79313,TUESDAY,0,0,1.7,96,40.7,993.7,Rain
3/14/2023 18:00,0,97,0,57289,97,57289,TUESDAY,0,0,1.7,96,51.8,991.8,Snow
3/14/2023 19:00,4,71,4017,45880,75,49897,TUESDAY,0,0,2.2,97,57.6,990.4,Snow
3/14/2023 20:00,6,50,6166,25452,56,31618,TUESDAY,0,0,1.7,92,55.4,990.5,Snow
3/14/2023 21:00,7,39,9975,22117,46,32092,TUESDAY,0,0,1.1,97,25.9,991,Snow
3/14/2023 22:00,2,36,1586,25225,38,26811,TUESDAY,0,0,0.6,96,24.1,991.1,Snow
3/14/2023 23:00,4,16,2550,9321,20,11871,TUESDAY,0,0,0.6,96,24.1,991.1,Snow
3/15/2023 0:00,0,5,0,4285,5,4285,WEDNESDAY,0,0,1.1,92,29.5,991.1,Snow
3/15/2023 1:00,2,5,1772,2813,7,4585,WEDNESDAY,0,0,1.1,92,27.7,990,Snow
3/15/2023 2:00,1,3,809,1455,4,2264,WEDNESDAY,0,0,1.1,92,27.7,989.4,Snow
3/15/2023 3:00,3,2,3648,1373,5,5021,WEDNESDAY,0,0,1.1,92,31.7,989.4,Snow
3/15/2023 4:00,0,2,0,780,2,780,WEDNESDAY,0,0,0.6,96,37.1,989.7,Snow
3/15/2023 5:00,3,31,1414,18349,34,19763,WEDNESDAY,0,0,1.1,100,33.5,992.4,Snow
3/15/2023 6:00,9,83,8549,51986,92,60535,WEDNESDAY,0,0,2.2,92,31.7,993.5,Snow
3/15/2023 7:00,11,240,7928,169270,251,177198,WEDNESDAY,0,0,2.2,92,33.5,993.5,Snow
3/15/2023 8:00,45,560,36595,380383,605,416978,WEDNESDAY,0,0,1.7,82,33.5,995.7,Snow
3/15/2023 9:00,26,390,119050,258201,416,377251,WEDNESDAY,0,0,1.7,82,24.1,996.7,Snow
3/15/2023 10:00,19,230,16321,138973,249,155294,WEDNESDAY,0,0,1.7,82,24.1,996.7,Snow
3/15/2023 11:00,29,216,62890,125316,245,188206,WEDNESDAY,0,0,1.7,78,31.7,997.7,Cloudy
3/15/2023 12:00,42,274,43119,189784,316,232903,WEDNESDAY,0,0,2.2,70,27.7,999.9,Cloudy
3/15/2023 13:00,21,177,28847,107481,198,136328,WEDNESDAY,0,0,2.2,70,35.3,999.9,Cloudy
3/15/2023 14:00,44,237,54225,154281,281,208506,WEDNESDAY,0,0,3.9,62,33.5,1000.9,Cloudy
3/15/2023 15:00,44,271,53163,172483,315,225646,WEDNESDAY,0,0,3.9,62,38.9,1000.9,Cloudy
3/15/2023 16:00,51,412,251553,287175,463,538728,WEDNESDAY,0,0,5,57,29.5,1000.9,Cloudy
3/15/2023 17:00,89,672,365874,2178463,761,2544337,WEDNESDAY,0,0,5,55,35.3,1001.5,Cloudy
3/15/2023 18:00,72,511,84351,366741,583,451092,WEDNESDAY,0,0,5,55,40.7,1001.5,Cloudy
3/15/2023 19:00,42,329,70001,207526,371,277527,WEDNESDAY,0,0,6.1,49,46.4,1002.6,Cloudy
3/15/2023 20:00,26,239,26669,149379,265,176048,WEDNESDAY,0,0,6.1,49,40.7,1002.6,Cloudy
3/15/2023 21:00,22,143,15470,100969,165,116439,WEDNESDAY,0,0,5,51,37.1,1004.8,Cloudy
3/15/2023 22:00,13,104,14343,65039,117,79382,WEDNESDAY,0,0,3.9,55,44.6,1005.9,Cloudy
3/15/2023 23:00,5,66,2800,531833,71,534633,WEDNESDAY,0,0,3.9,55,33.5,1005.9,Cloudy
3/16/2023 0:00,10,18,10409,14090,28,24499,THURSDAY,0,0,2.8,61,31.7,1007.6,Cloudy
3/16/2023 1:00,3,11,3413,6042,14,9455,THURSDAY,0,0,2.8,59,29.5,1008.6,Fair
3/16/2023 2:00,1,10,2697,8226,11,10923,THURSDAY,0,0,2.8,61,29.5,1009.2,Fair
3/16/2023 3:00,1,2,814,867,3,1681,THURSDAY,0,0,2.2,64,24.1,1009.8,Fair
3/16/2023 4:00,0,5,0,3354,5,3354,THURSDAY,0,0,2.2,59,24.1,1010.1,Cloudy
3/16/2023 5:00,3,38,2839,27014,41,29853,THURSDAY,0,0,2.2,59,24.1,1010.1,Fair
3/16/2023 6:00,7,96,6537,68837,103,75374,THURSDAY,0,0,2.2,56,22.3,1010.8,Fair
3/16/2023 7:00,30,314,24066,221322,344,245388,THURSDAY,0,0,1.7,56,18.4,1011.1,Clear
3/16/2023 8:00,53,686,53580,634804,739,688384,THURSDAY,0,0,1.7,52,20.5,1011.2,Clear
3/16/2023 9:00,42,421,39499,314534,463,354033,THURSDAY,0,0,1.7,52,20.5,1011.2,Fair
3/16/2023 10:00,37,272,51880,207304,309,259184,THURSDAY,0,0,1.1,54,25.9,1012.1,Fair
3/16/2023 11:00,44,219,58869,143768,263,202637,THURSDAY,0,0,2.2,42,20.5,1013.1,Fair
3/16/2023 12:00,60,273,74419,193193,333,267612,THURSDAY,0,0,2.2,42,29.5,1013.1,Fair
3/16/2023 13:00,75,235,101011,174966,310,275977,THURSDAY,0,0,5,31,27.7,1013.7,Fair
3/16/2023 14:00,93,262,280307,189785,355,470092,THURSDAY,0,0,5,31,29.5,1013.7,Cloudy
3/16/2023 15:00,103,334,529047,243069,437,772116,THURSDAY,0,0,6.7,28,31.7,1013.4,Cloudy
3/16/2023 16:00,120,508,231573,393353,628,624926,THURSDAY,0,0,7.8,28,20.5,1012.3,Cloudy
3/16/2023 17:00,141,673,197858,510057,814,707915,THURSDAY,0,0,8.9,31,22.3,1011.3,Cloudy
3/16/2023 18:00,103,567,768852,449855,670,1218707,THURSDAY,0,0,8.9,31,22.3,1011.3,Cloudy
3/16/2023 19:00,59,400,87139,291320,459,378459,THURSDAY,0,0,10,36,22.3,1010.8,Cloudy
3/16/2023 20:00,36,267,30875,203493,303,234368,THURSDAY,0,0,10,36,22.3,1010.8,Cloudy
3/16/2023 21:00,35,199,41258,146253,234,187511,THURSDAY,0,0,8.9,42,24.1,1010.7,Cloudy
3/16/2023 22:00,43,116,47567,81104,159,128671,THURSDAY,0,0,8.9,42,24.1,1010.7,Cloudy
3/16/2023 23:00,33,106,276020,79445,139,355465,THURSDAY,0,0,8.3,46,18.4,1011.8,Cloudy
3/17/2023 0:00,20,46,58795,26113,66,84908,FRIDAY,0,1,8.3,46,18.4,1011.8,Cloudy
3/17/2023 1:00,9,22,9310,17580,31,26890,FRIDAY,0,1,7.2,49,13,1012.7,Cloudy
3/17/2023 2:00,6,7,6657,3616,13,10273,FRIDAY,0,1,7.2,49,13,1012.7,Cloudy
3/17/2023 3:00,2,8,1356659,4224,10,1360883,FRIDAY,0,1,6.7,51,13,1012.9,Fair
3/17/2023 4:00,2,9,1889,7821,11,9710,FRIDAY,0,1,6.7,51,13,1012.9,Cloudy
3/17/2023 5:00,2,25,1794,13223,27,15017,FRIDAY,0,1,5.6,57,0,1012.8,Fair
3/17/2023 6:00,6,119,6531,75854,125,82385,FRIDAY,0,1,5.6,57,0,1012.8,Fair
3/17/2023 7:00,18,256,24677,180254,274,204931,FRIDAY,0,1,5,65,5.4,1012.5,Cloudy
3/17/2023 8:00,42,524,46420,380692,566,427112,FRIDAY,0,1,5,65,5.4,1012.5,Cloudy
3/17/2023 9:00,45,403,666266,273522,448,939788,FRIDAY,0,1,3.9,76,5.4,1012.1,Cloudy
3/17/2023 10:00,53,297,126854,210621,350,337475,FRIDAY,0,1,3.9,82,7.6,1012.3,Cloudy
3/17/2023 11:00,86,284,119149,579230,370,698379,FRIDAY,0,1,3.9,79,9.4,1012,Cloudy
3/17/2023 12:00,95,317,144111,250858,412,394969,FRIDAY,0,1,4.4,70,13,1011.6,Cloudy
3/17/2023 13:00,80,308,133751,1837615,388,1971366,FRIDAY,0,1,4.4,70,13,1011.6,Cloudy
3/17/2023 14:00,113,342,178782,289076,455,467858,FRIDAY,0,1,6.7,65,11.2,1010.4,Cloudy
3/17/2023 15:00,140,400,238787,313550,540,552337,FRIDAY,0,1,7.8,65,14.8,1009.4,Cloudy
3/17/2023 16:00,187,524,2032617,465845,711,2498462,FRIDAY,0,1,10,58,20.5,1008.3,Cloudy
3/17/2023 17:00,166,618,230806,854595,784,1085401,FRIDAY,0,1,10.6,52,18.4,1006.3,Cloudy
3/17/2023 18:00,150,514,698962,400864,664,1099826,FRIDAY,0,1,10.6,52,18.4,1006.3,Cloudy
3/17/2023 19:00,112,366,437734,313996,478,751730,FRIDAY,0,1,11.1,63,20.5,1003.9,Cloudy
3/17/2023 20:00,97,225,276899,175326,322,452225,FRIDAY,0,1,11.1,66,20.5,1002.3,Cloudy
3/17/2023 21:00,95,168,189532,126588,263,316120,FRIDAY,0,1,10.6,68,20.5,1002.2,Cloudy
3/17/2023 22:00,88,166,172686,121740,254,294426,FRIDAY,0,1,10.6,68,22.3,1002.2,Cloudy
3/17/2023 23:00,106,124,221310,155077,230,376387,FRIDAY,0,1,10,71,16.6,1001.4,Cloudy
3/18/2023 0:00,109,92,141585,111427,201,253012,SATURDAY,1,0,10,71,16.6,1001.4,Cloudy
3/18/2023 1:00,115,84,265328,64439,199,329767,SATURDAY,1,0,9.4,69,16.6,1001.3,Cloudy
3/18/2023 2:00,71,41,84240,33544,112,117784,SATURDAY,1,0,9.4,66,13,1001.1,Cloudy
3/18/2023 3:00,27,19,50100,13585,46,63685,SATURDAY,1,0,9.4,66,13,1001.1,Cloudy
3/18/2023 4:00,8,11,7965,12985,19,20950,SATURDAY,1,0,8.9,71,13,1001.5,Cloudy
3/18/2023 5:00,7,14,12027,8033,21,20060,SATURDAY,1,0,8.3,74,13,1001.4,Cloudy
3/18/2023 6:00,8,28,7325,14151,36,21476,SATURDAY,1,0,8.3,74,7.6,1001.4,Cloudy
3/18/2023 7:00,19,85,23341,64235,104,87576,SATURDAY,1,0,7.8,79,0,1001.5,Cloudy
3/18/2023 8:00,34,106,79581,87213,140,166794,SATURDAY,1,0,7.8,79,0,1001.5,Cloudy
3/18/2023 9:00,61,178,92188,125804,239,217992,SATURDAY,1,0,8.9,71,14.8,1001.3,Cloudy
3/18/2023 10:00,106,266,183220,200830,372,384050,SATURDAY,1,0,8.3,71,18.4,1002.6,Cloudy
3/18/2023 11:00,141,331,280427,954901,472,1235328,SATURDAY,1,0,8.3,65,20.5,1003.3,Cloudy
3/18/2023 12:00,150,356,205754,292582,506,498336,SATURDAY,1,0,7.8,60,20.5,1004.1,Cloudy
3/18/2023 13:00,251,420,810344,393485,671,1203829,SATURDAY,1,0,7.8,60,27.7,1004.1,Cloudy
3/18/2023 14:00,363,411,678556,369849,774,1048405,SATURDAY,1,0,7.2,56,20.5,1004,Cloudy
3/18/2023 15:00,372,400,3012060,380360,772,3392420,SATURDAY,1,0,7.8,51,16.6,1003.8,Cloudy
3/18/2023 16:00,329,402,1438416,353009,731,1791425,SATURDAY,1,0,9.4,48,14.8,1003.6,Cloudy
3/18/2023 17:00,327,417,1644375,356751,744,2001126,SATURDAY,1,0,9.4,44,13,1003.4,Cloudy
3/18/2023 18:00,289,406,633710,1218763,695,1852473,SATURDAY,1,0,9.4,44,13,1003.4,Cloudy
3/18/2023 19:00,158,296,339016,214000,454,553016,SATURDAY,1,0,11.1,38,11.2,1002.1,Cloudy
3/18/2023 20:00,68,180,124229,122251,248,246480,SATURDAY,1,0,11.7,35,13,1001.8,Cloudy
3/18/2023 21:00,65,123,140528,87162,188,227690,SATURDAY,1,0,10.6,33,14.8,1001.9,Cloudy
3/18/2023 22:00,76,126,231354,99659,202,331013,SATURDAY,1,0,9.4,33,16.6,1003.3,Cloudy
3/18/2023 23:00,79,125,154107,92214,204,246321,SATURDAY,1,0,9.4,33,16.6,1003.3,Fair
3/19/2023 0:00,61,85,120939,69017,146,189956,SUNDAY,1,0,6.7,36,31.7,1005.3,Fair
3/19/2023 1:00,109,49,1861795,44172,158,1905967,SUNDAY,1,0,5.6,36,16.6,1005.4,Fair
3/19/2023 2:00,50,23,149023,18616,73,167639,SUNDAY,1,0,5,38,11.2,1005.6,Fair
3/19/2023 3:00,8,15,8766,12955,23,21721,SUNDAY,1,0,5,38,11.2,1005.6,Fair
3/19/2023 4:00,12,9,73092,5434,21,78526,SUNDAY,1,0,4.4,39,14.8,1006.6,Fair
3/19/2023 5:00,2,13,3585,15924,15,19509,SUNDAY,1,0,4.4,43,16.6,1006.8,Fair
3/19/2023 6:00,3,34,3704,19499,37,23203,SUNDAY,1,0,2.2,54,13,1007,Fair
3/19/2023 7:00,7,50,5272,32281,57,37553,SUNDAY,1,0,2.2,54,18.4,1006.9,Fair
3/19/2023 8:00,14,93,14428,69827,107,84255,SUNDAY,1,0,2.2,54,18.4,1006.9,Fair
3/19/2023 9:00,50,130,105840,83338,180,189178,SUNDAY,1,0,0.6,58,24.1,1009,Fair
3/19/2023 10:00,90,209,151429,147908,299,299337,SUNDAY,1,0,-0.6,45,33.5,1009.9,Cloudy
3/19/2023 11:00,130,285,1029231,209519,415,1238750,SUNDAY,1,0,-0.6,45,29.5,1011.1,Fair
3/19/2023 12:00,135,296,654441,259151,431,913592,SUNDAY,1,0,-0.6,30,29.5,1011.1,Fair
3/19/2023 13:00,139,252,525595,210353,391,735948,SUNDAY,1,0,0,31,31.7,1011.2,Fair
3/19/2023 14:00,94,232,469605,181168,326,650773,SUNDAY,1,0,1.1,33,25.9,1010.9,Fair
3/19/2023 15:00,166,303,3252945,264462,469,3517407,SUNDAY,1,0,2.2,32,25.9,1011,Fair
3/19/2023 16:00,137,289,230513,230176,426,460689,SUNDAY,1,0,2.2,31,25.9,1011,Fair
3/19/2023 17:00,115,265,804476,217466,380,1021942,SUNDAY,1,0,3.3,30,38.9,1010.8,Fair
3/19/2023 18:00,67,258,753199,248396,325,1001595,SUNDAY,1,0,3.3,30,44.6,1010.8,Fair
3/19/2023 19:00,34,168,184899,118087,202,302986,SUNDAY,1,0,2.8,30,31.7,1011.3,Fair
3/19/2023 20:00,32,125,40279,80394,157,120673,SUNDAY,1,0,2.8,28,40.7,1011.7,Fair
3/19/2023 21:00,18,92,17746,62860,110,80606,SUNDAY,1,0,2.2,32,42.5,1012.3,Fair
3/19/2023 22:00,14,66,10169,43437,80,53606,SUNDAY,1,0,2.2,32,44.6,1012.3,Fair
3/19/2023 23:00,6,40,2680,24646,46,27326,SUNDAY,1,0,1.1,35,31.7,1015,Fair
3/20/2023 0:00,4,29,3459,24242,33,27701,MONDAY,0,0,1.1,35,31.7,1015,Fair
3/20/2023 1:00,10,13,63002,9274,23,72276,MONDAY,0,0,-0.6,41,22.3,1017.7,Fair
3/20/2023 2:00,0,3,0,2300,3,2300,MONDAY,0,0,-0.6,43,18.4,1018.7,Fair
3/20/2023 3:00,1,2,1722,654,3,2376,MONDAY,0,0,-0.6,43,18.4,1018.7,Fair
3/20/2023 4:00,4,10,9719,9248,14,18967,MONDAY,0,0,-0.6,51,18.4,1020.1,Fair
3/20/2023 5:00,3,28,2138,14073,31,16211,MONDAY,0,0,-0.6,51,14.8,1020.7,Clear
3/20/2023 6:00,9,125,52161,78059,134,130220,MONDAY,0,0,-1.1,55,14.8,1021.1,Clear
3/20/2023 7:00,20,294,16893,204521,314,221414,MONDAY,0,0,-1.1,55,14.8,1021.1,Clear
3/20/2023 8:00,53,592,49609,443055,645,492664,MONDAY,0,0,-1.1,53,16.6,1021.7,Clear
3/20/2023 9:00,34,377,56855,269437,411,326292,MONDAY,0,0,-1.7,56,16.6,1022.5,Clear
3/20/2023 10:00,36,233,1488595,164243,269,1652838,MONDAY,0,0,-1.7,56,20.5,1023.2,Fair
3/20/2023 11:00,48,193,55023,128698,241,183721,MONDAY,0,0,-0.6,51,20.5,1023.3,Fair
3/20/2023 12:00,48,244,95475,181633,292,277108,MONDAY,0,0,1.1,47,13,1023.7,Fair
3/20/2023 13:00,72,249,113431,182989,321,296420,MONDAY,0,0,1.1,47,13,1023.7,Fair
3/20/2023 14:00,75,263,96169,177632,338,273801,MONDAY,0,0,4.4,39,25.9,1023.7,Fair
3/20/2023 15:00,108,291,205242,210519,399,415761,MONDAY,0,0,6.1,36,25.9,1022.8,Fair
3/20/2023 16:00,121,490,187336,377346,611,564682,MONDAY,0,0,7.8,30,27.7,1022.2,Fair
3/20/2023 17:00,160,770,217661,599277,930,816938,MONDAY,0,0,7.8,30,29.5,1022.2,Fair
3/20/2023 18:00,124,590,155194,451788,714,606982,MONDAY,0,0,10,21,22.3,1020.6,Fair
3/20/2023 19:00,66,416,76343,287767,482,364110,MONDAY,0,0,11.1,21,24.1,1020.2,Fair
3/20/2023 20:00,37,290,43220,201353,327,244573,MONDAY,0,0,11.1,18,25.9,1020,Fair
3/20/2023 21:00,30,166,30299,103292,196,133591,MONDAY,0,0,11.1,18,25.9,1020,Fair
3/20/2023 22:00,36,113,53848,106162,149,160010,MONDAY,0,0,10.6,19,29.5,1019.9,Fair
3/20/2023 23:00,14,54,25300,39233,68,64533,MONDAY,0,0,10,20,20.5,1020.7,Fair
3/21/2023 0:00,6,25,4570,13289,31,17859,TUESDAY,0,0,8.3,25,18.4,1021.5,Fair
3/21/2023 1:00,1,10,534,7168,11,7702,TUESDAY,0,0,5.6,36,22.3,1022.9,Fair
3/21/2023 2:00,2,7,6708,3809,9,10517,TUESDAY,0,0,5,43,24.1,1023,Fair
3/21/2023 3:00,5,1,3552,2239,6,5791,TUESDAY,0,0,4.4,48,16.6,1023.2,Fair
3/21/2023 4:00,1,5,1102,5552,6,6654,TUESDAY,0,0,3.9,52,16.6,1023.6,Fair
3/21/2023 5:00,5,41,8568,24468,46,33036,TUESDAY,0,0,3.9,52,16.6,1023.6,Clear
3/21/2023 6:00,5,131,3756,88895,136,92651,TUESDAY,0,0,2.2,62,18.4,1024.5,Clear
3/21/2023 7:00,35,373,39851,272061,408,311912,TUESDAY,0,0,2.2,62,13,1024.5,Clear
3/21/2023 8:00,74,767,62608,559642,841,622250,TUESDAY,0,0,1.7,66,16.6,1025,Clear
3/21/2023 9:00,61,465,87719,349672,526,437391,TUESDAY,0,0,1.7,66,11.2,1025.4,Clear
3/21/2023 10:00,49,263,80496,197248,312,277744,TUESDAY,0,0,1.7,66,11.2,1025.4,Clear
3/21/2023 11:00,66,300,96059,250405,366,346464,TUESDAY,0,0,5,48,7.6,1026,Fair
3/21/2023 12:00,78,302,143137,204953,380,348090,TUESDAY,0,0,6.7,41,11.2,1026,Fair
3/21/2023 13:00,87,305,194843,246833,392,441676,TUESDAY,0,0,8.9,35,13,1026,Fair
3/21/2023 14:00,109,286,159689,212270,395,371959,TUESDAY,0,0,10.6,28,14.8,1026.3,Fair
3/21/2023 15:00,130,403,206953,310550,533,517503,TUESDAY,0,0,10.6,28,14.8,1026.3,Fair
3/21/2023 16:00,158,620,606459,507083,778,1113542,TUESDAY,0,0,13.3,22,25.9,1025.4,Fair
3/21/2023 17:00,258,936,1408055,782658,1194,2190713,TUESDAY,0,0,13.9,25,18.4,1024.9,Fair
3/21/2023 18:00,170,763,928581,600473,933,1529054,TUESDAY,0,0,13.9,25,18.4,1024.4,Fair
3/21/2023 19:00,102,448,884727,312954,550,1197681,TUESDAY,0,0,13.9,25,27.7,1024.4,Fair
3/21/2023 20:00,77,324,81530,234898,401,316428,TUESDAY,0,0,13.9,25,25.9,1024.1,Fair
3/21/2023 21:00,60,238,96165,153753,298,249918,TUESDAY,0,0,13.9,25,25.9,1024.3,Fair
3/21/2023 22:00,45,118,47727,64500,163,112227,TUESDAY,0,0,13.3,26,18.4,1025,Fair
3/21/2023 23:00,30,83,183953,62754,113,246707,TUESDAY,0,0,12.8,29,16.6,1025.7,Fair
3/22/2023 0:00,11,31,10165,35228,42,45393,WEDNESDAY,0,0,12.8,29,16.6,1025.7,Fair
3/22/2023 1:00,5,14,2909,6751,19,9660,WEDNESDAY,0,0,11.7,31,7.6,1027,Fair
3/22/2023 2:00,1,9,897,6726,10,7623,WEDNESDAY,0,0,8.3,49,9.4,1027.5,Fair
3/22/2023 3:00,0,3,0,1016,3,1016,WEDNESDAY,0,0,10.6,35,11.2,1027.5,Fair
3/22/2023 4:00,3,6,2097,2758,9,4855,WEDNESDAY,0,0,10.6,35,9.4,1027.6,Cloudy
3/22/2023 5:00,4,38,2545,25822,42,28367,WEDNESDAY,0,0,10.6,35,9.4,1027.6,Cloudy
3/22/2023 6:00,12,153,13835,94626,165,108461,WEDNESDAY,0,0,7.8,43,14.8,1028.5,Cloudy
3/22/2023 7:00,47,411,40183,308989,458,349172,WEDNESDAY,0,0,5.6,70,16.6,1028.9,Cloudy
3/22/2023 8:00,100,849,101323,661070,949,762393,WEDNESDAY,0,0,5,76,18.4,1029.5,Cloudy
3/22/2023 9:00,69,474,103806,342899,543,446705,WEDNESDAY,0,0,4.4,79,13,1030.1,Cloudy
3/22/2023 10:00,52,307,62558,221098,359,283656,WEDNESDAY,0,0,4.4,79,13,1030.1,Cloudy
3/22/2023 11:00,66,253,78501,188888,319,267389,WEDNESDAY,0,0,5,76,13,1030.9,Cloudy
3/22/2023 12:00,84,288,124050,197581,372,321631,WEDNESDAY,0,0,6.1,73,16.6,1031,Cloudy
3/22/2023 13:00,82,306,100925,249221,388,350146,WEDNESDAY,0,0,6.7,65,18.4,1031,Cloudy
3/22/2023 14:00,82,283,147874,200808,365,348682,WEDNESDAY,0,0,6.7,65,18.4,1031,Cloudy
3/22/2023 15:00,88,359,290542,267838,447,558380,WEDNESDAY,0,0,7.2,74,18.4,1030.3,Cloudy
3/22/2023 16:00,136,600,193472,429501,736,622973,WEDNESDAY,0,0,7.8,76,22.3,1029.6,Cloudy
3/22/2023 17:00,174,887,1349277,729435,1061,2078712,WEDNESDAY,0,0,7.8,73,27.7,1028.5,Cloudy
3/22/2023 18:00,153,650,192973,502422,803,695395,WEDNESDAY,0,0,7.8,73,27.7,1028.5,Cloudy
3/22/2023 19:00,82,412,138979,878911,494,1017890,WEDNESDAY,0,0,7.8,73,25.9,1027.3,Cloudy
3/22/2023 20:00,53,302,70996,209385,355,280381,WEDNESDAY,0,0,7.2,80,24.1,1026,Cloudy
3/22/2023 21:00,35,215,40055,160262,250,200317,WEDNESDAY,0,0,6.7,82,25.9,1025.4,Cloudy
3/22/2023 22:00,34,139,28798,88097,173,116895,WEDNESDAY,0,0,6.1,86,13,1025,Cloudy
3/22/2023 23:00,27,76,739328,50820,103,790148,WEDNESDAY,0,0,8.9,86,14.8,1024.4,Cloudy
3/23/2023 0:00,13,35,331004,20220,48,351224,THURSDAY,0,0,8.9,58,14.8,1024.4,Cloudy
3/23/2023 1:00,4,15,3135,13399,19,16534,THURSDAY,0,0,8.9,51,11.2,1024,Cloudy
3/23/2023 2:00,8,19,8308,10655,27,18963,THURSDAY,0,0,8.9,63,11.2,1023.4,Cloudy
3/23/2023 3:00,0,4,0,2977,4,2977,THURSDAY,0,0,8.3,71,11.2,1023.4,Rain
3/23/2023 4:00,0,12,0,9956,12,9956,THURSDAY,0,0,8.9,71,13,1022.7,Cloudy
3/23/2023 5:00,10,41,10639,29884,51,40523,THURSDAY,0,0,9.4,71,16.6,1022,Cloudy
3/23/2023 6:00,15,160,16904,97493,175,114397,THURSDAY,0,0,9.4,74,14.8,1021,Cloudy
3/23/2023 7:00,51,369,48181,263451,420,311632,THURSDAY,0,0,9.4,74,14.8,1021,Cloudy
3/23/2023 8:00,84,759,154294,554999,843,709293,THURSDAY,0,0,7.8,86,0,1019.3,Cloudy
3/23/2023 9:00,59,462,316266,316191,521,632457,THURSDAY,0,0,7.8,86,0,1019.3,Cloudy
3/23/2023 10:00,49,290,48963,197981,339,246944,THURSDAY,0,0,7.8,89,11.2,1017.6,Cloudy
3/23/2023 11:00,54,305,961016,212570,359,1173586,THURSDAY,0,0,7.8,89,11.2,1017.6,Cloudy
3/23/2023 12:00,71,324,75807,218908,395,294715,THURSDAY,0,0,7.8,89,11.2,1017,Cloudy
3/23/2023 13:00,90,298,143646,225950,388,369596,THURSDAY,0,0,10,86,11.2,1014.8,Cloudy
3/23/2023 14:00,86,305,115207,209179,391,324386,THURSDAY,0,0,10,86,11.2,1014.8,Cloudy
3/23/2023 15:00,110,374,145218,240241,484,385459,THURSDAY,0,0,14.4,57,14.8,1012,Cloudy
3/23/2023 16:00,111,508,138790,396076,619,534866,THURSDAY,0,0,14.4,53,22.3,1010.2,Cloudy
3/23/2023 17:00,192,791,399060,624902,983,1023962,THURSDAY,0,0,15.6,46,22.3,1008.8,Cloudy
3/23/2023 18:00,181,692,342104,1587394,873,1929498,THURSDAY,0,0,15,49,27.7,1007.1,Cloudy
3/23/2023 19:00,100,462,431475,327498,562,758973,THURSDAY,0,0,15,49,27.7,1007.1,Cloudy
3/23/2023 20:00,111,279,395045,203384,390,598429,THURSDAY,0,0,13.9,72,22.3,1004.6,Cloudy
3/23/2023 21:00,93,246,134838,170760,339,305598,THURSDAY,0,0,13.9,72,27.7,1004.6,Rain
3/23/2023 22:00,50,181,51357,133214,231,184571,THURSDAY,0,0,13.3,75,24.1,1003.7,Cloudy
3/23/2023 23:00,51,94,65976,68936,145,134912,THURSDAY,0,0,13.3,75,20.5,1004.4,Cloudy
3/24/2023 0:00,52,56,191444,40878,108,232322,FRIDAY,0,0,12.8,77,16.6,1003.9,Cloudy
3/24/2023 1:00,32,27,104330,20879,59,125209,FRIDAY,0,0,13.3,77,18.4,1004.9,Cloudy
3/24/2023 2:00,13,18,10344,9304,31,19648,FRIDAY,0,0,13.3,77,22.3,1005,Cloudy
3/24/2023 3:00,1,8,1257,8313,9,9570,FRIDAY,0,0,12.8,74,22.3,1005.1,Cloudy
3/24/2023 4:00,2,17,1197,10303,19,11500,FRIDAY,0,0,12.8,74,24.1,1005.1,Cloudy
3/24/2023 5:00,7,29,5340,14449,36,19789,FRIDAY,0,0,11.7,71,25.9,1005.6,Cloudy
3/24/2023 6:00,17,117,12177,82884,134,95061,FRIDAY,0,0,9.4,71,22.3,1007.4,Cloudy
3/24/2023 7:00,27,294,22686,195703,321,218389,FRIDAY,0,0,8.3,71,13,1007.9,Fair
3/24/2023 8:00,77,506,74383,371746,583,446129,FRIDAY,0,0,7.8,68,18.4,1008.9,Fair
3/24/2023 9:00,65,427,70319,282139,492,352458,FRIDAY,0,0,7.8,68,18.4,1008.9,Fair
3/24/2023 10:00,62,264,96595,183865,326,280460,FRIDAY,0,0,6.7,60,22.3,1010.9,Fair
3/24/2023 11:00,86,286,185902,197706,372,383608,FRIDAY,0,0,6.7,60,20.5,1011.4,Cloudy
3/24/2023 12:00,100,348,178925,241308,448,420233,FRIDAY,0,0,7.2,56,20.5,1011.9,Cloudy
3/24/2023 13:00,116,315,167009,211507,431,378516,FRIDAY,0,0,7.2,58,18.4,1012.4,Cloudy
3/24/2023 14:00,150,344,240419,247689,494,488108,FRIDAY,0,0,7.2,51,18.4,1013.2,Cloudy
3/24/2023 15:00,182,421,272114,301338,603,573452,FRIDAY,0,0,7.2,51,20.5,1013.2,Cloudy
3/24/2023 16:00,192,556,277258,416437,748,693695,FRIDAY,0,0,9.4,39,16.6,1013.1,Cloudy
3/24/2023 17:00,222,702,754818,564750,924,1319568,FRIDAY,0,0,10,37,18.4,1012.6,Cloudy
3/24/2023 18:00,213,610,386768,534917,823,921685,FRIDAY,0,0,10.6,35,18.4,1012.4,Cloudy
3/24/2023 19:00,142,371,135269,282697,513,417966,FRIDAY,0,0,10.6,35,11.2,1012.4,Cloudy
3/24/2023 20:00,81,282,95324,374382,363,469706,FRIDAY,0,0,11.7,32,14.8,1013.7,Cloudy
3/24/2023 21:00,96,212,123999,158982,308,282981,FRIDAY,0,0,10.6,36,18.4,1014,Cloudy
3/24/2023 22:00,84,182,394798,120450,266,515248,FRIDAY,0,0,8.9,39,18.4,1015.4,Cloudy
3/24/2023 23:00,60,96,301873,119533,156,421406,FRIDAY,0,0,8.9,39,18.4,1015.4,Cloudy
3/25/2023 0:00,64,81,66090,57750,145,123840,SATURDAY,1,0,7.8,42,13,1017,Cloudy
3/25/2023 1:00,71,76,124260,59360,147,183620,SATURDAY,1,0,7.2,44,14.8,1017.8,Cloudy
3/25/2023 2:00,28,36,93817,25606,64,119423,SATURDAY,1,0,5,48,16.6,1019,Cloudy
3/25/2023 3:00,8,13,12059,8787,21,20846,SATURDAY,1,0,4.4,51,14.8,1019.8,Cloudy
3/25/2023 4:00,7,9,6698,5390,16,12088,SATURDAY,1,0,4.4,51,14.8,1019.8,Cloudy
3/25/2023 5:00,4,15,2521,11316,19,13837,SATURDAY,1,0,2.2,62,11.2,1020.6,Fair
3/25/2023 6:00,10,45,13814,26045,55,39859,SATURDAY,1,0,1.1,67,11.2,1020.9,Fair
3/25/2023 7:00,17,59,17771,54178,76,71949,SATURDAY,1,0,1.7,66,13,1021,Fair
3/25/2023 8:00,48,159,76058,100724,207,176782,SATURDAY,1,0,1.1,73,11.2,1021.8,Fair
3/25/2023 9:00,72,200,115200,154819,272,270019,SATURDAY,1,0,1.1,73,11.2,1021.8,Fair
3/25/2023 10:00,94,242,133986,170286,336,304272,SATURDAY,1,0,3.3,67,18.4,1022.2,Fair
3/25/2023 11:00,105,272,207649,181589,377,389238,SATURDAY,1,0,3.9,67,20.5,1022.9,Cloudy
3/25/2023 12:00,115,294,145917,216920,409,362837,SATURDAY,1,0,4.4,73,20.5,1022.3,Cloudy
3/25/2023 13:00,73,284,346980,222913,357,569893,SATURDAY,1,0,5,62,27.7,1023.4,Cloudy
3/25/2023 14:00,73,266,107135,196428,339,303563,SATURDAY,1,0,5,62,27.7,1023.4,Cloudy
3/25/2023 15:00,61,196,82629,138673,257,221302,SATURDAY,1,0,4.4,65,27.7,1022.1,Cloudy
3/25/2023 16:00,67,185,647550,119125,252,766675,SATURDAY,1,0,5,65,27.7,1019.9,Cloudy
3/25/2023 17:00,50,229,65854,170729,279,236583,SATURDAY,1,0,4.4,70,33.5,1019.4,Rain
3/25/2023 18:00,55,178,325169,133567,233,458736,SATURDAY,1,0,4.4,70,31.7,1019.4,Rain
3/25/2023 19:00,32,142,39897,169808,174,209705,SATURDAY,1,0,3.9,86,31.7,1017.8,Snow
3/25/2023 20:00,19,77,17761,108270,96,126031,SATURDAY,1,0,3.9,86,29.5,1017.8,Snow
3/25/2023 21:00,18,56,25446,40227,74,65673,SATURDAY,1,0,3.9,89,31.7,1016.7,Rain
3/25/2023 22:00,27,82,30175,58887,109,89062,SATURDAY,1,0,3.9,89,33.5,1015.1,Rain
3/25/2023 23:00,33,66,35720,46797,99,82517,SATURDAY,1,0,3.9,89,40.7,1014.8,Rain
3/26/2023 0:00,34,46,36080,30692,80,66772,SUNDAY,1,0,3.9,89,38.9,1012.7,Rain
3/26/2023 1:00,44,37,49268,32400,81,81668,SUNDAY,1,0,4.4,97,22.3,1012.1,Rain
3/26/2023 2:00,20,32,27230,22353,52,49583,SUNDAY,1,0,4.4,97,20.5,1010,Cloudy
3/26/2023 3:00,6,7,4170,2264,13,6434,SUNDAY,1,0,5,96,18.4,1008.5,Rain
3/26/2023 4:00,5,4,4328,2450,9,6778,SUNDAY,1,0,5,96,18.4,1008.5,Cloudy
3/26/2023 5:00,3,14,4362,12791,17,17153,SUNDAY,1,0,5.6,100,11.2,1005.9,Cloudy
3/26/2023 6:00,3,34,6858,17011,37,23869,SUNDAY,1,0,5.6,100,11.2,1005.9,Cloudy
3/26/2023 7:00,11,58,13055,35209,69,48264,SUNDAY,1,0,5.6,100,9.4,1006.8,Cloudy
3/26/2023 8:00,40,103,59452,77962,143,137414,SUNDAY,1,0,5.6,100,0,1005.4,Cloudy
3/26/2023 9:00,80,192,152242,147497,272,299739,SUNDAY,1,0,5,96,14.8,1004.9,Cloudy
3/26/2023 10:00,108,262,634876,235015,370,869891,SUNDAY,1,0,5,96,16.6,1005.4,Cloudy
3/26/2023 11:00,158,320,255310,266006,478,521316,SUNDAY,1,0,5,96,20.5,1006.5,Cloudy
3/26/2023 12:00,215,365,463663,343315,580,806978,SUNDAY,1,0,7.8,73,18.4,1008.3,Cloudy
3/26/2023 13:00,266,411,535612,371429,677,907041,SUNDAY,1,0,7.8,73,18.4,1008.3,Cloudy
3/26/2023 14:00,278,365,1344855,366298,643,1711153,SUNDAY,1,0,9.4,50,29.5,1008.8,Fair
3/26/2023 15:00,284,428,737172,398116,712,1135288,SUNDAY,1,0,9.4,50,29.5,1008.8,Fair
3/26/2023 16:00,303,402,917907,367566,705,1285473,SUNDAY,1,0,11.7,43,27.7,1008.6,Fair
3/26/2023 17:00,274,438,1292286,411954,712,1704240,SUNDAY,1,0,12.2,40,33.5,1008.3,Fair
3/26/2023 18:00,213,400,722296,330904,613,1053200,SUNDAY,1,0,12.2,40,33.5,1008.3,Fair
3/26/2023 19:00,113,258,159297,199570,371,358867,SUNDAY,1,0,13.9,33,22.3,1008.9,Fair
3/26/2023 20:00,95,204,101122,156746,299,257868,SUNDAY,1,0,13.9,29,22.3,1009.5,Fair
3/26/2023 21:00,45,139,53200,87352,184,140552,SUNDAY,1,0,13.9,29,44.6,1009.5,Fair
3/26/2023 22:00,28,81,49097,50408,109,99505,SUNDAY,1,0,13.3,29,31.7,1010.3,Fair
3/26/2023 23:00,20,52,16956,29150,72,46106,SUNDAY,1,0,12.8,30,25.9,1011.1,Fair
3/27/2023 0:00,5,20,4765,11590,25,16355,MONDAY,0,0,11.1,28,24.1,1013.1,Fair
3/27/2023 1:00,1,24,419,17442,25,17861,MONDAY,0,0,11.1,28,24.1,1013.1,Fair
3/27/2023 2:00,1,8,394,3564,9,3958,MONDAY,0,0,9.4,32,13,1014.7,Fair
3/27/2023 3:00,1,2,1029,2505,3,3534,MONDAY,0,0,9.4,32,13,1014.7,Clear
3/27/2023 4:00,1,11,447,9683,12,10130,MONDAY,0,0,6.7,49,5.4,1016,Clear
3/27/2023 5:00,5,46,7270,21599,51,28869,MONDAY,0,0,5.6,55,0,1016.2,Clear
3/27/2023 6:00,16,134,15258,115320,150,130578,MONDAY,0,0,6.7,41,9.4,1016.1,Clear
3/27/2023 7:00,33,368,22962,310872,401,333834,MONDAY,0,0,6.7,41,11.2,1016.5,Clear
3/27/2023 8:00,49,653,42165,489024,702,531189,MONDAY,0,0,6.7,40,9.4,1016.9,Clear
3/27/2023 9:00,43,370,47246,965746,413,1012992,MONDAY,0,0,6.7,40,9.4,1016.9,Clear
3/27/2023 10:00,60,273,187671,193743,333,381414,MONDAY,0,0,4.4,48,9.4,1017.9,Clear
3/27/2023 11:00,66,268,125901,205963,334,331864,MONDAY,0,0,6.7,41,11.2,1018.8,Fair
3/27/2023 12:00,75,285,930564,207761,360,1138325,MONDAY,0,0,7.8,38,13,1018.4,Fair
3/27/2023 13:00,97,268,214897,200760,365,415657,MONDAY,0,0,9.4,39,13,1018.1,Fair
3/27/2023 14:00,98,311,435139,257650,409,692789,MONDAY,0,0,9.4,39,13,1018.1,Fair
3/27/2023 15:00,140,337,327106,249062,477,576168,MONDAY,0,0,11.1,38,14.8,1017.8,Fair
3/27/2023 16:00,154,526,321051,497515,680,818566,MONDAY,0,0,11.7,35,16.6,1016.8,Cloudy
3/27/2023 17:00,174,759,237816,595731,933,833547,MONDAY,0,0,12.2,32,13,1016.2,Cloudy
3/27/2023 18:00,133,599,176631,503691,732,680322,MONDAY,0,0,12.2,32,13,1016.2,Cloudy
3/27/2023 19:00,66,369,90574,271593,435,362167,MONDAY,0,0,10,48,27.7,1015.6,Cloudy
3/27/2023 20:00,38,210,30996,135620,248,166616,MONDAY,0,0,8.9,50,27.7,1015.5,Cloudy
3/27/2023 21:00,10,84,7087,55407,94,62494,MONDAY,0,0,7.8,63,24.1,1015.4,Cloudy
3/27/2023 22:00,9,43,55000,26669,52,81669,MONDAY,0,0,7.8,63,24.1,1015.4,Cloudy
3/27/2023 23:00,1,24,1491,16128,25,17619,MONDAY,0,0,7.2,63,13,1015.9,Cloudy
3/28/2023 0:00,0,8,0,4862,8,4862,TUESDAY,0,0,7.2,71,13,1015.7,Rain
3/28/2023 1:00,0,2,0,2121,2,2121,TUESDAY,0,0,7.2,74,13,1016.7,Rain
3/28/2023 2:00,1,2,617,842,3,1459,TUESDAY,0,0,5.6,85,5.4,1016.8,Rain
3/28/2023 3:00,0,1,0,915,1,915,TUESDAY,0,0,5.6,85,5.4,1016.8,Rain
3/28/2023 4:00,1,6,767,6432,7,7199,TUESDAY,0,0,5,86,9.4,1016.6,Rain
3/28/2023 5:00,2,26,566,16523,28,17089,TUESDAY,0,0,3.3,89,9.4,1016.3,Rain
3/28/2023 6:00,10,122,32839,78984,132,111823,TUESDAY,0,0,2.8,93,0,1016.2,Rain
3/28/2023 7:00,17,283,39176,200495,300,239671,TUESDAY,0,0,3.3,89,5.4,1016.2,Rain
3/28/2023 8:00,38,441,28277,327660,479,355937,TUESDAY,0,0,3.3,89,0,1016.4,Rain
3/28/2023 9:00,22,265,24542,168473,287,193015,TUESDAY,0,0,3.3,89,0,1016.4,Rain
3/28/2023 10:00,22,173,27961,112772,195,140733,TUESDAY,0,0,3.9,89,5.4,1016.6,Rain
3/28/2023 11:00,24,150,94816,88354,174,183170,TUESDAY,0,0,3.9,89,5.4,1016.6,Cloudy
3/28/2023 12:00,18,172,21543,104943,190,126486,TUESDAY,0,0,3.9,89,9.4,1017.1,Cloudy
3/28/2023 13:00,30,212,42117,169764,242,211881,TUESDAY,0,0,3.9,89,16.6,1017.5,Snow
3/28/2023 14:00,36,225,136342,175238,261,311580,TUESDAY,0,0,3.9,89,16.6,1017.5,Cloudy
3/28/2023 15:00,78,321,100890,232600,399,333490,TUESDAY,0,0,3.9,86,13,1018.3,Cloudy
3/28/2023 16:00,87,511,115053,453125,598,568178,TUESDAY,0,0,4.4,83,13,1018.4,Cloudy
3/28/2023 17:00,171,774,213883,620150,945,834033,TUESDAY,0,0,4.4,83,13,1018.4,Cloudy
3/28/2023 18:00,116,588,720971,462704,704,1183675,TUESDAY,0,0,5.6,73,9.4,1018.2,Cloudy
3/28/2023 19:00,86,417,817783,299964,503,1117747,TUESDAY,0,0,6.1,76,11.2,1017.2,Cloudy
3/28/2023 20:00,61,299,63426,207151,360,270577,TUESDAY,0,0,5.6,79,11.2,1017,Cloudy
3/28/2023 21:00,40,200,41847,154931,240,196778,TUESDAY,0,0,5.6,79,13,1017,Cloudy
3/28/2023 22:00,21,115,15466,79915,136,95381,TUESDAY,0,0,6.7,73,14.8,1017.3,Fair
3/28/2023 23:00,15,53,18546,76629,68,95175,TUESDAY,0,0,5.6,73,7.6,1017.8,Fair
3/29/2023 0:00,9,34,11760,18284,43,30044,WEDNESDAY,0,0,6.7,45,11.2,1018.3,Fair
3/29/2023 1:00,8,9,5539,5833,17,11372,WEDNESDAY,0,0,5,57,7.6,1019.4,Fair
3/29/2023 2:00,2,4,1128,1812,6,2940,WEDNESDAY,0,0,5.6,44,7.6,1019.7,Fair
3/29/2023 3:00,1,5,813,3247,6,4060,WEDNESDAY,0,0,5.6,44,7.6,1019.7,Fair
3/29/2023 4:00,0,9,0,8423,9,8423,WEDNESDAY,0,0,5,48,9.4,1019.9,Fair
3/29/2023 5:00,6,41,3931,28032,47,31963,WEDNESDAY,0,0,2.8,61,9.4,1019.3,Fair
3/29/2023 6:00,8,135,5506,114231,143,119737,WEDNESDAY,0,0,2.2,59,16.6,1018.5,Clear
3/29/2023 7:00,35,416,30212,310844,451,341056,WEDNESDAY,0,0,1.7,61,9.4,1019.5,Clear
3/29/2023 8:00,90,773,94661,610395,863,705056,WEDNESDAY,0,0,1.1,64,9.4,1019.6,Clear
3/29/2023 9:00,53,447,54377,323439,500,377816,WEDNESDAY,0,0,1.1,64,9.4,1019.6,Clear
3/29/2023 10:00,42,282,73913,192449,324,266362,WEDNESDAY,0,0,1.1,64,13,1020.9,Fair
3/29/2023 11:00,52,258,91275,201966,310,293241,WEDNESDAY,0,0,1.7,61,13,1021.5,Fair
3/29/2023 12:00,72,258,98458,196396,330,294854,WEDNESDAY,0,0,1.7,61,13,1021.5,Fair
3/29/2023 13:00,78,291,256765,223758,369,480523,WEDNESDAY,0,0,4.4,48,16.6,1021.5,Fair
3/29/2023 14:00,84,303,147163,465236,387,612399,WEDNESDAY,0,0,4.4,48,16.6,1021.5,Fair
3/29/2023 15:00,114,322,196790,258520,436,455310,WEDNESDAY,0,0,6.7,45,11.2,1020.7,Fair
3/29/2023 16:00,132,570,259215,483619,702,742834,WEDNESDAY,0,0,5.6,57,11.2,1020,Fair
3/29/2023 17:00,229,915,384936,767433,1144,1152369,WEDNESDAY,0,0,5.6,57,18.4,1020,Fair
3/29/2023 18:00,171,694,276108,687295,865,963403,WEDNESDAY,0,0,6.7,53,22.3,1018,Fair
3/29/2023 19:00,83,430,79545,331491,513,411036,WEDNESDAY,0,0,6.7,60,22.3,1017.1,Fair
3/29/2023 20:00,63,263,149140,173963,326,323103,WEDNESDAY,0,0,6.7,62,25.9,1016.3,Fair
3/29/2023 21:00,36,210,401715,151669,246,553384,WEDNESDAY,0,0,7.2,60,24.1,1015.9,Fair
3/29/2023 22:00,21,136,16776,88186,157,104962,WEDNESDAY,0,0,7.2,60,24.1,1015.9,Fair
3/29/2023 23:00,11,50,10607,37759,61,48366,WEDNESDAY,0,0,6.7,53,24.1,1015.8,Cloudy
3/30/2023 0:00,5,24,4347,14892,29,19239,THURSDAY,0,0,6.1,60,24.1,1016,Cloudy
3/30/2023 1:00,4,7,3605,56503,11,60108,THURSDAY,0,0,5,67,22.3,1015.7,Cloudy
3/30/2023 2:00,2,12,1327,10216,14,11543,THURSDAY,0,0,4.4,70,18.4,1015.3,Cloudy
3/30/2023 3:00,0,2,0,1597,2,1597,THURSDAY,0,0,4.4,70,18.4,1015.3,Cloudy
3/30/2023 4:00,0,4,0,3674,4,3674,THURSDAY,0,0,4.4,70,27.7,1013.8,Cloudy
3/30/2023 5:00,6,45,5336,28946,51,34282,THURSDAY,0,0,5,65,24.1,1014.7,Cloudy
3/30/2023 6:00,10,121,7145,85562,131,92707,THURSDAY,0,0,4.4,68,24.1,1015.3,Cloudy
3/30/2023 7:00,25,358,44205,266658,383,310863,THURSDAY,0,0,4.4,68,27.7,1015.3,Cloudy
3/30/2023 8:00,76,652,328253,509090,728,837343,THURSDAY,0,0,1.7,54,31.7,1016.8,Fair
3/30/2023 9:00,45,400,56154,285673,445,341827,THURSDAY,0,0,0.6,47,29.5,1018.2,Fair
3/30/2023 10:00,38,222,267374,400669,260,668043,THURSDAY,0,0,0,39,25.9,1019.5,Fair
3/30/2023 11:00,50,220,66773,138085,270,204858,THURSDAY,0,0,0.6,41,25.9,1020.6,Fair
3/30/2023 12:00,76,283,187203,190710,359,377913,THURSDAY,0,0,1.1,36,25.9,1021.2,Fair
3/30/2023 13:00,71,259,109908,401709,330,511617,THURSDAY,0,0,1.1,36,31.7,1021.2,Fair
3/30/2023 14:00,52,237,58191,170579,289,228770,THURSDAY,0,0,2.2,29,31.7,1022.3,Fair
3/30/2023 15:00,83,295,226288,233501,378,459789,THURSDAY,0,0,2.8,30,22.3,1022.2,Fair
3/30/2023 16:00,122,483,154307,412657,605,566964,THURSDAY,0,0,3.3,27,18.4,1022.4,Fair
3/30/2023 17:00,184,704,248462,734334,888,982796,THURSDAY,0,0,3.3,24,18.4,1022.2,Fair
3/30/2023 18:00,128,601,168705,455833,729,624538,THURSDAY,0,0,3.3,24,18.4,1022.2,Fair
3/30/2023 19:00,84,383,160991,262833,467,423824,THURSDAY,0,0,5,19,22.3,1022,Fair
3/30/2023 20:00,34,271,38860,186194,305,225054,THURSDAY,0,0,5,21,29.5,1021.8,Fair
3/30/2023 21:00,28,184,18785,134917,212,153702,THURSDAY,0,0,3.9,22,25.9,1022.5,Fair
3/30/2023 22:00,34,133,130919,98036,167,228955,THURSDAY,0,0,3.9,22,29.5,1022.5,Fair
3/30/2023 23:00,17,66,115617,40146,83,155763,THURSDAY,0,0,3.3,25,18.4,1023.5,Fair
3/31/2023 0:00,14,40,29067,25361,54,54428,FRIDAY,0,0,2.8,31,18.4,1024.3,Fair
3/31/2023 1:00,12,19,12455,16671,31,29126,FRIDAY,0,0,2.2,32,18.4,1025,Fair
3/31/2023 2:00,6,9,4587,6120,15,10707,FRIDAY,0,0,2.2,35,18.4,1025.3,Clear
3/31/2023 3:00,0,8,0,7932,8,7932,FRIDAY,0,0,2.2,35,18.4,1025.3,Clear
3/31/2023 4:00,2,7,2153,5642,9,7795,FRIDAY,0,0,1.1,40,14.8,1026.3,Clear
3/31/2023 5:00,7,31,3526,22757,38,26283,FRIDAY,0,0,1.1,41,18.4,1026.6,Clear
3/31/2023 6:00,9,121,7847,86198,130,94045,FRIDAY,0,0,0.6,43,13,1026.2,Clear
3/31/2023 7:00,21,262,19907,222576,283,242483,FRIDAY,0,0,0.6,43,13,1026.2,Clear
3/31/2023 8:00,54,518,67337,385131,572,452468,FRIDAY,0,0,0.6,41,14.8,1026.9,Clear
3/31/2023 9:00,64,371,79999,251708,435,331707,FRIDAY,0,0,0.6,43,13,1027.5,Clear
3/31/2023 10:00,66,248,92605,504680,314,597285,FRIDAY,0,0,0.6,43,13,1027.5,Clear
3/31/2023 11:00,73,263,141450,199712,336,341162,FRIDAY,0,0,1.7,42,14.8,1028.3,Fair
3/31/2023 12:00,100,308,159121,225700,408,384821,FRIDAY,0,0,1.7,42,14.8,1028.3,Fair
3/31/2023 13:00,114,346,599506,346707,460,946213,FRIDAY,0,0,4.4,34,13,1028.3,Cloudy
3/31/2023 14:00,117,319,135409,245417,436,380826,FRIDAY,0,0,4.4,37,14.8,1027.7,Cloudy
3/31/2023 15:00,133,407,254027,304489,540,558516,FRIDAY,0,0,6.1,36,13,1026.9,Cloudy
3/31/2023 16:00,156,548,388223,427148,704,815371,FRIDAY,0,0,7.2,35,14.8,1025.3,Cloudy
3/31/2023 17:00,139,549,255797,385117,688,640914,FRIDAY,0,0,7.2,35,14.8,1025.3,Cloudy
3/31/2023 18:00,54,256,50929,190010,310,240939,FRIDAY,0,0,6.1,53,25.9,1023.2,Cloudy
3/31/2023 19:00,33,188,106546,139587,221,246133,FRIDAY,0,0,6.7,58,18.4,1022.1,Rain
3/31/2023 20:00,10,83,17571,58988,93,76559,FRIDAY,0,0,7.8,45,18.4,1020.6,Rain
3/31/2023 21:00,7,73,5733,47424,80,53157,FRIDAY,0,0,7.8,45,29.5,1020.6,Rain
3/31/2023 22:00,26,65,31160,39837,91,70997,FRIDAY,0,0,3.3,83,27.7,1021.8,Rain
3/31/2023 23:00,7,60,10150,41313,67,51463,FRIDAY,0,0,3.3,86,18.4,1019.3,Rain
4/1/2023 0:00,26,49,76697,31952,75,108649,SATURDAY,1,0,3.3,89,22.3,1019,Rain
4/1/2023 1:00,57,44,137229,38371,101,175600,SATURDAY,1,0,3.3,89,22.3,1019,Rain
4/1/2023 2:00,49,38,209576,32817,87,242393,SATURDAY,1,0,4.4,93,24.1,1018.3,Rain
4/1/2023 3:00,14,8,14346,7164,22,21510,SATURDAY,1,0,5,93,18.4,1014.8,Rain
4/1/2023 4:00,0,7,0,4230,7,4230,SATURDAY,1,0,5,100,5.4,1013.2,Rain
4/1/2023 5:00,4,10,3836,6534,14,10370,SATURDAY,1,0,5,100,5.4,1013.2,Cloudy
4/1/2023 6:00,8,28,23936,19666,36,43602,SATURDAY,1,0,5.6,96,7.6,1010.6,Cloudy
4/1/2023 7:00,14,50,21017,24278,64,45295,SATURDAY,1,0,5.6,96,7.6,1010.6,Cloudy
4/1/2023 8:00,10,50,16750,33812,60,50562,SATURDAY,1,0,5.6,100,0,1007.6,Cloudy
4/1/2023 9:00,13,62,20359,41746,75,62105,SATURDAY,1,0,5.6,100,0,1006.9,Cloudy
4/1/2023 10:00,18,105,589148,81490,123,670638,SATURDAY,1,0,5,100,7.6,1005,Cloudy
4/1/2023 11:00,25,102,25327,68019,127,93346,SATURDAY,1,0,5,100,7.6,1004.6,Rain
4/1/2023 12:00,25,86,25287,57418,111,82705,SATURDAY,1,0,5,100,7.6,1004.6,Rain
4/1/2023 13:00,54,182,561174,143200,236,704374,SATURDAY,1,0,5.6,100,0,1003.4,Rain
4/1/2023 14:00,97,242,570332,174826,339,745158,SATURDAY,1,0,6.1,100,0,999.3,Rain
4/1/2023 15:00,152,295,302369,260358,447,562727,SATURDAY,1,0,7.2,97,0,998,Cloudy
4/1/2023 16:00,192,363,313733,316865,555,630598,SATURDAY,1,0,7.2,97,0,998,Rain
4/1/2023 17:00,293,423,680485,1179968,716,1860453,SATURDAY,1,0,8.9,96,7.6,996.7,Cloudy
4/1/2023 18:00,358,495,2156203,514864,853,2671067,SATURDAY,1,0,10,100,0,994.9,Rain
4/1/2023 19:00,281,376,1884004,311631,657,2195635,SATURDAY,1,0,10,96,7.6,993.1,Rain
4/1/2023 20:00,161,284,400072,287175,445,687247,SATURDAY,1,0,16.7,78,25.9,991.6,Rain
4/1/2023 21:00,127,172,453629,191998,299,645627,SATURDAY,1,0,16.7,78,31.7,991.6,Cloudy
4/1/2023 22:00,103,154,1772634,161212,257,1933846,SATURDAY,1,0,15,81,22.3,991.7,Cloudy
4/1/2023 23:00,134,132,2062405,98981,266,2161386,SATURDAY,1,0,12.8,87,16.6,991.6,Cloudy
4/2/2023 0:00,117,99,340840,75060,216,415900,SUNDAY,1,0,11.7,89,14.8,992.2,Cloudy
4/2/2023 1:00,99,79,156005,96237,178,252242,SUNDAY,1,0,13.9,81,18.4,992.8,Cloudy
4/2/2023 2:00,67,43,66345,67764,110,134109,SUNDAY,1,0,13.9,81,18.4,992.8,Cloudy
4/2/2023 3:00,16,12,17181,9403,28,26584,SUNDAY,1,0,13.3,75,14.8,991.5,Rain
4/2/2023 4:00,10,9,13835,6300,19,20135,SUNDAY,1,0,12.8,66,14.8,991.6,Cloudy
4/2/2023 5:00,3,21,11585,19648,24,31233,SUNDAY,1,0,11.7,61,33.5,992.7,Cloudy
4/2/2023 6:00,10,35,40536,20499,45,61035,SUNDAY,1,0,11.1,63,22.3,993.6,Cloudy
4/2/2023 7:00,15,62,288508,41397,77,329905,SUNDAY,1,0,11.1,63,22.3,993.6,Cloudy
4/2/2023 8:00,33,113,43217,127619,146,170836,SUNDAY,1,0,9.4,66,25.9,996.8,Cloudy
4/2/2023 9:00,59,177,85306,141208,236,226514,SUNDAY,1,0,7.2,60,31.7,1000.1,Cloudy
4/2/2023 10:00,127,243,295952,208830,370,504782,SUNDAY,1,0,5.6,59,33.5,1003,Cloudy
4/2/2023 11:00,140,336,241211,276040,476,517251,SUNDAY,1,0,5.6,59,38.9,1003,Cloudy
4/2/2023 12:00,230,403,3069561,1047198,633,4116759,SUNDAY,1,0,5,53,38.9,1006.6,Cloudy
4/2/2023 13:00,196,392,911576,422924,588,1334500,SUNDAY,1,0,6.1,47,33.5,1007.8,Fair
4/2/2023 14:00,223,380,947777,327972,603,1275749,SUNDAY,1,0,6.7,41,27.7,1009.1,Fair
4/2/2023 15:00,221,384,1517097,312125,605,1829222,SUNDAY,1,0,7.2,34,31.7,1009.8,Fair
4/2/2023 16:00,281,403,911340,352138,684,1263478,SUNDAY,1,0,7.2,34,38.9,1009.8,Fair
4/2/2023 17:00,218,368,2141347,309753,586,2451100,SUNDAY,1,0,7.8,25,24.1,1011.6,Fair
4/2/2023 18:00,149,392,225884,286338,541,512222,SUNDAY,1,0,7.2,24,25.9,1012.6,Fair
4/2/2023 19:00,62,264,65705,186895,326,252600,SUNDAY,1,0,7.8,22,25.9,1013.2,Fair
4/2/2023 20:00,61,171,923188,113413,232,1036601,SUNDAY,1,0,7.2,21,25.9,1013.7,Fair
4/2/2023 21:00,26,128,17575,78019,154,95594,SUNDAY,1,0,7.2,21,25.9,1013.7,Fair
4/2/2023 22:00,23,97,659788,64025,120,723813,SUNDAY,1,0,6.1,20,22.3,1015.5,Fair
4/2/2023 23:00,17,61,16300,31110,78,47410,SUNDAY,1,0,5,18,22.3,1017.1,Fair
4/3/2023 0:00,8,29,7124,50052,37,57176,MONDAY,0,0,4.4,20,18.4,1017.9,Fair
4/3/2023 1:00,2,9,783,7430,11,8213,MONDAY,0,0,3.3,22,14.8,1019,Fair
4/3/2023 2:00,3,9,23645,6898,12,30543,MONDAY,0,0,3.3,22,14.8,1019,Clear
4/3/2023 3:00,1,4,768,2612,5,3380,MONDAY,0,0,2.2,23,16.6,1019.8,Clear
4/3/2023 4:00,3,8,2392,4759,11,7151,MONDAY,0,0,1.7,24,18.4,1020.3,Clear
4/3/2023 5:00,6,39,2749,25670,45,28419,MONDAY,0,0,1.1,27,13,1020.5,Fair
4/3/2023 6:00,12,163,14437,95350,175,109787,MONDAY,0,0,1.1,27,13,1020.5,Clear
4/3/2023 7:00,44,376,31753,267271,420,299024,MONDAY,0,0,0.6,29,5.4,1020.8,Clear
4/3/2023 8:00,59,708,90728,565338,767,656066,MONDAY,0,0,0,31,0,1020.7,Clear
4/3/2023 9:00,39,395,38558,358317,434,396875,MONDAY,0,0,0.6,32,0,1021.4,Clear
4/3/2023 10:00,54,295,76838,198054,349,274892,MONDAY,0,0,1.1,32,0,1022.4,Clear
4/3/2023 11:00,69,266,207324,180834,335,388158,MONDAY,0,0,1.1,32,0,1022.4,Fair
4/3/2023 12:00,108,316,246797,242312,424,489109,MONDAY,0,0,3.3,42,7.6,1023.7,Fair
4/3/2023 13:00,71,284,125161,225772,355,350933,MONDAY,0,0,5.6,41,20.5,1023.2,Fair
4/3/2023 14:00,108,341,182625,244088,449,426713,MONDAY,0,0,6.7,36,20.5,1022.2,Fair
4/3/2023 15:00,98,405,166853,280249,503,447102,MONDAY,0,0,8.3,33,20.5,1020.9,Fair
4/3/2023 16:00,155,603,410405,439006,758,849411,MONDAY,0,0,8.3,33,20.5,1020.9,Fair
4/3/2023 17:00,199,848,1800337,792478,1047,2592815,MONDAY,0,0,10.6,33,27.7,1018.5,Fair
4/3/2023 18:00,173,710,2812099,532614,883,3344713,MONDAY,0,0,11.1,39,27.7,1016.6,Fair
4/3/2023 19:00,117,481,1067966,1074259,598,2142225,MONDAY,0,0,10.6,44,33.5,1016.3,Cloudy
4/3/2023 20:00,65,319,111493,213269,384,324762,MONDAY,0,0,10.6,48,33.5,1015.3,Cloudy
4/3/2023 21:00,46,204,309982,131296,250,441278,MONDAY,0,0,10.6,48,33.5,1015.1,Cloudy
4/3/2023 22:00,70,159,236044,112437,229,348481,MONDAY,0,0,10.6,48,33.5,1015.1,Cloudy
4/3/2023 23:00,50,91,126222,64448,141,190670,MONDAY,0,0,9.4,44,31.7,1015.4,Cloudy
4/4/2023 0:00,16,27,17330,16239,43,33569,TUESDAY,0,0,8.9,54,37.1,1015.3,Cloudy
4/4/2023 1:00,16,11,72790,14177,27,86967,TUESDAY,0,0,8.9,54,29.5,1015.3,Cloudy
4/4/2023 2:00,3,9,44181,9231,12,53412,TUESDAY,0,0,8.3,65,27.7,1015.5,Cloudy
4/4/2023 3:00,1,4,1724,3399,5,5123,TUESDAY,0,0,8.9,66,13,1017.4,Cloudy
4/4/2023 4:00,2,13,3662,6642,15,10304,TUESDAY,0,0,8.9,66,13,1017.4,Cloudy
4/4/2023 5:00,5,44,3642,31725,49,35367,TUESDAY,0,0,6.7,79,9.4,1017.4,Cloudy
4/4/2023 6:00,15,173,10279,120438,188,130717,TUESDAY,0,0,6.7,79,9.4,1017.4,Cloudy
4/4/2023 7:00,47,445,65536,337997,492,403533,TUESDAY,0,0,6.7,82,14.8,1016.7,Cloudy
4/4/2023 8:00,101,906,129143,659719,1007,788862,TUESDAY,0,0,7.2,82,0,1017.4,Cloudy
4/4/2023 9:00,71,532,1148181,397510,603,1545691,TUESDAY,0,0,7.2,82,7.6,1017.8,Cloudy
4/4/2023 10:00,73,315,140544,251666,388,392210,TUESDAY,0,0,7.2,86,7.6,1017.9,Cloudy
4/4/2023 11:00,86,323,130317,336920,409,467237,TUESDAY,0,0,7.2,86,7.6,1017.9,Cloudy
4/4/2023 12:00,101,359,174962,281377,460,456339,TUESDAY,0,0,10,77,0,1018.4,Cloudy
4/4/2023 13:00,113,336,152236,257742,449,409978,TUESDAY,0,0,11.1,71,5.4,1018.6,Cloudy
4/4/2023 14:00,142,359,285233,269174,501,554407,TUESDAY,0,0,9.4,80,13,1019,Cloudy
4/4/2023 15:00,145,494,303280,346396,639,649676,TUESDAY,0,0,11.7,71,14.8,1018.8,Cloudy
4/4/2023 16:00,218,733,400177,546349,951,946526,TUESDAY,0,0,11.7,71,14.8,1018.8,Cloudy
4/4/2023 17:00,278,1031,681901,1237013,1309,1918914,TUESDAY,0,0,10,77,22.3,1019.1,Cloudy
4/4/2023 18:00,247,826,408072,707062,1073,1115134,TUESDAY,0,0,10.6,71,22.3,1019,Cloudy
4/4/2023 19:00,148,526,353671,387893,674,741564,TUESDAY,0,0,10,74,20.5,1019,Cloudy
4/4/2023 20:00,72,352,66202,252848,424,319050,TUESDAY,0,0,8.9,80,20.5,1019.6,Cloudy
4/4/2023 21:00,78,262,150795,235863,340,386658,TUESDAY,0,0,8.9,80,20.5,1019.6,Cloudy
4/4/2023 22:00,77,174,735321,182467,251,917788,TUESDAY,0,0,7.8,89,16.6,1021.6,Cloudy
4/4/2023 23:00,28,86,23748,57207,114,80955,TUESDAY,0,0,7.8,89,11.2,1022.6,Cloudy
4/5/2023 0:00,21,31,17728,19833,52,37561,WEDNESDAY,0,0,8.3,86,9.4,1023.3,Cloudy
4/5/2023 1:00,14,20,302942,14694,34,317636,WEDNESDAY,0,0,8.3,86,9.4,1023.3,Cloudy
4/5/2023 2:00,3,11,2219,7239,14,9458,WEDNESDAY,0,0,8.9,83,11.2,1023.9,Cloudy
4/5/2023 3:00,5,6,6261,6478,11,12739,WEDNESDAY,0,0,9.4,77,11.2,1024.4,Rain
4/5/2023 4:00,6,12,11896,6397,18,18293,WEDNESDAY,0,0,9.4,74,9.4,1024.9,Cloudy
4/5/2023 5:00,6,48,3867,32533,54,36400,WEDNESDAY,0,0,9.4,71,11.2,1024.9,Cloudy
4/5/2023 6:00,11,189,10963,131638,200,142601,WEDNESDAY,0,0,9.4,71,11.2,1024.9,Cloudy
4/5/2023 7:00,39,458,23800,349318,497,373118,WEDNESDAY,0,0,8.9,73,16.6,1025.9,Cloudy
4/5/2023 8:00,84,845,207578,2033729,929,2241307,WEDNESDAY,0,0,8.3,71,16.6,1026.8,Cloudy
4/5/2023 9:00,77,531,86289,400554,608,486843,WEDNESDAY,0,0,8.3,71,33.5,1026.8,Cloudy
4/5/2023 10:00,50,265,63961,196515,315,260476,WEDNESDAY,0,0,6.7,73,25.9,1029,Cloudy
4/5/2023 11:00,58,292,112446,178876,350,291322,WEDNESDAY,0,0,6.7,73,25.9,1029,Cloudy
4/5/2023 12:00,50,300,681849,218008,350,899857,WEDNESDAY,0,0,6.7,70,31.7,1030.5,Cloudy
4/5/2023 13:00,50,302,48311,208417,352,256728,WEDNESDAY,0,0,6.7,70,31.7,1030.5,Cloudy
4/5/2023 14:00,67,309,2341112,282603,376,2623715,WEDNESDAY,0,0,5.6,67,35.3,1031,Cloudy
4/5/2023 15:00,58,336,310466,239205,394,549671,WEDNESDAY,0,0,5.6,64,35.3,1030.5,Cloudy
4/5/2023 16:00,80,552,98796,400865,632,499661,WEDNESDAY,0,0,5.6,64,31.7,1030.5,Cloudy
4/5/2023 17:00,143,774,344957,581135,917,926092,WEDNESDAY,0,0,5,70,29.5,1029.1,Cloudy
4/5/2023 18:00,108,593,276440,477590,701,754030,WEDNESDAY,0,0,5,73,24.1,1028.5,Cloudy
4/5/2023 19:00,72,399,2337933,326978,471,2664911,WEDNESDAY,0,0,5,73,24.1,1027.4,Cloudy
4/5/2023 20:00,37,223,1453025,146393,260,1599418,WEDNESDAY,0,0,5,73,27.7,1027.4,Cloudy
4/5/2023 21:00,27,152,772388,101115,179,873503,WEDNESDAY,0,0,5,76,22.3,1026.9,Cloudy
4/5/2023 22:00,32,155,713377,169854,187,883231,WEDNESDAY,0,0,4.4,83,14.8,1026.2,Cloudy
4/5/2023 23:00,8,63,11148,90491,71,101639,WEDNESDAY,0,0,4.4,83,14.8,1026.2,Cloudy
4/6/2023 0:00,3,31,1833,20838,34,22671,THURSDAY,0,0,4.4,97,16.6,1025.6,Cloudy
4/6/2023 1:00,8,16,14990,13948,24,28938,THURSDAY,0,0,4.4,97,18.4,1026,Cloudy
4/6/2023 2:00,4,9,22130,3895,13,26025,THURSDAY,0,0,3.9,100,13,1024.6,Cloudy
4/6/2023 3:00,1,4,339,2984,5,3323,THURSDAY,0,0,3.9,100,13,1024.6,Cloudy
4/6/2023 4:00,2,8,1478,6158,10,7636,THURSDAY,0,0,3.9,100,7.6,1023.1,Cloudy
4/6/2023 5:00,6,42,4876,26980,48,31856,THURSDAY,0,0,3.9,93,5.4,1022,Cloudy
4/6/2023 6:00,7,145,4246,117569,152,121815,THURSDAY,0,0,3.9,93,5.4,1022,Cloudy
4/6/2023 7:00,40,376,54728,348076,416,402804,THURSDAY,0,0,3.9,100,0,1021,Cloudy
4/6/2023 8:00,70,784,57343,614879,854,672222,THURSDAY,0,0,3.9,100,0,1021,Cloudy
4/6/2023 9:00,56,507,71792,335463,563,407255,THURSDAY,0,0,3.9,96,11.2,1019.1,Cloudy
4/6/2023 10:00,52,314,111562,203239,366,314801,THURSDAY,0,0,3.9,96,11.2,1019.1,Cloudy
4/6/2023 11:00,65,287,95318,2508589,352,2603907,THURSDAY,0,0,4.4,100,7.6,1020.5,Cloudy
4/6/2023 12:00,89,375,164213,283417,464,447630,THURSDAY,0,0,5,100,7.6,1020.4,Cloudy
4/6/2023 13:00,99,361,486109,268598,460,754707,THURSDAY,0,0,5,100,7.6,1020.8,Cloudy
4/6/2023 14:00,112,368,276327,666652,480,942979,THURSDAY,0,0,5,100,7.6,1020.8,Cloudy
4/6/2023 15:00,143,419,211490,290649,562,502139,THURSDAY,0,0,5.6,100,9.4,1021,Cloudy
4/6/2023 16:00,155,717,709225,533998,872,1243223,THURSDAY,0,0,5.6,100,9.4,1021,Cloudy
4/6/2023 17:00,209,857,2429789,3052551,1066,5482340,THURSDAY,0,0,8.3,86,9.4,1020.1,Cloudy
4/6/2023 18:00,200,740,266812,678765,940,945577,THURSDAY,0,0,7.8,86,14.8,1019.8,Cloudy
4/6/2023 19:00,136,526,227037,400598,662,627635,THURSDAY,0,0,6.7,93,14.8,1018.5,Cloudy
4/6/2023 20:00,98,326,859498,220891,424,1080389,THURSDAY,0,0,6.7,93,14.8,1018.5,Cloudy
4/6/2023 21:00,89,283,179811,253571,372,433382,THURSDAY,0,0,7.2,90,13,1017.9,Rain
4/6/2023 22:00,50,174,111382,826325,224,937707,THURSDAY,0,0,7.8,86,7.6,1017.7,Cloudy
4/6/2023 23:00,44,126,49653,76428,170,126081,THURSDAY,0,0,8.3,83,11.2,1019.5,Cloudy
4/7/2023 0:00,37,69,285179,46150,106,331329,FRIDAY,0,0,11.1,74,0,1020.5,Cloudy
4/7/2023 1:00,24,38,23366,28385,62,51751,FRIDAY,0,0,11.1,74,0,1020.5,Cloudy
4/7/2023 2:00,12,18,312781,15627,30,328408,FRIDAY,0,0,12.8,62,18.4,1020.1,Cloudy
4/7/2023 3:00,1,8,2385,5450,9,7835,FRIDAY,0,0,12.8,43,22.3,1020.3,Cloudy
4/7/2023 4:00,2,6,1988,5213,8,7201,FRIDAY,0,0,12.2,43,18.4,1020.8,Cloudy
4/7/2023 5:00,9,44,5474,26057,53,31531,FRIDAY,0,0,12.2,40,18.4,1021,Cloudy
4/7/2023 6:00,21,115,17339,75413,136,92752,FRIDAY,0,0,12.2,40,18.4,1021,Cloudy
4/7/2023 7:00,41,270,47363,190194,311,237557,FRIDAY,0,0,11.1,39,14.8,1021.4,Cloudy
4/7/2023 8:00,63,579,102463,603200,642,705663,FRIDAY,0,0,11.1,36,16.6,1021.7,Cloudy
4/7/2023 9:00,101,459,2326372,390096,560,2716468,FRIDAY,0,0,10.6,36,18.4,1022.4,Cloudy
4/7/2023 10:00,101,312,184459,232729,413,417188,FRIDAY,0,0,10,34,18.4,1022.5,Cloudy
4/7/2023 11:00,139,379,1067169,284341,518,1351510,FRIDAY,0,0,10,34,24.1,1022.5,Cloudy
4/7/2023 12:00,155,354,422340,255618,509,677958,FRIDAY,0,0,10.6,36,24.1,1023.2,Cloudy
4/7/2023 13:00,148,406,236164,279486,554,515650,FRIDAY,0,0,12.2,31,25.9,1022.5,Cloudy
4/7/2023 14:00,177,375,522051,293876,552,815927,FRIDAY,0,0,12.8,29,25.9,1022.2,Cloudy
4/7/2023 15:00,166,438,253140,346713,604,599853,FRIDAY,0,0,12.8,29,31.7,1022.2,Cloudy
4/7/2023 16:00,160,508,1560483,378657,668,1939140,FRIDAY,0,0,13.9,21,31.7,1021.1,Cloudy
4/7/2023 17:00,175,654,990924,474911,829,1465835,FRIDAY,0,0,12.8,24,31.7,1020.8,Cloudy
4/7/2023 18:00,157,538,569710,371844,695,941554,FRIDAY,0,0,11.7,25,38.9,1021.4,Cloudy
4/7/2023 19:00,131,391,2081373,283470,522,2364843,FRIDAY,0,0,10.6,29,42.5,1021.6,Cloudy
4/7/2023 20:00,96,250,1165097,186125,346,1351222,FRIDAY,0,0,10.6,29,25.9,1021.6,Cloudy
4/7/2023 21:00,88,184,122176,162264,272,284440,FRIDAY,0,0,9.4,29,20.5,1022.7,Cloudy
4/7/2023 22:00,70,170,120875,139901,240,260776,FRIDAY,0,0,8.9,29,20.5,1024,Cloudy
4/7/2023 23:00,51,99,935245,62707,150,997952,FRIDAY,0,0,8.9,29,27.7,1024,Cloudy
4/8/2023 0:00,43,82,438883,46747,125,485630,SATURDAY,1,0,8.3,23,24.1,1024.5,Cloudy
4/8/2023 1:00,55,81,676553,71210,136,747763,SATURDAY,1,0,7.8,25,20.5,1025.8,Cloudy
4/8/2023 2:00,29,34,80965,23114,63,104079,SATURDAY,1,0,6.1,31,22.3,1027,Cloudy
4/8/2023 3:00,3,12,5315,14815,15,20130,SATURDAY,1,0,6.1,31,22.3,1027,Cloudy
4/8/2023 4:00,0,11,0,6278,11,6278,SATURDAY,1,0,3.9,34,20.5,1028.6,Cloudy
4/8/2023 5:00,7,14,7482,12036,21,19518,SATURDAY,1,0,3.9,34,31.7,1028.6,Cloudy
4/8/2023 6:00,15,45,11628,30572,60,42200,SATURDAY,1,0,2.2,37,18.4,1029.6,Fair
4/8/2023 7:00,19,80,31445,56320,99,87765,SATURDAY,1,0,1.7,38,14.8,1029.8,Fair
4/8/2023 8:00,55,174,73017,126305,229,199322,SATURDAY,1,0,1.7,38,16.6,1030,Fair
4/8/2023 9:00,109,255,215463,181231,364,396694,SATURDAY,1,0,1.1,41,16.6,1030.9,Fair
4/8/2023 10:00,164,303,296949,271288,467,568237,SATURDAY,1,0,1.1,41,20.5,1030.9,Clear
4/8/2023 11:00,213,354,608290,299745,567,908035,SATURDAY,1,0,2.2,37,14.8,1032.4,Fair
4/8/2023 12:00,310,439,588113,378889,749,967002,SATURDAY,1,0,3.3,31,22.3,1032.6,Fair
4/8/2023 13:00,307,429,1635821,342794,736,1978615,SATURDAY,1,0,4.4,29,20.5,1032.6,Fair
4/8/2023 14:00,391,462,2827725,529496,853,3357221,SATURDAY,1,0,5.6,27,20.5,1032.6,Fair
4/8/2023 15:00,374,437,848433,420781,811,1269214,SATURDAY,1,0,5.6,27,22.3,1032.6,Fair
4/8/2023 16:00,368,446,1769579,424445,814,2194024,SATURDAY,1,0,7.8,23,18.4,1031.4,Fair
4/8/2023 17:00,341,469,1209469,470726,810,1680195,SATURDAY,1,0,8.9,19,18.4,1030.8,Fair
4/8/2023 18:00,233,424,2077027,671265,657,2748292,SATURDAY,1,0,8.9,18,14.8,1029.7,Fair
4/8/2023 19:00,230,355,892660,279418,585,1172078,SATURDAY,1,0,10,17,14.8,1029.2,Fair
4/8/2023 20:00,107,225,217340,163176,332,380516,SATURDAY,1,0,10,17,20.5,1029.2,Cloudy
4/8/2023 21:00,96,175,726981,173724,271,900705,SATURDAY,1,0,10,16,18.4,1028.7,Cloudy
4/8/2023 22:00,73,140,96111,104849,213,200960,SATURDAY,1,0,10,16,18.4,1028.7,Fair
4/8/2023 23:00,98,144,2044583,106108,242,2150691,SATURDAY,1,0,9.4,16,20.5,1029,Cloudy
4/9/2023 0:00,69,78,195087,56552,147,251639,SUNDAY,1,0,8.3,21,13,1029.5,Cloudy
4/9/2023 1:00,79,78,81995,55149,157,137144,SUNDAY,1,0,5,55,7.6,1031.1,Cloudy
4/9/2023 2:00,59,48,82585,41681,107,124266,SUNDAY,1,0,5,55,7.6,1031.1,Fair
4/9/2023 3:00,11,11,88064,6055,22,94119,SUNDAY,1,0,4.4,62,5.4,1031.2,Fair
4/9/2023 4:00,2,4,1132,2646,6,3778,SUNDAY,1,0,3.3,39,13,1032.1,Fair
4/9/2023 5:00,8,21,9621,21108,29,30729,SUNDAY,1,0,3.3,39,13,1032.1,Fair
4/9/2023 6:00,5,45,6385,26286,50,32671,SUNDAY,1,0,3.9,55,22.3,1032.4,Fair
4/9/2023 7:00,18,75,57213,53636,93,110849,SUNDAY,1,0,3.3,55,14.8,1032.5,Fair
4/9/2023 8:00,49,108,97359,89526,157,186885,SUNDAY,1,0,2.2,59,9.4,1032.4,Fair
4/9/2023 9:00,87,192,169809,140535,279,310344,SUNDAY,1,0,2.2,59,7.6,1033,Fair
4/9/2023 10:00,168,294,386213,276148,462,662361,SUNDAY,1,0,2.2,59,7.6,1033,Fair
4/9/2023 11:00,244,333,534949,274448,577,809397,SUNDAY,1,0,3.9,50,11.2,1034.5,Fair
4/9/2023 12:00,238,351,1248225,327021,589,1575246,SUNDAY,1,0,6.1,41,7.6,1034.6,Fair
4/9/2023 13:00,256,374,501714,346881,630,848595,SUNDAY,1,0,6.1,41,7.6,1034.6,Fair
4/9/2023 14:00,243,379,784196,1620497,622,2404693,SUNDAY,1,0,6.7,41,14.8,1034.9,Fair
4/9/2023 15:00,284,373,835717,406097,657,1241814,SUNDAY,1,0,6.7,41,14.8,1034.9,Fair
4/9/2023 16:00,252,447,594865,405375,699,1000240,SUNDAY,1,0,8.3,28,16.6,1034,Fair
4/9/2023 17:00,232,402,2039795,349650,634,2389445,SUNDAY,1,0,8.9,30,16.6,1033.4,Fair
4/9/2023 18:00,199,395,303453,331276,594,634729,SUNDAY,1,0,8.3,34,22.3,1032.6,Fair
4/9/2023 19:00,109,293,239216,212742,402,451958,SUNDAY,1,0,8.3,34,25.9,1032.6,Fair
4/9/2023 20:00,54,170,89962,128772,224,218734,SUNDAY,1,0,8.3,37,27.7,1030.9,Fair
4/9/2023 21:00,30,132,36921,94355,162,131276,SUNDAY,1,0,8.3,46,18.4,1030.7,Fair
4/9/2023 22:00,29,103,28033,101212,132,129245,SUNDAY,1,0,8.9,39,18.4,1030.5,Fair
4/9/2023 23:00,16,53,11708,40650,69,52358,SUNDAY,1,0,7.8,45,18.4,1030.6,Fair
4/10/2023 0:00,3,30,1962,132526,33,134488,MONDAY,0,0,6.1,49,20.5,1031.3,Fair
4/10/2023 1:00,7,16,59604,10999,23,70603,MONDAY,0,0,6.1,49,20.5,1031.3,Fair
4/10/2023 2:00,3,5,2587,8262,8,10849,MONDAY,0,0,5,53,18.4,1031.4,Fair
4/10/2023 3:00,1,4,822,3490,5,4312,MONDAY,0,0,5,51,11.2,1031,Clear
4/10/2023 4:00,2,5,1237,2337,7,3574,MONDAY,0,0,4.4,57,14.8,1030.7,Clear
4/10/2023 5:00,8,41,5077,24617,49,29694,MONDAY,0,0,4.4,57,14.8,1030.7,Clear
4/10/2023 6:00,7,156,5059,304529,163,309588,MONDAY,0,0,3.9,62,16.6,1030,Clear
4/10/2023 7:00,34,382,31203,278848,416,310051,MONDAY,0,0,3.3,64,14.8,1030,Clear
4/10/2023 8:00,70,790,74118,1112130,860,1186248,MONDAY,0,0,3.3,64,9.4,1030.1,Clear
4/10/2023 9:00,66,472,90022,375619,538,465641,MONDAY,0,0,3.3,67,7.6,1030.5,Clear
4/10/2023 10:00,83,278,764094,231650,361,995744,MONDAY,0,0,3.3,67,7.6,1030.5,Clear
4/10/2023 11:00,86,319,185177,267709,405,452886,MONDAY,0,0,6.1,53,13,1031,Fair
4/10/2023 12:00,142,341,265875,648505,483,914380,MONDAY,0,0,8.3,44,14.8,1030.6,Fair
4/10/2023 13:00,141,337,210475,264330,478,474805,MONDAY,0,0,10.6,36,11.2,1030.2,Fair
4/10/2023 14:00,166,393,603845,291397,559,895242,MONDAY,0,0,12.2,30,5.4,1029.8,Fair
4/10/2023 15:00,175,464,1072325,1236296,639,2308621,MONDAY,0,0,12.2,30,5.4,1029.8,Fair
4/10/2023 16:00,229,707,1368051,968919,936,2336970,MONDAY,0,0,15,24,13,1028.2,Fair
4/10/2023 17:00,316,1006,2981092,2703504,1322,5684596,MONDAY,0,0,15.6,23,9.4,1027.2,Fair
4/10/2023 18:00,200,885,1132472,1832732,1085,2965204,MONDAY,0,0,13.3,23,9.4,1026.3,Fair
4/10/2023 19:00,167,587,280871,761798,754,1042669,MONDAY,0,0,13.3,38,24.1,1026.3,Fair
4/10/2023 20:00,83,321,1835645,282251,404,2117896,MONDAY,0,0,13.9,37,24.1,1025.2,Fair
4/10/2023 21:00,48,248,1430092,176548,296,1606640,MONDAY,0,0,12.8,45,24.1,1024.7,Fair
4/10/2023 22:00,55,144,76792,91992,199,168784,MONDAY,0,0,11.7,54,14.8,1024.4,Fair
4/10/2023 23:00,27,71,85581,323659,98,409240,MONDAY,0,0,11.7,52,5.4,1024.3,Fair
4/11/2023 0:00,5,31,5417,41980,36,47397,TUESDAY,0,0,11.7,52,5.4,1024.3,Fair
4/11/2023 1:00,16,7,794073,4858,23,798931,TUESDAY,0,0,10.6,50,9.4,1024.6,Fair
4/11/2023 2:00,5,6,9604,2581,11,12185,TUESDAY,0,0,10.6,48,14.8,1024,Fair
4/11/2023 3:00,1,10,1590,9720,11,11310,TUESDAY,0,0,10.6,44,16.6,1023.4,Clear
4/11/2023 4:00,1,10,418,4359,11,4777,TUESDAY,0,0,10,42,18.4,1022.8,Clear
4/11/2023 5:00,8,56,7046,37686,64,44732,TUESDAY,0,0,10,42,18.4,1022.8,Clear
4/11/2023 6:00,26,223,27083,152496,249,179579,TUESDAY,0,0,8.3,49,18.4,1021.5,Clear
4/11/2023 7:00,66,537,67740,405758,603,473498,TUESDAY,0,0,8.3,48,11.2,1021.1,Clear
4/11/2023 8:00,103,1034,86031,845651,1137,931682,TUESDAY,0,0,8.9,47,16.6,1020.2,Clear
4/11/2023 9:00,90,590,1024551,412590,680,1437141,TUESDAY,0,0,8.9,47,16.6,1020.2,Clear
4/11/2023 10:00,86,315,164639,248110,401,412749,TUESDAY,0,0,9.4,50,11.2,1020.6,Fair
4/11/2023 11:00,115,338,258774,247672,453,506446,TUESDAY,0,0,9.4,50,11.2,1020.6,Fair
4/11/2023 12:00,106,377,217979,286070,483,504049,TUESDAY,0,0,13.9,34,9.4,1019.8,Cloudy
4/11/2023 13:00,153,368,276173,662680,521,938853,TUESDAY,0,0,17.8,26,7.6,1019,Cloudy
4/11/2023 14:00,193,384,370117,302757,577,672874,TUESDAY,0,0,17.8,26,7.6,1019,Cloudy
4/11/2023 15:00,205,508,2245432,402364,713,2647796,TUESDAY,0,0,21.7,19,13,1016.8,Cloudy
4/11/2023 16:00,294,794,1521934,710410,1088,2232344,TUESDAY,0,0,23.3,16,13,1015.1,Cloudy
4/11/2023 17:00,419,1181,2047068,1070668,1600,3117736,TUESDAY,0,0,23.3,14,27.7,1013.9,Cloudy
4/11/2023 18:00,327,981,593931,806387,1308,1400318,TUESDAY,0,0,23.9,14,33.5,1012.4,Cloudy
4/11/2023 19:00,194,619,750253,511806,813,1262059,TUESDAY,0,0,23.9,14,33.5,1012.4,Cloudy
4/11/2023 20:00,109,388,266834,1415824,497,1682658,TUESDAY,0,0,23.3,15,22.3,1010.2,Cloudy
4/11/2023 21:00,136,280,202035,809773,416,1011808,TUESDAY,0,0,22.2,16,29.5,1009.6,Cloudy
4/11/2023 22:00,92,206,291383,203712,298,495095,TUESDAY,0,0,22.2,16,31.7,1009.3,Cloudy
4/11/2023 23:00,55,103,163456,77134,158,240590,TUESDAY,0,0,21.7,19,22.3,1008.4,Cloudy
4/12/2023 0:00,24,42,31840,25245,66,57085,WEDNESDAY,0,0,21.7,19,22.3,1008.4,Cloudy
4/12/2023 1:00,17,21,20622,11833,38,32455,WEDNESDAY,0,0,20,20,27.7,1007.2,Cloudy
4/12/2023 2:00,15,14,21689,10237,29,31926,WEDNESDAY,0,0,19.4,23,20.5,1006.4,Cloudy
4/12/2023 3:00,5,10,3554,6280,15,9834,WEDNESDAY,0,0,17.2,29,22.3,1005.6,Rain
4/12/2023 4:00,2,17,1828,9586,19,11414,WEDNESDAY,0,0,17.2,29,22.3,1005.6,Cloudy
4/12/2023 5:00,12,49,10524,33464,61,43988,WEDNESDAY,0,0,16.7,35,18.4,1004.6,Cloudy
4/12/2023 6:00,24,234,46688,148712,258,195400,WEDNESDAY,0,0,19.4,34,25.9,1004.3,Cloudy
4/12/2023 7:00,83,558,80923,418760,641,499683,WEDNESDAY,0,0,18.9,37,25.9,1004,Cloudy
4/12/2023 8:00,128,1064,136281,817466,1192,953747,WEDNESDAY,0,0,18.3,37,24.1,1004.4,Cloudy
4/12/2023 9:00,87,552,104250,447149,639,551399,WEDNESDAY,0,0,18.3,37,24.1,1004.4,Cloudy
4/12/2023 10:00,64,351,96619,245084,415,341703,WEDNESDAY,0,0,16.7,30,14.8,1006.7,Cloudy
4/12/2023 11:00,98,362,219272,262981,460,482253,WEDNESDAY,0,0,16.7,27,22.3,1007.4,Cloudy
4/12/2023 12:00,114,354,233483,246404,468,479887,WEDNESDAY,0,0,17.2,23,22.3,1007.7,Cloudy
4/12/2023 13:00,169,384,2008995,946924,553,2955919,WEDNESDAY,0,0,17.2,23,29.5,1007.7,Cloudy
4/12/2023 14:00,174,436,861003,761144,610,1622147,WEDNESDAY,0,0,17.2,23,33.5,1007.7,Cloudy
4/12/2023 15:00,194,437,821612,346415,631,1168027,WEDNESDAY,0,0,19.4,20,24.1,1007.2,Cloudy
4/12/2023 16:00,282,825,616127,1260469,1107,1876596,WEDNESDAY,0,0,21.1,23,24.1,1006.2,Cloudy
4/12/2023 17:00,376,1116,2681771,1011554,1492,3693325,WEDNESDAY,0,0,21.1,26,25.9,1006.4,Cloudy
4/12/2023 18:00,343,907,605412,934154,1250,1539566,WEDNESDAY,0,0,21.1,26,25.9,1006.4,Cloudy
4/12/2023 19:00,265,623,445773,615830,888,1061603,WEDNESDAY,0,0,21.7,25,22.3,1006.5,Cloudy
4/12/2023 20:00,151,427,191346,1108629,578,1299975,WEDNESDAY,0,0,22.2,25,16.6,1006.7,Cloudy
4/12/2023 21:00,129,340,355845,241657,469,597502,WEDNESDAY,0,0,22.2,26,20.5,1007,Cloudy
4/12/2023 22:00,105,200,160581,137033,305,297614,WEDNESDAY,0,0,21.7,27,16.6,1007.7,Cloudy
4/12/2023 23:00,58,112,76853,178842,170,255695,WEDNESDAY,0,0,21.7,27,16.6,1007.7,Cloudy
4/13/2023 0:00,26,46,40769,35268,72,76037,THURSDAY,0,0,18.3,34,9.4,1009,Cloudy
4/13/2023 1:00,16,23,24665,14981,39,39646,THURSDAY,0,0,18.3,34,14.8,1009.8,Cloudy
4/13/2023 2:00,10,14,10038,13784,24,23822,THURSDAY,0,0,13.3,53,0,1009.9,Cloudy
4/13/2023 3:00,2,9,798,4849,11,5647,THURSDAY,0,0,13.3,53,13,1010.7,Fair
4/13/2023 4:00,5,18,4550,12230,23,16780,THURSDAY,0,0,12.2,55,13,1010.7,Fair
4/13/2023 5:00,13,65,54707,42203,78,96910,THURSDAY,0,0,11.7,59,5.4,1010.9,Fair
4/13/2023 6:00,27,220,26334,225687,247,252021,THURSDAY,0,0,11.1,59,7.6,1010.5,Fair
4/13/2023 7:00,85,576,112205,495838,661,608043,THURSDAY,0,0,10,68,7.6,1010.4,Fair
4/13/2023 8:00,149,1026,178105,796053,1175,974158,THURSDAY,0,0,11.1,57,7.6,1010.3,Fair
4/13/2023 9:00,127,619,178017,489077,746,667094,THURSDAY,0,0,11.1,57,7.6,1010.3,Fair
4/13/2023 10:00,111,384,274279,280076,495,554355,THURSDAY,0,0,10,66,5.4,1010.1,Fair
4/13/2023 11:00,151,381,497976,295537,532,793513,THURSDAY,0,0,12.8,55,7.6,1010,Fair
4/13/2023 12:00,156,470,319447,361688,626,681135,THURSDAY,0,0,18.9,40,14.8,1009.6,Fair
4/13/2023 13:00,178,442,975242,334002,620,1309244,THURSDAY,0,0,23.3,36,20.5,1009.3,Fair
4/13/2023 14:00,226,438,2270911,417623,664,2688534,THURSDAY,0,0,23.3,36,20.5,1009.3,Fair
4/13/2023 15:00,220,551,414691,534931,771,949622,THURSDAY,0,0,27.2,32,14.8,1008.5,Fair
4/13/2023 16:00,358,869,1864408,2660434,1227,4524842,THURSDAY,0,0,28.9,29,18.4,1007.8,Fair
4/13/2023 17:00,491,1157,4085843,1663919,1648,5749762,THURSDAY,0,0,29.4,27,16.6,1007.2,Fair
4/13/2023 18:00,476,985,1166547,1883324,1461,3049871,THURSDAY,0,0,29.4,27,16.6,1006.9,Fair
4/13/2023 19:00,350,706,1095966,681932,1056,1777898,THURSDAY,0,0,24.4,40,16.6,1006.9,Fair
4/13/2023 20:00,255,469,469832,783832,724,1253664,THURSDAY,0,0,25.6,36,13,1005.6,Fair
4/13/2023 21:00,173,377,362983,399655,550,762638,THURSDAY,0,0,31.1,22,14.8,1005.5,Fair
4/13/2023 22:00,152,273,264700,444520,425,709220,THURSDAY,0,0,30,24,16.6,1005.6,Fair
4/13/2023 23:00,119,176,195885,137566,295,333451,THURSDAY,0,0,30,24,16.6,1005.6,Fair
4/14/2023 0:00,79,89,733291,57896,168,791187,FRIDAY,0,0,28.3,28,13,1006.8,Fair
4/14/2023 1:00,88,52,732277,821685,140,1553962,FRIDAY,0,0,28.3,28,14.8,1006.8,Fair
4/14/2023 2:00,48,24,142995,14449,72,157444,FRIDAY,0,0,23.9,37,16.6,1007.4,Fair
4/14/2023 3:00,15,10,24882,27250,25,52132,FRIDAY,0,0,23.3,38,13,1007.6,Fair
4/14/2023 4:00,14,18,32540,15137,32,47677,FRIDAY,0,0,23.3,38,13,1007.6,Clear
4/14/2023 5:00,23,50,66310,60507,73,126817,FRIDAY,0,0,23.9,39,11.2,1008.1,Clear
4/14/2023 6:00,42,197,75831,140727,239,216558,FRIDAY,0,0,23.9,39,18.4,1008.1,Clear
4/14/2023 7:00,96,415,135974,490641,511,626615,FRIDAY,0,0,23.9,39,18.4,1008.3,Clear
4/14/2023 8:00,170,733,224943,586862,903,811805,FRIDAY,0,0,22.2,43,13,1008.5,Clear
4/14/2023 9:00,169,582,229957,498463,751,728420,FRIDAY,0,0,22.2,43,13,1008.5,Fair
4/14/2023 10:00,205,386,550604,316978,591,867582,FRIDAY,0,0,22.8,41,9.4,1009.9,Clear
4/14/2023 11:00,254,420,1301595,352702,674,1654297,FRIDAY,0,0,23.3,40,13,1010.5,Fair
4/14/2023 12:00,258,457,497810,357053,715,854863,FRIDAY,0,0,25.6,35,14.8,1010.5,Cloudy
4/14/2023 13:00,395,513,1468701,1144595,908,2613296,FRIDAY,0,0,27.8,32,11.2,1010.8,Cloudy
4/14/2023 14:00,489,574,3714732,695689,1063,4410421,FRIDAY,0,0,27.8,32,11.2,1010.8,Cloudy
4/14/2023 15:00,531,585,2479197,511782,1116,2990979,FRIDAY,0,0,26.7,37,13,1011.3,Cloudy
4/14/2023 16:00,642,817,3099206,855060,1459,3954266,FRIDAY,0,0,27.2,35,25.9,1011.1,Cloudy
4/14/2023 17:00,837,961,4199516,930713,1798,5130229,FRIDAY,0,0,27.2,35,25.9,1011.5,Cloudy
4/14/2023 18:00,781,852,2932150,750586,1633,3682736,FRIDAY,0,0,19.4,55,24.1,1011.6,Cloudy
4/14/2023 19:00,499,565,1722022,495119,1064,2217141,FRIDAY,0,0,19.4,55,24.1,1011.6,Cloudy
4/14/2023 20:00,353,349,2184269,282962,702,2467231,FRIDAY,0,0,17.8,56,27.7,1011.6,Cloudy
4/14/2023 21:00,316,323,2178484,257605,639,2436089,FRIDAY,0,0,13.3,75,29.5,1011.7,Cloudy
4/14/2023 22:00,373,309,1252009,246878,682,1498887,FRIDAY,0,0,12.2,77,22.3,1011.8,Cloudy
4/14/2023 23:00,234,179,2596115,166260,413,2762375,FRIDAY,0,0,12.2,77,22.3,1011.8,Cloudy
4/15/2023 0:00,152,123,423868,90264,275,514132,SATURDAY,1,0,11.1,83,22.3,1013,Cloudy
4/15/2023 1:00,117,78,198208,111097,195,309305,SATURDAY,1,0,10.6,80,22.3,1013.4,Cloudy
4/15/2023 2:00,83,51,976546,46653,134,1023199,SATURDAY,1,0,10,86,14.8,1013.6,Cloudy
4/15/2023 3:00,15,17,35724,12611,32,48335,SATURDAY,1,0,9.4,86,13,1013.8,Cloudy
4/15/2023 4:00,5,11,73241,6052,16,79293,SATURDAY,1,0,9.4,86,13,1013.8,Cloudy
4/15/2023 5:00,10,18,6879,12815,28,19694,SATURDAY,1,0,9.4,90,18.4,1014.3,Cloudy
4/15/2023 6:00,37,63,82131,65694,100,147825,SATURDAY,1,0,9.4,86,22.3,1014.3,Cloudy
4/15/2023 7:00,73,134,118547,143176,207,261723,SATURDAY,1,0,9.4,86,18.4,1014.3,Fair
4/15/2023 8:00,89,180,468278,154075,269,622353,SATURDAY,1,0,8.9,89,14.8,1014.7,Cloudy
4/15/2023 9:00,228,329,506950,1280423,557,1787373,SATURDAY,1,0,8.9,89,13,1015,Cloudy
4/15/2023 10:00,308,412,711624,370708,720,1082332,SATURDAY,1,0,9.4,90,11.2,1015.6,Fair
4/15/2023 11:00,445,506,1559808,499604,951,2059412,SATURDAY,1,0,10,83,13,1016,Cloudy
4/15/2023 12:00,480,572,1155291,516212,1052,1671503,SATURDAY,1,0,11.1,83,11.2,1016.4,Cloudy
4/15/2023 13:00,626,609,4374912,633852,1235,5008764,SATURDAY,1,0,11.1,83,11.2,1016.4,Cloudy
4/15/2023 14:00,626,566,3342514,562625,1192,3905139,SATURDAY,1,0,13.3,77,9.4,1016.3,Cloudy
4/15/2023 15:00,690,562,2309810,653295,1252,2963105,SATURDAY,1,0,13.3,77,14.8,1015.7,Cloudy
4/15/2023 16:00,607,510,1902908,661174,1117,2564082,SATURDAY,1,0,12.8,80,18.4,1015.5,Cloudy
4/15/2023 17:00,517,505,2209691,485031,1022,2694722,SATURDAY,1,0,13.3,77,20.5,1015.4,Cloudy
4/15/2023 18:00,421,520,818620,493173,941,1311793,SATURDAY,1,0,12.8,77,22.3,1015,Cloudy
4/15/2023 19:00,427,453,6317677,385339,880,6703016,SATURDAY,1,0,12.8,77,22.3,1015,Cloudy
4/15/2023 20:00,233,309,2626901,273051,542,2899952,SATURDAY,1,0,11.7,83,22.3,1014.3,Cloudy
4/15/2023 21:00,164,237,249956,233096,401,483052,SATURDAY,1,0,11.1,86,18.4,1014.1,Cloudy
4/15/2023 22:00,174,224,1858798,334007,398,2192805,SATURDAY,1,0,9.4,93,16.6,1014.6,Cloudy
4/15/2023 23:00,110,152,1000033,196966,262,1196999,SATURDAY,1,0,9.4,93,16.6,1014.6,Cloudy
4/16/2023 0:00,117,97,384444,84224,214,468668,SUNDAY,1,0,9.4,97,13,1015,Cloudy
4/16/2023 1:00,135,82,277386,101048,217,378434,SUNDAY,1,0,10,93,13,1014.8,Cloudy
4/16/2023 2:00,106,68,211031,67547,174,278578,SUNDAY,1,0,10.6,89,9.4,1014.1,Cloudy
4/16/2023 3:00,22,19,1412857,9673,41,1422530,SUNDAY,1,0,10.6,89,9.4,1014.1,Cloudy
4/16/2023 4:00,4,15,1854,7916,19,9770,SUNDAY,1,0,10,96,13,1013.1,Cloudy
4/16/2023 5:00,5,15,10035,17651,20,27686,SUNDAY,1,0,10,96,16.6,1012.6,Cloudy
4/16/2023 6:00,21,47,64231,23054,68,87285,SUNDAY,1,0,10,96,16.6,1012.6,Cloudy
4/16/2023 7:00,46,81,90604,57385,127,147989,SUNDAY,1,0,9.4,97,13,1012.5,Cloudy
4/16/2023 8:00,95,134,1093241,112500,229,1205741,SUNDAY,1,0,10,96,9.4,1013,Cloudy
4/16/2023 9:00,130,238,810076,186690,368,996766,SUNDAY,1,0,10,96,11.2,1013.2,Cloudy
4/16/2023 10:00,254,361,655622,293634,615,949256,SUNDAY,1,0,10,96,16.6,1013.1,Cloudy
4/16/2023 11:00,291,365,2872973,315945,656,3188918,SUNDAY,1,0,10,96,16.6,1013.1,Cloudy
4/16/2023 12:00,340,494,584478,724885,834,1309363,SUNDAY,1,0,9.4,97,13,1013.1,Cloudy
4/16/2023 13:00,367,470,2447220,408819,837,2856039,SUNDAY,1,0,10,96,14.8,1013.1,Cloudy
4/16/2023 14:00,365,449,2363264,1057088,814,3420352,SUNDAY,1,0,11.1,89,9.4,1012.7,Cloudy
4/16/2023 15:00,415,471,1643377,504382,886,2147759,SUNDAY,1,0,10.6,89,20.5,1013.1,Cloudy
4/16/2023 16:00,446,487,3128763,419033,933,3547796,SUNDAY,1,0,11.7,83,16.6,1012.4,Cloudy
4/16/2023 17:00,350,456,1722994,365543,806,2088537,SUNDAY,1,0,11.7,83,16.6,1012.4,Cloudy
4/16/2023 18:00,277,399,1752443,357465,676,2109908,SUNDAY,1,0,12.2,86,11.2,1012.1,Cloudy
4/16/2023 19:00,161,308,1215951,206954,469,1422905,SUNDAY,1,0,12.2,86,11.2,1012.1,Cloudy
4/16/2023 20:00,134,254,175347,176608,388,351955,SUNDAY,1,0,10.6,89,11.2,1011.5,Cloudy
4/16/2023 21:00,88,215,229306,178782,303,408088,SUNDAY,1,0,10,93,11.2,1011.3,Cloudy
4/16/2023 22:00,63,155,555431,130451,218,685882,SUNDAY,1,0,10,93,11.2,1011.3,Cloudy
4/16/2023 23:00,33,113,57201,98139,146,155340,SUNDAY,1,0,10,96,5.4,1010.9,Cloudy
4/17/2023 0:00,34,64,1492883,69481,98,1562364,MONDAY,0,1,9.4,93,9.4,1010.5,Cloudy
4/17/2023 1:00,27,32,64932,26144,59,91076,MONDAY,0,1,8.9,100,11.2,1010.3,Cloudy
4/17/2023 2:00,19,15,499590,15222,34,514812,MONDAY,0,1,8.9,100,11.2,1010.2,Cloudy
4/17/2023 3:00,5,7,4355,5542,12,9897,MONDAY,0,1,8.9,100,11.2,1010.2,Cloudy
4/17/2023 4:00,2,15,1408,14229,17,15637,MONDAY,0,1,8.9,100,7.6,1009.2,Cloudy
4/17/2023 5:00,20,56,38340,41981,76,80321,MONDAY,0,1,8.9,100,7.6,1009.2,Cloudy
4/17/2023 6:00,58,124,81060,80536,182,161596,MONDAY,0,1,8.9,96,9.4,1008.4,Cloudy
4/17/2023 7:00,70,266,101238,236944,336,338182,MONDAY,0,1,8.3,100,7.6,1007.9,Cloudy
4/17/2023 8:00,119,397,1203293,298516,516,1501809,MONDAY,0,1,8.3,100,7.6,1007.9,Cloudy
4/17/2023 9:00,193,378,1145875,284230,571,1430105,MONDAY,0,1,8.3,100,11.2,1007.1,Cloudy
4/17/2023 10:00,164,241,429683,287616,405,717299,MONDAY,0,1,8.3,100,11.2,1007.1,Cloudy
4/17/2023 11:00,162,249,697326,409104,411,1106430,MONDAY,0,1,8.3,100,18.4,1006.5,Cloudy
4/17/2023 12:00,181,277,391495,232746,458,624241,MONDAY,0,1,8.9,100,16.6,1006.5,Rain
4/17/2023 13:00,135,183,2066000,156795,318,2222795,MONDAY,0,1,8.9,100,16.6,1006.5,Cloudy
4/17/2023 14:00,178,222,1717317,193586,400,1910903,MONDAY,0,1,8.9,100,14.8,1006.1,Cloudy
4/17/2023 15:00,327,340,506877,285166,667,792043,MONDAY,0,1,9.4,100,22.3,1004.7,Cloudy
4/17/2023 16:00,281,411,637914,398561,692,1036475,MONDAY,0,1,9,100,20.5,1004.7,Cloudy
4/17/2023 17:00,238,560,550091,425540,798,975631,MONDAY,0,1,8.9,100,20.5,1004,Cloudy
4/17/2023 18:00,193,518,1152214,393508,711,1545722,MONDAY,0,1,9.4,100,18.4,1002.2,Cloudy
4/17/2023 19:00,69,355,1973698,252333,424,2226031,MONDAY,0,1,9.4,100,20.5,1001,Cloudy
4/17/2023 20:00,62,281,140380,541120,343,681500,MONDAY,0,1,9.4,100,20.5,1001,Cloudy
4/17/2023 21:00,68,189,101773,151850,257,253623,MONDAY,0,1,9.4,100,14.8,1000.3,Cloudy
4/17/2023 22:00,59,134,157007,106922,193,263929,MONDAY,0,1,10,100,9.4,999.8,Cloudy
4/17/2023 23:00,40,85,91674,73193,125,164867,MONDAY,0,1,10.6,100,13,1001,Cloudy
4/18/2023 0:00,27,46,36624,28968,73,65592,TUESDAY,0,0,10.6,100,11.2,1001.6,Cloudy
4/18/2023 1:00,21,21,63982,19670,42,83652,TUESDAY,0,0,11.1,97,9.4,1002,Cloudy
4/18/2023 2:00,3,9,3361,4808,12,8169,TUESDAY,0,0,11.1,97,9.4,1002,Cloudy
4/18/2023 3:00,3,8,2327,9911,11,12238,TUESDAY,0,0,11.1,93,9.4,1002.5,Cloudy
4/18/2023 4:00,4,12,5807,12382,16,18189,TUESDAY,0,0,11.1,93,9.4,1003,Cloudy
4/18/2023 5:00,11,50,18885,41123,61,60008,TUESDAY,0,0,10.6,92,7.6,1002.7,Cloudy
4/18/2023 6:00,25,195,159827,129548,220,289375,TUESDAY,0,0,10,96,11.2,1002.6,Cloudy
4/18/2023 7:00,60,489,78439,368909,549,447348,TUESDAY,0,0,10,96,11.2,1002.6,Fair
4/18/2023 8:00,145,981,168237,815587,1126,983824,TUESDAY,0,0,8.9,96,11.2,1002.6,Fair
4/18/2023 9:00,147,534,261399,395837,681,657236,TUESDAY,0,0,10,89,20.5,1002.8,Fair
4/18/2023 10:00,137,363,627522,317312,500,944834,TUESDAY,0,0,10,86,18.4,1003.1,Fair
4/18/2023 11:00,137,342,856556,230973,479,1087529,TUESDAY,0,0,10.6,74,24.1,1003.4,Fair
4/18/2023 12:00,128,378,761731,258791,506,1020522,TUESDAY,0,0,11.7,61,24.1,1003.5,Fair
4/18/2023 13:00,134,385,817300,261666,519,1078966,TUESDAY,0,0,11.7,61,27.7,1003.5,Fair
4/18/2023 14:00,158,342,239783,216131,500,455914,TUESDAY,0,0,13.3,43,29.5,1003.9,Fair
4/18/2023 15:00,177,464,1059753,385017,641,1444770,TUESDAY,0,0,13.9,37,31.7,1004.4,Fair
4/18/2023 16:00,188,686,774752,539714,874,1314466,TUESDAY,0,0,13.9,39,33.5,1004.6,Cloudy
4/18/2023 17:00,293,1071,1786270,1786087,1364,3572357,TUESDAY,0,0,13.9,39,29.5,1004.6,Cloudy
4/18/2023 18:00,270,852,1113909,978175,1122,2092084,TUESDAY,0,0,13.9,42,29.5,1005.3,Cloudy
4/18/2023 19:00,150,564,221037,641636,714,862673,TUESDAY,0,0,13.3,42,24.1,1005.3,Cloudy
4/18/2023 20:00,89,320,108608,353987,409,462595,TUESDAY,0,0,13.9,40,24.1,1005.5,Cloudy
4/18/2023 21:00,120,307,1015881,310432,427,1326313,TUESDAY,0,0,13.9,39,20.5,1006.1,Cloudy
4/18/2023 22:00,107,210,1636884,129666,317,1766550,TUESDAY,0,0,13.9,39,20.5,1006.1,Cloudy
4/18/2023 23:00,44,115,64972,72943,159,137915,TUESDAY,0,0,12.2,41,18.4,1008.2,Cloudy
4/19/2023 0:00,15,31,17660,19744,46,37404,WEDNESDAY,0,0,11.7,47,16.6,1009.1,Cloudy
4/19/2023 1:00,15,31,39966,22352,46,62318,WEDNESDAY,0,0,11.7,47,16.6,1009.1,Cloudy
4/19/2023 2:00,8,9,12220,6990,17,19210,WEDNESDAY,0,0,11.1,46,22.3,1010.1,Fair
4/19/2023 3:00,4,9,2048,7786,13,9834,WEDNESDAY,0,0,10.6,48,18.4,1010.8,Fair
4/19/2023 4:00,6,11,8425,5107,17,13532,WEDNESDAY,0,0,10.6,48,14.8,1011.1,Fair
4/19/2023 5:00,7,48,6766,40407,55,47173,WEDNESDAY,0,0,10,50,20.5,1011.2,Fair
4/19/2023 6:00,17,180,12178,145824,197,158002,WEDNESDAY,0,0,8.9,54,16.6,1011.3,Fair
4/19/2023 7:00,61,481,69981,396112,542,466093,WEDNESDAY,0,0,8.9,54,16.6,1011.3,Fair
4/19/2023 8:00,92,940,121163,995176,1032,1116339,WEDNESDAY,0,0,8.3,54,20.5,1011.9,Fair
4/19/2023 9:00,90,554,203306,396043,644,599349,WEDNESDAY,0,0,7.8,47,24.1,1012.5,Cloudy
4/19/2023 10:00,91,396,3463843,1404867,487,4868710,WEDNESDAY,0,0,7.2,51,18.4,1013.3,Fair
4/19/2023 11:00,85,336,159381,1830385,421,1989766,WEDNESDAY,0,0,7.2,49,20.5,1014,Fair
4/19/2023 12:00,109,319,1092958,207424,428,1300382,WEDNESDAY,0,0,7.2,49,20.5,1014,Fair
4/19/2023 13:00,80,346,606409,222951,426,829360,WEDNESDAY,0,0,10,39,25.9,1013.9,Fair
4/19/2023 14:00,127,331,2087234,241967,458,2329201,WEDNESDAY,0,0,11.1,41,24.1,1014.1,Fair
4/19/2023 15:00,122,373,746501,265690,495,1012191,WEDNESDAY,0,0,10,39,24.1,1014.8,Fair
4/19/2023 16:00,153,599,526660,1094002,752,1620662,WEDNESDAY,0,0,9.4,41,24.1,1015.6,Cloudy
4/19/2023 17:00,222,935,1274200,1371594,1157,2645794,WEDNESDAY,0,0,9.4,41,24.1,1015.6,Cloudy
4/19/2023 18:00,178,799,699714,654530,977,1354244,WEDNESDAY,0,0,10.6,41,24.1,1015.3,Fair
4/19/2023 19:00,122,528,121510,414138,650,535648,WEDNESDAY,0,0,10,42,24.1,1015.5,Fair
4/19/2023 20:00,79,347,1234941,232191,426,1467132,WEDNESDAY,0,0,10,44,20.5,1016,Fair
4/19/2023 21:00,85,256,236963,267930,341,504893,WEDNESDAY,0,0,10,44,20.5,1016,Fair
4/19/2023 22:00,104,190,113130,209545,294,322675,WEDNESDAY,0,0,10,44,22.3,1016.9,Fair
4/19/2023 23:00,34,108,58353,82411,142,140764,WEDNESDAY,0,0,9.4,46,25.9,1018.4,Cloudy
4/20/2023 0:00,13,60,14699,39552,73,54251,THURSDAY,0,0,9.4,46,22.3,1019.4,Cloudy
4/20/2023 1:00,13,17,30644,11060,30,41704,THURSDAY,0,0,8.3,49,20.5,1019.8,Fair
4/20/2023 2:00,9,15,12905,7723,24,20628,THURSDAY,0,0,8.3,49,20.5,1019.8,Fair
4/20/2023 3:00,4,6,2581,3811,10,6392,THURSDAY,0,0,7.2,51,22.3,1020.6,Fair
4/20/2023 4:00,4,8,4438,6150,12,10588,THURSDAY,0,0,6.1,55,20.5,1021,Fair
4/20/2023 5:00,11,46,8161,34658,57,42819,THURSDAY,0,0,6.1,55,16.6,1020.8,Fair
4/20/2023 6:00,24,167,32219,115192,191,147411,THURSDAY,0,0,5.6,59,18.4,1020.9,Fair
4/20/2023 7:00,71,461,241063,357830,532,598893,THURSDAY,0,0,5.6,59,18.4,1020.9,Fair
4/20/2023 8:00,96,923,85346,675632,1019,760978,THURSDAY,0,0,6.1,55,16.6,1022.1,Fair
4/20/2023 9:00,69,536,72020,374312,605,446332,THURSDAY,0,0,6.1,55,16.6,1022.5,Rain
4/20/2023 10:00,99,331,262898,251273,430,514171,THURSDAY,0,0,6.1,55,16.6,1022.7,Cloudy
4/20/2023 11:00,121,364,230718,282888,485,513606,THURSDAY,0,0,7.2,51,16.6,1023.2,Fair
4/20/2023 12:00,169,406,961384,302736,575,1264120,THURSDAY,0,0,7.2,51,16.6,1023.2,Fair
4/20/2023 13:00,181,446,2060598,395490,627,2456088,THURSDAY,0,0,9.4,44,22.3,1023.2,Fair
4/20/2023 14:00,175,434,520909,373678,609,894587,THURSDAY,0,0,10,42,22.3,1023.2,Fair
4/20/2023 15:00,251,491,5372497,399073,742,5771570,THURSDAY,0,0,11.7,38,16.6,1022.5,Fair
4/20/2023 16:00,325,846,1159887,732960,1171,1892847,THURSDAY,0,0,13.3,33,11.2,1021.5,Fair
4/20/2023 17:00,365,1066,2242958,920318,1431,3163276,THURSDAY,0,0,13.3,33,11.2,1021.5,Fair
4/20/2023 18:00,350,916,1965242,760001,1266,2725243,THURSDAY,0,0,13.3,37,14.8,1019.9,Fair
4/20/2023 19:00,239,645,1369919,2147169,884,3517088,THURSDAY,0,0,12.8,40,18.4,1019.6,Fair
4/20/2023 20:00,123,393,158668,701386,516,860054,THURSDAY,0,0,11.1,57,18.4,1019.8,Fair
4/20/2023 21:00,120,319,1147185,1284804,439,2431989,THURSDAY,0,0,11.1,57,27.7,1019.8,Cloudy
4/20/2023 22:00,81,209,88447,181044,290,269491,THURSDAY,0,0,11.1,59,22.3,1019.8,Fair
4/20/2023 23:00,48,128,101722,89591,176,191313,THURSDAY,0,0,10.6,61,14.8,1020.3,Fair
4/21/2023 0:00,35,63,36044,39659,98,75703,FRIDAY,0,0,10.6,61,14.8,1020.3,Cloudy
4/21/2023 1:00,47,30,448170,17784,77,465954,FRIDAY,0,0,10,61,13,1020.9,Cloudy
4/21/2023 2:00,20,18,23760,11067,38,34827,FRIDAY,0,0,8.3,74,11.2,1021.1,Cloudy
4/21/2023 3:00,8,13,9420,8776,21,18196,FRIDAY,0,0,8.3,74,11.2,1021.1,Cloudy
4/21/2023 4:00,7,12,5905,9145,19,15050,FRIDAY,0,0,8.3,76,7.6,1021.6,Cloudy
4/21/2023 5:00,8,36,5870,23716,44,29586,FRIDAY,0,0,8.3,80,5.4,1021.6,Cloudy
4/21/2023 6:00,18,154,11581,99899,172,111480,FRIDAY,0,0,8.3,80,5.4,1021.5,Cloudy
4/21/2023 7:00,48,326,74028,252814,374,326842,FRIDAY,0,0,8.3,80,5.4,1021.5,Cloudy
4/21/2023 8:00,101,671,131079,1230691,772,1361770,FRIDAY,0,0,7.8,86,18.4,1022.2,Cloudy
4/21/2023 9:00,90,511,146484,353219,601,499703,FRIDAY,0,0,7.8,83,24.1,1022.3,Cloudy
4/21/2023 10:00,123,360,149510,995237,483,1144747,FRIDAY,0,0,7.8,68,22.3,1022.9,Cloudy
4/21/2023 11:00,136,361,195265,225226,497,420491,FRIDAY,0,0,7.8,68,24.1,1023,Cloudy
4/21/2023 12:00,150,426,245050,318679,576,563729,FRIDAY,0,0,7.8,68,24.1,1023,Cloudy
4/21/2023 13:00,171,397,865517,328309,568,1193826,FRIDAY,0,0,8.3,68,20.5,1023.1,Cloudy
4/21/2023 14:00,190,480,341990,341448,670,683438,FRIDAY,0,0,9.4,66,20.5,1023,Cloudy
4/21/2023 15:00,254,500,2670480,380446,754,3050926,FRIDAY,0,0,9.4,66,20.5,1023.2,Cloudy
4/21/2023 16:00,303,653,1604447,519308,956,2123755,FRIDAY,0,0,10,63,20.5,1022.7,Cloudy
4/21/2023 17:00,353,885,3225181,1400864,1238,4626045,FRIDAY,0,0,10,63,20.5,1022.7,Cloudy
4/21/2023 18:00,305,770,2673027,1159230,1075,3832257,FRIDAY,0,0,10,68,29.5,1020.7,Cloudy
4/21/2023 19:00,200,564,1401653,427499,764,1829152,FRIDAY,0,0,10,66,27.7,1020.5,Cloudy
4/21/2023 20:00,126,328,227700,942976,454,1170676,FRIDAY,0,0,10,66,33.5,1020.2,Cloudy
4/21/2023 21:00,111,255,192631,187480,366,380111,FRIDAY,0,0,10,66,33.5,1020.2,Cloudy
4/21/2023 22:00,113,219,293866,171903,332,465769,FRIDAY,0,0,9.4,71,22.3,1020.7,Cloudy
4/21/2023 23:00,99,147,239117,152006,246,391123,FRIDAY,0,0,8.9,73,24.1,1020.7,Fair
4/22/2023 0:00,111,119,1773901,91876,230,1865777,SATURDAY,1,0,8.9,73,24.1,1020.7,Fair
4/22/2023 1:00,110,82,467332,65066,192,532398,SATURDAY,1,0,8.9,71,20.5,1021.1,Fair
4/22/2023 2:00,61,72,99741,81256,133,180997,SATURDAY,1,0,8.9,71,14.8,1021.2,Fair
4/22/2023 3:00,17,18,15003,14927,35,29930,SATURDAY,1,0,8.3,74,11.2,1021.1,Fair
4/22/2023 4:00,10,11,13307,6930,21,20237,SATURDAY,1,0,8.3,74,11.2,1021.1,Cloudy
4/22/2023 5:00,11,20,17327,14534,31,31861,SATURDAY,1,0,8.3,80,14.8,1020.9,Cloudy
4/22/2023 6:00,15,52,17720,25698,67,43418,SATURDAY,1,0,8.3,86,13,1020.3,Cloudy
4/22/2023 7:00,37,103,66036,66554,140,132590,SATURDAY,1,0,8.3,86,13,1020.3,Cloudy
4/22/2023 8:00,75,176,134481,161069,251,295550,SATURDAY,1,0,8.3,83,16.6,1020.3,Cloudy
4/22/2023 9:00,113,301,172092,229242,414,401334,SATURDAY,1,0,8.3,83,18.4,1020.5,Cloudy
4/22/2023 10:00,152,389,262133,336568,541,598701,SATURDAY,1,0,8.3,86,20.5,1020.9,Cloudy
4/22/2023 11:00,213,454,365099,395747,667,760846,SATURDAY,1,0,8.9,80,20.5,1021.2,Cloudy
4/22/2023 12:00,238,487,984885,384520,725,1369405,SATURDAY,1,0,8.9,80,20.5,1021.2,Cloudy
4/22/2023 13:00,251,463,583335,407920,714,991255,SATURDAY,1,0,9.4,77,22.3,1021.3,Cloudy
4/22/2023 14:00,317,512,952246,444232,829,1396478,SATURDAY,1,0,9.4,77,24.1,1021.4,Cloudy
4/22/2023 15:00,263,467,520909,417376,730,938285,SATURDAY,1,0,9.4,80,27.7,1021,Cloudy
4/22/2023 16:00,277,418,580147,366207,695,946354,SATURDAY,1,0,9.4,80,27.7,1021,Cloudy
4/22/2023 17:00,200,448,264987,528788,648,793775,SATURDAY,1,0,9.4,80,27.7,1020.6,Cloudy
4/22/2023 18:00,185,434,299591,340073,619,639664,SATURDAY,1,0,9.4,80,25.9,1020.3,Cloudy
4/22/2023 19:00,92,347,244708,331390,439,576098,SATURDAY,1,0,9.4,80,29.5,1020,Cloudy
4/22/2023 20:00,78,204,207287,435462,282,642749,SATURDAY,1,0,9.4,80,29.5,1020,Cloudy
4/22/2023 21:00,92,219,110130,155336,311,265466,SATURDAY,1,0,8.9,83,20.5,1019.8,Cloudy
4/22/2023 22:00,93,193,1279104,161493,286,1440597,SATURDAY,1,0,8.9,86,22.3,1020,Cloudy
4/22/2023 23:00,74,162,227996,114247,236,342243,SATURDAY,1,0,8.9,86,22.3,1020.1,Cloudy
4/23/2023 0:00,42,58,45020,36664,100,81684,SUNDAY,1,0,8.9,89,22.3,1019.7,Cloudy
4/23/2023 1:00,72,53,648235,69766,125,718001,SUNDAY,1,0,8.9,89,22.3,1019.7,Cloudy
4/23/2023 2:00,53,39,348209,34178,92,382387,SUNDAY,1,0,8.9,86,27.7,1019.5,Cloudy
4/23/2023 3:00,10,18,13418,14278,28,27696,SUNDAY,1,0,8.9,86,22.3,1018.8,Rain
4/23/2023 4:00,5,10,2283,6557,15,8840,SUNDAY,1,0,9.4,80,25.9,1018.1,Rain
4/23/2023 5:00,8,17,13531,8784,25,22315,SUNDAY,1,0,8.9,89,25.9,1017.8,Rain
4/23/2023 6:00,13,32,10762,17370,45,28132,SUNDAY,1,0,8.9,86,24.1,1017.1,Rain
4/23/2023 7:00,21,64,22832,40422,85,63254,SUNDAY,1,0,8.9,86,24.1,1017.1,Rain
4/23/2023 8:00,14,110,15532,73581,124,89113,SUNDAY,1,0,8.9,86,24.1,1016.1,Rain
4/23/2023 9:00,26,152,44171,114161,178,158332,SUNDAY,1,0,8.9,83,24.1,1016,Rain
4/23/2023 10:00,50,188,169129,154087,238,323216,SUNDAY,1,0,8.9,83,31.7,1016,Rain
4/23/2023 11:00,43,156,46341,114026,199,160367,SUNDAY,1,0,9.4,83,27.7,1015.8,Rain
4/23/2023 12:00,26,161,32490,111654,187,144144,SUNDAY,1,0,9.4,86,22.3,1015.7,Rain
4/23/2023 13:00,48,198,301669,119481,246,421150,SUNDAY,1,0,10,86,13,1015.7,Rain
4/23/2023 14:00,33,167,302087,171475,200,473562,SUNDAY,1,0,10,86,25.9,1015.3,Rain
4/23/2023 15:00,30,117,1037198,74667,147,1111865,SUNDAY,1,0,10,86,22.3,1015.1,Rain
4/23/2023 16:00,35,150,35326,121896,185,157222,SUNDAY,1,0,10.6,86,22.3,1014.5,Rain
4/23/2023 17:00,22,183,20778,129885,205,150663,SUNDAY,1,0,10.6,86,22.3,1014.5,Rain
4/23/2023 18:00,22,142,73681,91941,164,165622,SUNDAY,1,0,9.4,90,29.5,1014.3,Rain
4/23/2023 19:00,31,111,73590,71652,142,145242,SUNDAY,1,0,9.4,93,24.1,1013.3,Rain
4/23/2023 20:00,13,92,23432,59165,105,82597,SUNDAY,1,0,10,89,24.1,1012.7,Rain
4/23/2023 21:00,15,112,15955,73099,127,89054,SUNDAY,1,0,10,89,33.5,1012.7,Rain
4/23/2023 22:00,36,92,89957,109795,128,199752,SUNDAY,1,0,9.4,93,27.7,1012.8,Rain
4/23/2023 23:00,12,57,16587,41633,69,58220,SUNDAY,1,0,9.4,93,25.9,1012.2,Rain
4/24/2023 0:00,9,32,14406,22315,41,36721,MONDAY,0,0,10.6,92,16.6,1012.3,Rain
4/24/2023 1:00,17,24,797809,17467,41,815276,MONDAY,0,0,10.6,92,14.8,1012.8,Rain
4/24/2023 2:00,2,11,7042,13957,13,20999,MONDAY,0,0,9.4,100,9.4,1012.9,Cloudy
4/24/2023 3:00,3,7,1359,3761,10,5120,MONDAY,0,0,9.4,100,9.4,1012.9,Rain
4/24/2023 4:00,2,8,957,6579,10,7536,MONDAY,0,0,10.6,89,18.4,1013.6,Rain
4/24/2023 5:00,8,48,10112,29062,56,39174,MONDAY,0,0,9.4,90,20.5,1014.1,Cloudy
4/24/2023 6:00,17,192,29051,233582,209,262633,MONDAY,0,0,9.4,90,20.5,1014.1,Cloudy
4/24/2023 7:00,45,414,52186,340256,459,392442,MONDAY,0,0,8.9,86,18.4,1014.5,Cloudy
4/24/2023 8:00,81,761,82722,577252,842,659974,MONDAY,0,0,8.3,90,14.8,1014.6,Cloudy
4/24/2023 9:00,63,471,422787,324016,534,746803,MONDAY,0,0,8.3,86,14.8,1014.8,Cloudy
4/24/2023 10:00,61,338,91993,259073,399,351066,MONDAY,0,0,8.3,90,7.6,1015.6,Cloudy
4/24/2023 11:00,56,321,627144,219490,377,846634,MONDAY,0,0,8.3,90,7.6,1015.6,Cloudy
4/24/2023 12:00,109,390,713679,357370,499,1071049,MONDAY,0,0,8.3,86,9.4,1016.3,Cloudy
4/24/2023 13:00,110,349,159175,250593,459,409768,MONDAY,0,0,8.3,86,9.4,1016.3,Cloudy
4/24/2023 14:00,113,402,1169434,644189,515,1813623,MONDAY,0,0,10.6,74,0,1016.7,Cloudy
4/24/2023 15:00,115,463,1901575,368893,578,2270468,MONDAY,0,0,11.1,74,13,1016.7,Cloudy
4/24/2023 16:00,191,659,281840,1163194,850,1445034,MONDAY,0,0,11.1,74,13,1016.7,Cloudy
4/24/2023 17:00,200,942,1801396,811027,1142,2612423,MONDAY,0,0,11.7,74,24.1,1015.7,Cloudy
4/24/2023 18:00,165,783,193829,664750,948,858579,MONDAY,0,0,11.7,74,24.1,1015.7,Cloudy
4/24/2023 19:00,128,538,198631,437561,666,636192,MONDAY,0,0,11.7,69,27.7,1015.8,Cloudy
4/24/2023 20:00,59,382,71485,472458,441,543943,MONDAY,0,0,11.7,69,27.7,1015.8,Cloudy
4/24/2023 21:00,48,226,60499,271234,274,331733,MONDAY,0,0,11.1,77,20.5,1016,Cloudy
4/24/2023 22:00,37,150,405837,753377,187,1159214,MONDAY,0,0,10.6,80,22.3,1016.6,Cloudy
4/24/2023 23:00,18,109,17004,65074,127,82078,MONDAY,0,0,8.3,93,18.4,1016.9,Cloudy
4/25/2023 0:00,14,38,10549,52957,52,63506,TUESDAY,0,0,8.9,93,14.8,1017.1,Cloudy
4/25/2023 1:00,5,23,3374,20037,28,23411,TUESDAY,0,0,9.4,90,13,1017.7,Cloudy
4/25/2023 2:00,3,6,3111,2395,9,5506,TUESDAY,0,0,9.4,86,13,1018.1,Cloudy
4/25/2023 3:00,3,3,5529,4743,6,10272,TUESDAY,0,0,9.4,86,9.4,1018.3,Cloudy
4/25/2023 4:00,2,11,2101,6265,13,8366,TUESDAY,0,0,9.4,86,9.4,1018.3,Cloudy
4/25/2023 5:00,12,52,11364,54063,64,65427,TUESDAY,0,0,8.9,83,9.4,1018.9,Cloudy
4/25/2023 6:00,22,234,20140,156450,256,176590,TUESDAY,0,0,8.9,83,9.4,1018.9,Cloudy
4/25/2023 7:00,82,572,69581,1237750,654,1307331,TUESDAY,0,0,8.9,80,9.4,1019.3,Fair
4/25/2023 8:00,144,1006,212809,817208,1150,1030017,TUESDAY,0,0,8.9,80,9.4,1019.3,Fair
4/25/2023 9:00,84,607,121410,446822,691,568232,TUESDAY,0,0,7.8,83,11.2,1019.6,Fair
4/25/2023 10:00,82,376,120208,1081847,458,1202055,TUESDAY,0,0,7.8,83,11.2,1019.6,Cloudy
4/25/2023 11:00,80,340,657987,260230,420,918217,TUESDAY,0,0,8.9,77,11.2,1020,Cloudy
4/25/2023 12:00,130,404,760408,396840,534,1157248,TUESDAY,0,0,11.7,66,5.4,1020.4,Cloudy
4/25/2023 13:00,124,351,213529,258612,475,472141,TUESDAY,0,0,11.1,66,7.6,1020.5,Cloudy
4/25/2023 14:00,112,399,129748,419852,511,549600,TUESDAY,0,0,11.1,71,7.6,1020.6,Cloudy
4/25/2023 15:00,156,479,927360,345013,635,1272373,TUESDAY,0,0,11.1,71,16.6,1020.6,Cloudy
4/25/2023 16:00,154,717,244169,614102,871,858271,TUESDAY,0,0,13.3,62,16.6,1020.4,Cloudy
4/25/2023 17:00,228,1084,430119,873814,1312,1303933,TUESDAY,0,0,12.2,69,25.9,1020.2,Cloudy
4/25/2023 18:00,219,895,1001646,720303,1114,1721949,TUESDAY,0,0,11.1,69,25.9,1020.4,Cloudy
4/25/2023 19:00,145,580,208751,672461,725,881212,TUESDAY,0,0,10,77,20.5,1020.7,Cloudy
4/25/2023 20:00,79,377,93744,589036,456,682780,TUESDAY,0,0,10,77,20.5,1020.7,Cloudy
4/25/2023 21:00,53,229,70348,426403,282,496751,TUESDAY,0,0,10.6,71,24.1,1021,Cloudy
4/25/2023 22:00,82,177,801517,164896,259,966413,TUESDAY,0,0,10,77,14.8,1021.3,Cloudy
4/25/2023 23:00,37,86,50736,61526,123,112262,TUESDAY,0,0,10,77,14.8,1021.3,Cloudy
4/26/2023 0:00,23,51,51600,32235,74,83835,WEDNESDAY,0,0,8.9,86,18.4,1023,Cloudy
4/26/2023 1:00,13,25,27680,19824,38,47504,WEDNESDAY,0,0,8.9,86,18.4,1023,Cloudy
4/26/2023 2:00,9,16,15627,16187,25,31814,WEDNESDAY,0,0,8.9,83,16.6,1023.4,Cloudy
4/26/2023 3:00,5,3,5826,1263,8,7089,WEDNESDAY,0,0,8.9,83,18.4,1023.1,Cloudy
4/26/2023 4:00,8,15,11009,11397,23,22406,WEDNESDAY,0,0,8.3,86,13,1023.6,Cloudy
4/26/2023 5:00,11,52,18107,31332,63,49439,WEDNESDAY,0,0,8.3,83,13,1023.5,Cloudy
4/26/2023 6:00,27,227,26430,159663,254,186093,WEDNESDAY,0,0,8.3,83,13,1023.5,Cloudy
4/26/2023 7:00,75,493,64193,364089,568,428282,WEDNESDAY,0,0,8.9,83,9.4,1023.8,Cloudy
4/26/2023 8:00,129,953,142442,721153,1082,863595,WEDNESDAY,0,0,8.9,80,13,1024,Cloudy
4/26/2023 9:00,93,577,125992,421856,670,547848,WEDNESDAY,0,0,8.3,83,11.2,1024.3,Cloudy
4/26/2023 10:00,85,380,100357,241230,465,341587,WEDNESDAY,0,0,8.9,77,11.2,1024.9,Cloudy
4/26/2023 11:00,97,379,112717,255302,476,368019,WEDNESDAY,0,0,8.9,77,11.2,1024.9,Cloudy
4/26/2023 12:00,100,403,134886,278761,503,413647,WEDNESDAY,0,0,8.9,73,11.2,1025.3,Cloudy
4/26/2023 13:00,118,399,685633,297622,517,983255,WEDNESDAY,0,0,8.9,80,14.8,1025.6,Cloudy
4/26/2023 14:00,124,418,221104,877531,542,1098635,WEDNESDAY,0,0,10,71,20.5,1025.3,Cloudy
4/26/2023 15:00,134,467,221220,378262,601,599482,WEDNESDAY,0,0,10.6,71,20.5,1025,Cloudy
4/26/2023 16:00,194,725,868743,632418,919,1501161,WEDNESDAY,0,0,10.6,71,20.5,1025,Cloudy
4/26/2023 17:00,271,1078,1011251,908316,1349,1919567,WEDNESDAY,0,0,10.6,71,24.1,1024.4,Cloudy
4/26/2023 18:00,232,916,309642,1181807,1148,1491449,WEDNESDAY,0,0,10.6,68,24.1,1024.2,Cloudy
4/26/2023 19:00,143,540,154418,386945,683,541363,WEDNESDAY,0,0,10.6,68,25.9,1023.7,Cloudy
4/26/2023 20:00,66,373,175730,245243,439,420973,WEDNESDAY,0,0,10.6,68,25.9,1023.7,Cloudy
4/26/2023 21:00,59,273,873466,168949,332,1042415,WEDNESDAY,0,0,8.9,77,22.3,1023.6,Cloudy
4/26/2023 22:00,100,196,183690,136006,296,319696,WEDNESDAY,0,0,7.8,83,20.5,1023.8,Cloudy
4/26/2023 23:00,25,110,20010,76573,135,96583,WEDNESDAY,0,0,8.3,80,16.6,1024.4,Cloudy
4/27/2023 0:00,27,63,26902,44613,90,71515,THURSDAY,0,0,8.3,80,13,1025,Cloudy
4/27/2023 1:00,12,34,9102,21371,46,30473,THURSDAY,0,0,8.3,80,13,1025,Cloudy
4/27/2023 2:00,7,14,5929,10946,21,16875,THURSDAY,0,0,8.3,83,13,1024.4,Cloudy
4/27/2023 3:00,2,7,1630,3139,9,4769,THURSDAY,0,0,8.3,83,16.6,1024.2,Cloudy
4/27/2023 4:00,4,18,16133,14358,22,30491,THURSDAY,0,0,8.3,83,7.6,1024,Cloudy
4/27/2023 5:00,14,59,11265,40644,73,51909,THURSDAY,0,0,8.3,83,7.6,1024,Cloudy
4/27/2023 6:00,27,216,22339,160337,243,182676,THURSDAY,0,0,8.3,86,7.6,1023.7,Cloudy
4/27/2023 7:00,80,544,95395,380500,624,475895,THURSDAY,0,0,8.3,86,11.2,1023.5,Cloudy
4/27/2023 8:00,136,945,124484,701278,1081,825762,THURSDAY,0,0,8.3,80,13,1023.3,Cloudy
4/27/2023 9:00,85,570,106977,436498,655,543475,THURSDAY,0,0,8.3,80,9.4,1023.3,Cloudy
4/27/2023 10:00,88,318,155211,383567,406,538778,THURSDAY,0,0,8.3,80,9.4,1023.3,Fair
4/27/2023 11:00,111,333,198658,602751,444,801409,THURSDAY,0,0,10,74,14.8,1024.3,Cloudy
4/27/2023 12:00,99,363,121421,262790,462,384211,THURSDAY,0,0,10.6,71,13,1024.2,Cloudy
4/27/2023 13:00,114,325,215136,252708,439,467844,THURSDAY,0,0,11.7,66,9.4,1024.2,Cloudy
4/27/2023 14:00,136,360,188035,273106,496,461141,THURSDAY,0,0,11.7,66,13,1023.7,Cloudy
4/27/2023 15:00,111,401,243296,305945,512,549241,THURSDAY,0,0,11.7,66,13,1023.7,Cloudy
4/27/2023 16:00,154,628,724814,499289,782,1224103,THURSDAY,0,0,11.1,77,13,1023.2,Cloudy
4/27/2023 17:00,124,619,412662,789649,743,1202311,THURSDAY,0,0,11.1,77,18.4,1023,Cloudy
4/27/2023 18:00,170,735,183538,630048,905,813586,THURSDAY,0,0,11.1,77,16.6,1022.7,Cloudy
4/27/2023 19:00,178,540,402790,565212,718,968002,THURSDAY,0,0,11.7,83,16.6,1022.3,Cloudy
4/27/2023 20:00,101,432,135285,373354,533,508639,THURSDAY,0,0,11.7,83,16.6,1022.3,Cloudy
4/27/2023 21:00,77,260,583108,169490,337,752598,THURSDAY,0,0,11.7,77,13,1022.2,Cloudy
4/27/2023 22:00,74,190,415511,604809,264,1020320,THURSDAY,0,0,12.2,69,5.4,1022.3,Fair
4/27/2023 23:00,43,153,134506,151120,196,285626,THURSDAY,0,0,10.6,77,5.4,1022.7,Cloudy
4/28/2023 0:00,35,77,68580,49142,112,117722,FRIDAY,0,0,10,80,13,1022.9,Fair
4/28/2023 1:00,20,40,44459,22297,60,66756,FRIDAY,0,0,10,80,13,1022.9,Fair
4/28/2023 2:00,14,22,13595,15251,36,28846,FRIDAY,0,0,9.4,83,13,1022.9,Fair
4/28/2023 3:00,6,8,7196,6568,14,13764,FRIDAY,0,0,8.9,86,13,1023.2,Fair
4/28/2023 4:00,5,13,14087,8787,18,22874,FRIDAY,0,0,8.3,86,14.8,1023.7,Fair
4/28/2023 5:00,9,50,8185,86684,59,94869,FRIDAY,0,0,8.3,86,0,1023.3,Fair
4/28/2023 6:00,18,191,12150,150823,209,162973,FRIDAY,0,0,8.3,86,0,1023.3,Clear
4/28/2023 7:00,59,397,51992,309608,456,361600,FRIDAY,0,0,7.8,89,0,1023.1,Clear
4/28/2023 8:00,96,688,86427,538189,784,624616,FRIDAY,0,0,6.7,89,0,1023.2,Fair
4/28/2023 9:00,103,543,146153,394828,646,540981,FRIDAY,0,0,7.8,86,11.2,1023.8,Fair
4/28/2023 10:00,119,367,942284,307490,486,1249774,FRIDAY,0,0,7.8,86,11.2,1023.8,Fair
4/28/2023 11:00,145,397,281960,299536,542,581496,FRIDAY,0,0,10,80,5.4,1024.4,Fair
4/28/2023 12:00,191,496,577763,366698,687,944461,FRIDAY,0,0,11.1,77,9.4,1024.5,Fair
4/28/2023 13:00,240,497,798285,373579,737,1171864,FRIDAY,0,0,11.1,77,16.6,1024.1,Fair
4/28/2023 14:00,258,485,473035,362559,743,835594,FRIDAY,0,0,11.1,77,16.6,1024.1,Fair
4/28/2023 15:00,267,633,494944,512227,900,1007171,FRIDAY,0,0,11.7,77,9.4,1024.4,Cloudy
4/28/2023 16:00,337,791,714118,622128,1128,1336246,FRIDAY,0,0,12.8,66,20.5,1023.5,Cloudy
4/28/2023 17:00,366,958,562710,852202,1324,1414912,FRIDAY,0,0,13.3,64,18.4,1023.4,Cloudy
4/28/2023 18:00,394,746,822840,680016,1140,1502856,FRIDAY,0,0,13.9,59,20.5,1023.2,Cloudy
4/28/2023 19:00,229,564,479593,462812,793,942405,FRIDAY,0,0,13.3,64,22.3,1022.4,Cloudy
4/28/2023 20:00,119,317,305065,242946,436,548011,FRIDAY,0,0,13.3,64,22.3,1022.4,Cloudy
4/28/2023 21:00,140,298,169548,455289,438,624837,FRIDAY,0,0,11.7,69,20.5,1021.8,Cloudy
4/28/2023 22:00,148,232,501109,170848,380,671957,FRIDAY,0,0,10.6,77,16.6,1021.8,Cloudy
4/28/2023 23:00,142,182,350433,134854,324,485287,FRIDAY,0,0,10.6,77,16.6,1021.8,Cloudy
4/29/2023 0:00,85,135,198693,108324,220,307017,SATURDAY,1,0,10.6,83,20.5,1022,Cloudy
4/29/2023 1:00,139,109,794607,262995,248,1057602,SATURDAY,1,0,10.6,80,14.8,1022.3,Cloudy
4/29/2023 2:00,87,89,253762,75814,176,329576,SATURDAY,1,0,10,83,9.4,1022,Cloudy
4/29/2023 3:00,13,19,13172,17061,32,30233,SATURDAY,1,0,10,83,9.4,1022,Cloudy
4/29/2023 4:00,8,13,19780,21310,21,41090,SATURDAY,1,0,10,77,9.4,1021.5,Cloudy
4/29/2023 5:00,13,21,18194,24508,34,42702,SATURDAY,1,0,9.4,80,7.6,1020.9,Cloudy
4/29/2023 6:00,13,52,15310,42834,65,58144,SATURDAY,1,0,9.4,77,9.4,1019.6,Cloudy
4/29/2023 7:00,47,104,100484,75174,151,175658,SATURDAY,1,0,9.4,77,11.2,1019.4,Cloudy
4/29/2023 8:00,59,184,133264,135020,243,268284,SATURDAY,1,0,9.4,80,18.4,1019.3,Cloudy
4/29/2023 9:00,119,309,186380,229861,428,416241,SATURDAY,1,0,9.4,83,20.5,1019.5,Cloudy
4/29/2023 10:00,214,386,464843,302967,600,767810,SATURDAY,1,0,9.4,83,20.5,1019.5,Cloudy
4/29/2023 11:00,222,450,480608,379076,672,859684,SATURDAY,1,0,10,83,18.4,1020,Cloudy
4/29/2023 12:00,274,480,487783,384007,754,871790,SATURDAY,1,0,10,83,18.4,1020,Cloudy
4/29/2023 13:00,276,449,625141,368995,725,994136,SATURDAY,1,0,10.6,80,20.5,1019.7,Cloudy
4/29/2023 14:00,251,518,393754,616046,769,1009800,SATURDAY,1,0,10.6,80,20.5,1019.7,Cloudy
4/29/2023 15:00,237,491,807405,384161,728,1191566,SATURDAY,1,0,10,80,22.3,1019.8,Cloudy
4/29/2023 16:00,193,479,405748,658315,672,1064063,SATURDAY,1,0,10.6,77,25.9,1019.2,Cloudy
4/29/2023 17:00,185,483,265867,442550,668,708417,SATURDAY,1,0,11.1,77,25.9,1018.7,Cloudy
4/29/2023 18:00,147,360,314561,326077,507,640638,SATURDAY,1,0,10.6,77,25.9,1018.4,Cloudy
4/29/2023 19:00,149,323,162424,322903,472,485327,SATURDAY,1,0,10.6,77,25.9,1017.8,Cloudy
4/29/2023 20:00,103,308,415905,295431,411,711336,SATURDAY,1,0,10.6,77,31.7,1017.8,Cloudy
4/29/2023 21:00,17,112,13897,181900,129,195797,SATURDAY,1,0,9.4,86,29.5,1017.3,Rain
4/29/2023 22:00,29,74,26845,51847,103,78692,SATURDAY,1,0,9.4,86,29.5,1017.3,Rain
4/29/2023 23:00,27,72,32685,52714,99,85399,SATURDAY,1,0,9.4,86,27.7,1016.8,Rain
4/30/2023 0:00,22,45,54033,31123,67,85156,SUNDAY,1,0,9.4,86,25.9,1016.9,Rain
4/30/2023 1:00,28,31,63330,14912,59,78242,SUNDAY,1,0,9.4,86,27.7,1017,Rain
4/30/2023 2:00,20,22,187707,17612,42,205319,SUNDAY,1,0,9.4,93,25.9,1015.5,Rain
4/30/2023 3:00,2,5,45541,2462,7,48003,SUNDAY,1,0,9.4,93,25.9,1015.5,Rain
4/30/2023 4:00,0,5,0,3048,5,3048,SUNDAY,1,0,9.4,97,25.9,1014.4,Rain
4/30/2023 5:00,1,9,2511,8491,10,11002,SUNDAY,1,0,9.4,93,33.5,1013,Rain
4/30/2023 6:00,10,29,9740,25973,39,35713,SUNDAY,1,0,9.4,97,22.3,1011.9,Rain
4/30/2023 7:00,10,32,18074,25036,42,43110,SUNDAY,1,0,9.4,97,22.3,1011.9,Rain
4/30/2023 8:00,19,71,29182,60435,90,89617,SUNDAY,1,0,10,93,25.9,1011.3,Rain
4/30/2023 9:00,20,152,20250,113411,172,133661,SUNDAY,1,0,10,93,25.9,1011.3,Rain
4/30/2023 10:00,50,209,57242,158835,259,216077,SUNDAY,1,0,9.4,93,29.5,1011.2,Cloudy
4/30/2023 11:00,45,223,72756,160969,268,233725,SUNDAY,1,0,9.4,97,25.9,1010.3,Rain
4/30/2023 12:00,57,239,103651,199694,296,303345,SUNDAY,1,0,10,93,24.1,1010.1,Rain
4/30/2023 13:00,43,224,119164,175310,267,294474,SUNDAY,1,0,10,93,25.9,1009.5,Rain
4/30/2023 14:00,42,209,152396,157794,251,310190,SUNDAY,1,0,10,93,25.9,1009.5,Rain
4/30/2023 15:00,49,262,51813,179586,311,231399,SUNDAY,1,0,10,96,31.7,1007.9,Rain
4/30/2023 16:00,70,244,140407,209620,314,350027,SUNDAY,1,0,10,96,29.5,1007.1,Rain
4/30/2023 17:00,33,189,94853,161143,222,255996,SUNDAY,1,0,10,96,24.1,1006,Rain
4/30/2023 18:00,29,172,35227,114602,201,149829,SUNDAY,1,0,10,96,24.1,1006,Rain
4/30/2023 19:00,21,138,17127,105385,159,122512,SUNDAY,1,0,10.6,96,24.1,1004.6,Rain
4/30/2023 20:00,19,141,13679,104031,160,117710,SUNDAY,1,0,10,96,27.7,1002.5,Rain
4/30/2023 21:00,14,68,13577,35206,82,48783,SUNDAY,1,0,10,96,29.5,1002.5,Rain
4/30/2023 22:00,23,58,119150,68388,81,187538,SUNDAY,1,0,10.6,96,25.9,1001.7,Cloudy
4/30/2023 23:00,6,25,5703,12318,31,18021,SUNDAY,1,0,10.6,100,24.1,999.7,Cloudy
5/1/2023 0:00,1,17,659,11570,18,12229,MONDAY,0,0,11.7,96,22.3,997.8,Cloudy
5/1/2023 1:00,4,24,2200,13924,28,16124,MONDAY,0,0,11.7,96,33.5,996.2,Rain
5/1/2023 2:00,7,13,4466,7053,20,11519,MONDAY,0,0,12.2,97,37.1,994.5,Rain
5/1/2023 3:00,3,5,2120,2628,8,4748,MONDAY,0,0,11.7,96,40.7,992.4,Rain
5/1/2023 4:00,2,6,4045,4767,8,8812,MONDAY,0,0,12.2,97,40.7,990,Rain
5/1/2023 5:00,9,56,10350,38919,65,49269,MONDAY,0,0,12.2,97,46.4,987,Cloudy
5/1/2023 6:00,11,179,8148,124379,190,132527,MONDAY,0,0,12.8,96,37.1,986.3,Rain
5/1/2023 7:00,42,389,82509,320247,431,402756,MONDAY,0,0,12.2,97,25.9,984.6,Cloudy
5/1/2023 8:00,82,814,86093,693123,896,779216,MONDAY,0,0,12.2,97,25.9,984.6,Rain
5/1/2023 9:00,69,534,287725,418507,603,706232,MONDAY,0,0,14.4,97,22.3,984,Cloudy
5/1/2023 10:00,82,323,475923,229347,405,705270,MONDAY,0,0,14.4,93,20.5,983.9,Cloudy
5/1/2023 11:00,111,352,171401,304484,463,475885,MONDAY,0,0,14.4,93,20.5,984.7,Cloudy
5/1/2023 12:00,109,412,225730,642574,521,868304,MONDAY,0,0,15,87,25.9,985.7,Cloudy
5/1/2023 13:00,149,417,2061006,537712,566,2598718,MONDAY,0,0,14.4,81,25.9,988.2,Cloudy
5/1/2023 14:00,183,474,292404,369779,657,662183,MONDAY,0,0,14.4,81,44.6,988.2,Cloudy
5/1/2023 15:00,172,572,1415843,467076,744,1882919,MONDAY,0,0,15,58,20.5,992.1,Cloudy
5/1/2023 16:00,185,808,5661083,673884,993,6334967,MONDAY,0,0,16.7,48,20.5,992.8,Fair
5/1/2023 17:00,282,1208,1767655,1281498,1490,3049153,MONDAY,0,0,16.1,46,31.7,993.7,Cloudy
5/1/2023 18:00,249,957,425873,888038,1206,1313911,MONDAY,0,0,16.7,44,16.6,993.7,Cloudy
5/1/2023 19:00,188,808,1902689,681103,996,2583792,MONDAY,0,0,16.7,44,16.6,993.7,Fair
5/1/2023 20:00,119,476,160207,2789222,595,2949429,MONDAY,0,0,16.7,48,27.7,994.4,Fair
5/1/2023 21:00,77,317,95756,245453,394,341209,MONDAY,0,0,16.7,48,35.3,994.4,Fair
5/1/2023 22:00,146,284,453020,345262,430,798282,MONDAY,0,0,14.4,49,33.5,995.9,Cloudy
5/1/2023 23:00,42,134,110112,104516,176,214628,MONDAY,0,0,14.4,49,37.1,995.9,Fair
5/2/2023 0:00,29,68,68510,55718,97,124228,TUESDAY,0,0,13.3,57,24.1,996.7,Fair
5/2/2023 1:00,26,47,204409,42113,73,246522,TUESDAY,0,0,12.2,61,16.6,997.8,Fair
5/2/2023 2:00,8,13,6589,15795,21,22384,TUESDAY,0,0,10.6,77,13,998.7,Fair
5/2/2023 3:00,6,5,4990,3868,11,8858,TUESDAY,0,0,10,83,14.8,998.4,Fair
5/2/2023 4:00,4,10,4121,3650,14,7771,TUESDAY,0,0,10,83,14.8,998.4,Fair
5/2/2023 5:00,10,71,11450,57210,81,68660,TUESDAY,0,0,9.4,86,13,998,Fair
5/2/2023 6:00,23,228,17628,149691,251,167319,TUESDAY,0,0,8.9,86,11.2,997.3,Fair
5/2/2023 7:00,53,421,41047,287030,474,328077,TUESDAY,0,0,8.9,89,16.6,997.2,Fair
5/2/2023 8:00,59,751,55237,553186,810,608423,TUESDAY,0,0,8.9,89,14.8,997.1,Cloudy
5/2/2023 9:00,85,548,107050,459899,633,566949,TUESDAY,0,0,8.9,89,14.8,997.1,Cloudy
5/2/2023 10:00,70,364,81930,276253,434,358183,TUESDAY,0,0,10,89,18.4,996.8,Cloudy
5/2/2023 11:00,78,324,1340505,487288,402,1827793,TUESDAY,0,0,11.1,86,16.6,996.7,Cloudy
5/2/2023 12:00,43,264,77663,196411,307,274074,TUESDAY,0,0,11.1,86,16.6,996.7,Cloudy
5/2/2023 13:00,22,147,28693,108932,169,137625,TUESDAY,0,0,14.4,67,22.3,996.1,Rain
5/2/2023 14:00,27,221,23577,171105,248,194682,TUESDAY,0,0,14.4,67,24.1,996.1,Rain
5/2/2023 15:00,75,331,143481,336692,406,480173,TUESDAY,0,0,15.6,55,13,994.7,Rain
5/2/2023 16:00,70,561,69802,440927,631,510729,TUESDAY,0,0,11.7,80,22.3,995.6,Rain
5/2/2023 17:00,82,580,86453,444476,662,530929,TUESDAY,0,0,10,83,16.6,995,Rain
5/2/2023 18:00,119,796,1035643,693452,915,1729095,TUESDAY,0,0,10,83,16.6,995,Rain
5/2/2023 19:00,85,528,2929573,461607,613,3391180,TUESDAY,0,0,11.7,69,14.8,994.4,Rain
5/2/2023 20:00,57,356,1087068,328409,413,1415477,TUESDAY,0,0,11.7,66,16.6,994.1,Rain
5/2/2023 21:00,65,282,56119,263530,347,319649,TUESDAY,0,0,11.7,66,16.6,994.1,Rain
5/2/2023 22:00,71,223,130048,199982,294,330030,TUESDAY,0,0,10,83,18.4,995.5,Cloudy
5/2/2023 23:00,18,147,19617,113560,165,133177,TUESDAY,0,0,10,83,25.9,995.5,Cloudy
5/3/2023 0:00,17,68,97592,61779,85,159371,WEDNESDAY,0,0,10.6,68,18.4,996.7,Cloudy
5/3/2023 1:00,15,36,26302,20875,51,47177,WEDNESDAY,0,0,10.6,77,18.4,997.1,Cloudy
5/3/2023 2:00,5,17,4255,10652,22,14907,WEDNESDAY,0,0,10.6,77,18.4,997.1,Cloudy
5/3/2023 3:00,2,8,1399,5281,10,6680,WEDNESDAY,0,0,9.4,83,14.8,997.2,Cloudy
5/3/2023 4:00,0,13,0,16193,13,16193,WEDNESDAY,0,0,9.4,83,14.8,997.2,Cloudy
5/3/2023 5:00,10,66,6622,49535,76,56157,WEDNESDAY,0,0,8.9,83,9.4,996.7,Cloudy
5/3/2023 6:00,24,228,19761,162154,252,181915,WEDNESDAY,0,0,8.3,80,7.6,996.5,Cloudy
5/3/2023 7:00,69,585,102945,465979,654,568924,WEDNESDAY,0,0,7.8,79,7.6,996.7,Cloudy
5/3/2023 8:00,127,1088,711483,1035517,1215,1747000,WEDNESDAY,0,0,7.8,83,0,996.7,Cloudy
5/3/2023 9:00,89,626,152392,593464,715,745856,WEDNESDAY,0,0,7.8,83,0,996.7,Cloudy
5/3/2023 10:00,76,411,128733,291689,487,420422,WEDNESDAY,0,0,8.9,80,7.6,997.8,Cloudy
5/3/2023 11:00,54,322,79437,375145,376,454582,WEDNESDAY,0,0,9.4,80,7.6,998.1,Cloudy
5/3/2023 12:00,20,210,22490,149677,230,172167,WEDNESDAY,0,0,10.6,77,9.4,998.4,Cloudy
5/3/2023 13:00,59,349,336555,269475,408,606030,WEDNESDAY,0,0,10.6,77,11.2,999.2,Cloudy
5/3/2023 14:00,85,442,113721,339995,527,453716,WEDNESDAY,0,0,11.1,77,14.8,999.6,Cloudy
5/3/2023 15:00,96,568,539563,461272,664,1000835,WEDNESDAY,0,0,11.1,77,14.8,999.6,Cloudy
5/3/2023 16:00,156,727,219443,572981,883,792424,WEDNESDAY,0,0,10.6,74,16.6,1000,Cloudy
5/3/2023 17:00,248,1083,1087438,893618,1331,1981056,WEDNESDAY,0,0,10.6,71,0,999.8,Cloudy
5/3/2023 18:00,172,810,1630759,605861,982,2236620,WEDNESDAY,0,0,10.6,77,18.4,1000,Cloudy
5/3/2023 19:00,134,563,808272,469947,697,1278219,WEDNESDAY,0,0,11.7,83,22.3,1000,Cloudy
5/3/2023 20:00,76,322,90974,308087,398,399061,WEDNESDAY,0,0,11.1,83,24.1,1000,Cloudy
5/3/2023 21:00,49,241,86421,160022,290,246443,WEDNESDAY,0,0,10.6,86,25.9,1000.4,Cloudy
5/3/2023 22:00,65,167,158141,122340,232,280481,WEDNESDAY,0,0,10,89,20.5,1001.9,Cloudy
5/3/2023 23:00,26,104,49440,117795,130,167235,WEDNESDAY,0,0,10,89,25.9,1002.8,Cloudy
5/4/2023 0:00,16,49,15799,28111,65,43910,THURSDAY,0,0,10,89,25.9,1002.8,Cloudy
5/4/2023 1:00,25,24,39277,31093,49,70370,THURSDAY,0,0,10,89,27.7,1003.5,Cloudy
5/4/2023 2:00,5,11,5518,5635,16,11153,THURSDAY,0,0,9.4,90,25.9,1004.2,Cloudy
5/4/2023 3:00,3,4,3198,3438,7,6636,THURSDAY,0,0,8.9,86,31.7,1004.6,Cloudy
5/4/2023 4:00,4,10,7401,6435,14,13836,THURSDAY,0,0,8.3,83,29.5,1005.3,Cloudy
5/4/2023 5:00,8,57,5725,48823,65,54548,THURSDAY,0,0,8.3,83,25.9,1005.4,Cloudy
5/4/2023 6:00,12,190,10771,120034,202,130805,THURSDAY,0,0,8.3,83,24.1,1005.8,Cloudy
5/4/2023 7:00,59,408,49776,294274,467,344050,THURSDAY,0,0,6.7,89,25.9,1006.8,Cloudy
5/4/2023 8:00,92,809,934393,764318,901,1698711,THURSDAY,0,0,6.7,89,25.9,1006.8,Rain
5/4/2023 9:00,60,489,435683,308098,549,743781,THURSDAY,0,0,7.2,82,27.7,1007.3,Cloudy
5/4/2023 10:00,27,256,21494,176163,283,197657,THURSDAY,0,0,7.2,82,31.7,1008.3,Rain
5/4/2023 11:00,51,245,59859,187510,296,247369,THURSDAY,0,0,7.2,82,25.9,1009.2,Cloudy
5/4/2023 12:00,75,306,961964,797765,381,1759729,THURSDAY,0,0,7.8,83,20.5,1010.5,Cloudy
5/4/2023 13:00,66,277,67366,183439,343,250805,THURSDAY,0,0,7.8,83,20.5,1010.5,Cloudy
5/4/2023 14:00,85,356,1121681,229082,441,1350763,THURSDAY,0,0,7.2,90,22.3,1011.1,Cloudy
5/4/2023 15:00,104,432,146866,294185,536,441051,THURSDAY,0,0,7.8,83,24.1,1012.4,Rain
5/4/2023 16:00,156,638,559639,464669,794,1024308,THURSDAY,0,0,7.8,83,24.1,1012.4,Cloudy
5/4/2023 17:00,244,999,848086,767080,1243,1615166,THURSDAY,0,0,7.2,86,16.6,1013.4,Cloudy
5/4/2023 18:00,194,742,1934364,660489,936,2594853,THURSDAY,0,0,7.2,86,16.6,1013.4,Cloudy
5/4/2023 19:00,117,553,257545,388242,670,645787,THURSDAY,0,0,7.8,76,20.5,1013.7,Cloudy
5/4/2023 20:00,86,338,157063,251721,424,408784,THURSDAY,0,0,8.9,71,20.5,1014.5,Cloudy
5/4/2023 21:00,74,317,683978,212160,391,896138,THURSDAY,0,0,8.9,71,20.5,1014.5,Cloudy
5/4/2023 22:00,74,185,171410,145455,259,316865,THURSDAY,0,0,9.4,66,13,1014.9,Cloudy
5/4/2023 23:00,76,148,959781,101066,224,1060847,THURSDAY,0,0,9.4,66,13,1015.5,Cloudy
5/5/2023 0:00,50,65,204195,42442,115,246637,FRIDAY,0,0,10,61,7.6,1015.9,Cloudy
5/5/2023 1:00,43,38,42451,23287,81,65738,FRIDAY,0,0,10,61,14.8,1016.4,Cloudy
5/5/2023 2:00,24,20,63039,9024,44,72063,FRIDAY,0,0,10,63,14.8,1017.4,Rain
5/5/2023 3:00,15,13,31724,9373,28,41097,FRIDAY,0,0,9.4,71,14.8,1017.8,Cloudy
5/5/2023 4:00,8,14,6235,13573,22,19808,FRIDAY,0,0,9.4,71,14.8,1017.8,Cloudy
5/5/2023 5:00,11,34,20796,24334,45,45130,FRIDAY,0,0,8.3,90,14.8,1018.5,Cloudy
5/5/2023 6:00,14,138,9143,90371,152,99514,FRIDAY,0,0,8.3,90,14.8,1018.5,Rain
5/5/2023 7:00,39,291,45185,219578,330,264763,FRIDAY,0,0,8.3,90,11.2,1019.2,Rain
5/5/2023 8:00,83,601,69982,423308,684,493290,FRIDAY,0,0,8.3,90,11.2,1019.2,Cloudy
5/5/2023 9:00,62,454,90582,318145,516,408727,FRIDAY,0,0,8.3,90,11.2,1020.4,Cloudy
5/5/2023 10:00,61,302,371388,233916,363,605304,FRIDAY,0,0,8.3,90,11.2,1020.4,Cloudy
5/5/2023 11:00,68,335,88069,270517,403,358586,FRIDAY,0,0,8.3,93,18.4,1021.1,Cloudy
5/5/2023 12:00,145,428,1891054,291159,573,2182213,FRIDAY,0,0,8.9,86,18.4,1021.7,Cloudy
5/5/2023 13:00,141,432,283857,291171,573,575028,FRIDAY,0,0,8.9,86,24.1,1022.9,Cloudy
5/5/2023 14:00,185,422,1130319,319914,607,1450233,FRIDAY,0,0,8.9,86,24.1,1022.9,Cloudy
5/5/2023 15:00,233,532,1298401,409579,765,1707980,FRIDAY,0,0,10.6,74,11.2,1023.5,Cloudy
5/5/2023 16:00,266,794,2467035,623741,1060,3090776,FRIDAY,0,0,10.6,74,11.2,1023.5,Cloudy
5/5/2023 17:00,310,874,1240566,746635,1184,1987201,FRIDAY,0,0,10,77,16.6,1023.6,Cloudy
5/5/2023 18:00,350,730,1394251,613932,1080,2008183,FRIDAY,0,0,11.1,74,14.8,1022.7,Cloudy
5/5/2023 19:00,250,580,1155492,2728811,830,3884303,FRIDAY,0,0,11.1,69,18.4,1022.3,Cloudy
5/5/2023 20:00,145,379,205145,324271,524,529416,FRIDAY,0,0,11.1,66,20.5,1022.1,Cloudy
5/5/2023 21:00,103,260,702916,201788,363,904704,FRIDAY,0,0,10.6,63,16.6,1021.9,Cloudy
5/5/2023 22:00,130,226,552098,150960,356,703058,FRIDAY,0,0,10.6,63,16.6,1021.9,Cloudy
5/5/2023 23:00,154,178,1009533,140610,332,1150143,FRIDAY,0,0,10.6,66,0,1021.6,Cloudy
5/6/2023 0:00,98,146,2631549,106356,244,2737905,SATURDAY,1,0,11.1,69,7.6,1022,Cloudy
5/6/2023 1:00,128,89,425796,101035,217,526831,SATURDAY,1,0,11.7,69,11.2,1021.9,Cloudy
5/6/2023 2:00,80,66,326215,53428,146,379643,SATURDAY,1,0,11.7,69,11.2,1021.9,Fair
5/6/2023 3:00,18,29,21591,19800,47,41391,SATURDAY,1,0,11.7,69,13,1021.5,Fair
5/6/2023 4:00,8,11,10668,6964,19,17632,SATURDAY,1,0,11.7,66,16.6,1021.4,Fair
5/6/2023 5:00,10,17,17214,16294,27,33508,SATURDAY,1,0,11.1,69,18.4,1021.2,Fair
5/6/2023 6:00,10,60,9768,51632,70,61400,SATURDAY,1,0,11.1,66,16.6,1021.2,Fair
5/6/2023 7:00,29,91,63062,71816,120,134878,SATURDAY,1,0,10.6,68,16.6,1021.3,Fair
5/6/2023 8:00,75,204,2684667,177623,279,2862290,SATURDAY,1,0,10.6,68,16.6,1021.3,Fair
5/6/2023 9:00,132,322,238582,280504,454,519086,SATURDAY,1,0,11.1,63,18.4,1021.5,Fair
5/6/2023 10:00,258,436,784098,346296,694,1130394,SATURDAY,1,0,12.2,59,20.5,1021.8,Fair
5/6/2023 11:00,407,552,1429725,532774,959,1962499,SATURDAY,1,0,12.2,59,20.5,1021.8,Fair
5/6/2023 12:00,515,626,2627106,587984,1141,3215090,SATURDAY,1,0,16.7,44,20.5,1021.4,Fair
5/6/2023 13:00,572,602,1642668,703304,1174,2345972,SATURDAY,1,0,16.7,44,24.1,1021.4,Fair
5/6/2023 14:00,606,610,2183143,588713,1216,2771856,SATURDAY,1,0,20.6,33,16.6,1020.5,Fair
5/6/2023 15:00,688,607,2644541,1073154,1295,3717695,SATURDAY,1,0,21.7,31,18.4,1019.8,Fair
5/6/2023 16:00,604,629,3595879,644364,1233,4240243,SATURDAY,1,0,22.2,28,16.6,1019,Fair
5/6/2023 17:00,571,633,3992353,585171,1204,4577524,SATURDAY,1,0,22.2,28,16.6,1019,Fair
5/6/2023 18:00,586,634,4062434,624485,1220,4686919,SATURDAY,1,0,23.9,25,16.6,1017.8,Fair
5/6/2023 19:00,454,545,2731886,671135,999,3403021,SATURDAY,1,0,24.4,25,16.6,1017.2,Fair
5/6/2023 20:00,268,349,3451317,393216,617,3844533,SATURDAY,1,0,23.9,26,20.5,1016.7,Cloudy
5/6/2023 21:00,237,271,913440,217322,508,1130762,SATURDAY,1,0,23.3,25,18.4,1016.5,Fair
5/6/2023 22:00,160,242,360858,228228,402,589086,SATURDAY,1,0,23.3,25,18.4,1016.5,Fair
5/6/2023 23:00,153,184,246623,221465,337,468088,SATURDAY,1,0,21.7,27,18.4,1016.8,Fair
5/7/2023 0:00,121,126,892776,91393,247,984169,SUNDAY,1,0,21.7,27,18.4,1016.8,Fair
5/7/2023 1:00,139,105,315919,88284,244,404203,SUNDAY,1,0,19.4,32,14.8,1017.4,Fair
5/7/2023 2:00,93,63,770917,90707,156,861624,SUNDAY,1,0,18.3,36,18.4,1017.4,Fair
5/7/2023 3:00,24,25,1440722,19341,49,1460063,SUNDAY,1,0,18.3,36,18.4,1017.4,Fair
5/7/2023 4:00,26,19,88389,9218,45,97607,SUNDAY,1,0,17.2,37,16.6,1016.9,Fair
5/7/2023 5:00,5,23,3777,18462,28,22239,SUNDAY,1,0,16.1,39,16.6,1016.4,Fair
5/7/2023 6:00,19,50,32207,38099,69,70306,SUNDAY,1,0,15.6,42,18.4,1016.2,Fair
5/7/2023 7:00,43,117,82335,89859,160,172194,SUNDAY,1,0,15,44,18.4,1015.9,Clear
5/7/2023 8:00,82,151,122648,128441,233,251089,SUNDAY,1,0,15,44,18.4,1015.9,Clear
5/7/2023 9:00,191,292,431924,253650,483,685574,SUNDAY,1,0,14.4,46,18.4,1015.5,Fair
5/7/2023 10:00,347,435,1815717,423518,782,2239235,SUNDAY,1,0,15,44,22.3,1015.6,Fair
5/7/2023 11:00,511,545,3807219,949645,1056,4756864,SUNDAY,1,0,17.2,40,20.5,1015.2,Fair
5/7/2023 12:00,659,554,4014229,576257,1213,4590486,SUNDAY,1,0,18.9,36,20.5,1014.8,Fair
5/7/2023 13:00,733,625,3073624,703904,1358,3777528,SUNDAY,1,0,18.9,36,22.3,1014.8,Fair
5/7/2023 14:00,812,594,3706093,609590,1406,4315683,SUNDAY,1,0,23.3,28,13,1013.4,Fair
5/7/2023 15:00,852,607,4589100,2210100,1459,6799200,SUNDAY,1,0,23.9,24,13,1013,Fair
5/7/2023 16:00,720,618,4258636,1576261,1338,5834897,SUNDAY,1,0,23.9,24,20.5,1012.3,Fair
5/7/2023 17:00,597,614,2766004,692018,1211,3458022,SUNDAY,1,0,23.9,24,20.5,1012.3,Fair
5/7/2023 18:00,718,629,8272942,601623,1347,8874565,SUNDAY,1,0,25.6,22,16.6,1010,Cloudy
5/7/2023 19:00,525,505,2746362,440237,1030,3186599,SUNDAY,1,0,25.6,22,16.6,1010,Cloudy
5/7/2023 20:00,266,325,491123,314234,591,805357,SUNDAY,1,0,26.1,21,13,1008,Cloudy
5/7/2023 21:00,170,237,2049614,178206,407,2227820,SUNDAY,1,0,25,24,13,1007.5,Cloudy
5/7/2023 22:00,140,141,400656,103324,281,503980,SUNDAY,1,0,25,24,24.1,1007.5,Cloudy
5/7/2023 23:00,83,89,256313,99916,172,356229,SUNDAY,1,0,23.9,23,13,1006.8,Cloudy
5/8/2023 0:00,12,39,29674,24409,51,54083,MONDAY,0,0,22.8,27,20.5,1006.9,Cloudy
5/8/2023 1:00,15,30,817859,18972,45,836831,MONDAY,0,0,21.1,32,16.6,1006.8,Cloudy
5/8/2023 2:00,11,16,11165,9126,27,20291,MONDAY,0,0,20.6,35,20.5,1007.2,Cloudy
5/8/2023 3:00,2,11,1570,5888,13,7458,MONDAY,0,0,20.6,35,20.5,1007.2,Cloudy
5/8/2023 4:00,4,13,25487,8930,17,34417,MONDAY,0,0,17.8,56,11.2,1007.3,Cloudy
5/8/2023 5:00,9,80,7516,57387,89,64903,MONDAY,0,0,17.2,60,5.4,1006.4,Cloudy
5/8/2023 6:00,28,214,258232,145515,242,403747,MONDAY,0,0,15.6,75,13,1006.3,Cloudy
5/8/2023 7:00,79,504,81896,408340,583,490236,MONDAY,0,0,15.6,75,13,1006.3,Cloudy
5/8/2023 8:00,130,896,423115,1577600,1026,2000715,MONDAY,0,0,15.6,72,9.4,1005.1,Cloudy
5/8/2023 9:00,111,505,241958,382236,616,624194,MONDAY,0,0,16.1,65,13,1005,Cloudy
5/8/2023 10:00,104,311,195500,255199,415,450699,MONDAY,0,0,16.7,65,16.6,1005.6,Rain
5/8/2023 11:00,140,346,301107,264143,486,565250,MONDAY,0,0,17.8,52,16.6,1006.1,Cloudy
5/8/2023 12:00,165,365,405781,303658,530,709439,MONDAY,0,0,17.8,52,24.1,1006.1,Fair
5/8/2023 13:00,180,394,1584754,318407,574,1903161,MONDAY,0,0,20.6,41,20.5,1006.1,Fair
5/8/2023 14:00,209,455,2016973,351757,664,2368730,MONDAY,0,0,21.7,32,18.4,1005.2,Fair
5/8/2023 15:00,226,492,574351,399757,718,974108,MONDAY,0,0,22.2,29,18.4,1005,Fair
5/8/2023 16:00,313,781,663394,640966,1094,1304360,MONDAY,0,0,22.8,28,25.9,1004.8,Fair
5/8/2023 17:00,427,1158,1337645,935736,1585,2273381,MONDAY,0,0,22.8,28,25.9,1004.8,Fair
5/8/2023 18:00,376,883,1025186,756148,1259,1781334,MONDAY,0,0,23.9,26,14.8,1004.5,Fair
5/8/2023 19:00,266,686,2150426,526161,952,2676587,MONDAY,0,0,23.3,24,14.8,1004.9,Fair
5/8/2023 20:00,143,430,258619,993631,573,1252250,MONDAY,0,0,22.8,18,29.5,1005.5,Fair
5/8/2023 21:00,87,293,110401,217775,380,328176,MONDAY,0,0,22.2,17,29.5,1006.1,Fair
5/8/2023 22:00,72,201,90624,145624,273,236248,MONDAY,0,0,22.2,17,29.5,1006.1,Fair
5/8/2023 23:00,42,83,41246,48310,125,89556,MONDAY,0,0,18.9,16,20.5,1008.2,Fair
5/9/2023 0:00,24,40,29625,22519,64,52144,TUESDAY,0,0,17.8,18,18.4,1009.3,Fair
5/9/2023 1:00,13,26,15635,14541,39,30176,TUESDAY,0,0,16.1,23,9.4,1010.7,Fair
5/9/2023 2:00,6,19,8395,9892,25,18287,TUESDAY,0,0,12.8,23,9.4,1011.6,Fair
5/9/2023 3:00,3,8,9202,6194,11,15396,TUESDAY,0,0,12.8,62,18.4,1011.6,Fair
5/9/2023 4:00,1,18,832,17245,19,18077,TUESDAY,0,0,11.7,64,16.6,1012.2,Fair
5/9/2023 5:00,15,63,14240,46309,78,60549,TUESDAY,0,0,11.7,59,0,1012.3,Fair
5/9/2023 6:00,37,268,37423,182756,305,220179,TUESDAY,0,0,11.1,69,0,1012.6,Fair
5/9/2023 7:00,96,604,1037365,470302,700,1507667,TUESDAY,0,0,11.1,69,0,1012.6,Clear
5/9/2023 8:00,140,1062,142127,1323272,1202,1465399,TUESDAY,0,0,11.7,66,7.6,1013.2,Fair
5/9/2023 9:00,105,620,166747,1121089,725,1287836,TUESDAY,0,0,10.6,39,13,1013.6,Fair
5/9/2023 10:00,85,350,142416,289319,435,431735,TUESDAY,0,0,10.6,41,11.2,1014.4,Clear
5/9/2023 11:00,112,360,201225,1643054,472,1844279,TUESDAY,0,0,11.7,47,13,1014.6,Fair
5/9/2023 12:00,152,413,323596,305541,565,629137,TUESDAY,0,0,11.7,47,13,1014.6,Fair
5/9/2023 13:00,145,374,244768,270478,519,515246,TUESDAY,0,0,12.8,49,14.8,1015.8,Fair
5/9/2023 14:00,156,462,1100895,342548,618,1443443,TUESDAY,0,0,13.3,49,20.5,1016.1,Cloudy
5/9/2023 15:00,184,518,378841,1063826,702,1442667,TUESDAY,0,0,12.8,52,24.1,1016.4,Cloudy
5/9/2023 16:00,249,784,615682,692602,1033,1308284,TUESDAY,0,0,12.8,52,24.1,1016.4,Cloudy
5/9/2023 17:00,369,1234,2083142,1243178,1603,3326320,TUESDAY,0,0,13.3,51,24.1,1016.4,Cloudy
5/9/2023 18:00,374,976,1676871,2328489,1350,4005360,TUESDAY,0,0,12.8,59,29.5,1016.3,Cloudy
5/9/2023 19:00,218,667,364035,1165014,885,1529049,TUESDAY,0,0,12.8,57,31.7,1015.8,Cloudy
5/9/2023 20:00,141,454,211225,331506,595,542731,TUESDAY,0,0,12.8,55,31.7,1015.4,Cloudy
5/9/2023 21:00,98,298,116119,318163,396,434282,TUESDAY,0,0,12.8,59,31.7,1015.5,Fair
5/9/2023 22:00,113,232,169298,173885,345,343183,TUESDAY,0,0,12.8,59,27.7,1015.5,Fair
5/9/2023 23:00,37,90,48370,57369,127,105739,TUESDAY,0,0,12.2,61,24.1,1015.8,Fair
5/10/2023 0:00,25,61,736264,39284,86,775548,WEDNESDAY,0,0,11.1,63,9.4,1017.4,Fair
5/10/2023 1:00,10,30,8371,22108,40,30479,WEDNESDAY,0,0,11.7,54,16.6,1018,Fair
5/10/2023 2:00,6,10,1941,5821,16,7762,WEDNESDAY,0,0,11.7,54,16.6,1018,Fair
5/10/2023 3:00,8,7,25262,2803,15,28065,WEDNESDAY,0,0,10.6,66,14.8,1018.9,Clear
5/10/2023 4:00,3,12,4499,9581,15,14080,WEDNESDAY,0,0,10.6,63,22.3,1019.1,Clear
5/10/2023 5:00,16,55,30784,37764,71,68548,WEDNESDAY,0,0,10.6,63,14.8,1019.2,Clear
5/10/2023 6:00,20,272,21064,180669,292,201733,WEDNESDAY,0,0,10.6,63,14.8,1019.2,Clear
5/10/2023 7:00,96,612,104083,446351,708,550434,WEDNESDAY,0,0,10,61,14.8,1019.2,Clear
5/10/2023 8:00,167,1126,157795,1118558,1293,1276353,WEDNESDAY,0,0,8.9,51,11.2,1019.3,Clear
5/10/2023 9:00,110,649,104639,661536,759,766175,WEDNESDAY,0,0,9.4,54,13,1019.6,Clear
5/10/2023 10:00,117,353,623805,313442,470,937247,WEDNESDAY,0,0,11.1,44,16.6,1020.3,Clear
5/10/2023 11:00,138,406,409150,278001,544,687151,WEDNESDAY,0,0,12.8,40,14.8,1020.5,Clear
5/10/2023 12:00,159,364,941935,392693,523,1334628,WEDNESDAY,0,0,12.8,40,14.8,1020.5,Fair
5/10/2023 13:00,163,419,1072914,319039,582,1391953,WEDNESDAY,0,0,16.7,28,13,1020.4,Fair
5/10/2023 14:00,182,468,1098476,460906,650,1559382,WEDNESDAY,0,0,18.9,23,16.6,1019.6,Fair
5/10/2023 15:00,202,514,798146,476735,716,1274881,WEDNESDAY,0,0,20,21,18.4,1018.9,Fair
5/10/2023 16:00,322,830,1257437,837268,1152,2094705,WEDNESDAY,0,0,20,21,18.4,1018.9,Fair
5/10/2023 17:00,455,1295,4018991,3416241,1750,7435232,WEDNESDAY,0,0,21.7,20,20.5,1016.7,Fair
5/10/2023 18:00,447,1025,2424580,1102970,1472,3527550,WEDNESDAY,0,0,21.7,19,14.8,1016,Fair
5/10/2023 19:00,307,676,3724204,1240980,983,4965184,WEDNESDAY,0,0,22.8,20,18.4,1015.3,Fair
5/10/2023 20:00,187,494,534581,446781,681,981362,WEDNESDAY,0,0,22.8,20,22.3,1014.8,Fair
5/10/2023 21:00,127,326,184472,249799,453,434271,WEDNESDAY,0,0,22.8,20,22.3,1014.8,Fair
5/10/2023 22:00,121,238,413427,182041,359,595468,WEDNESDAY,0,0,22.2,22,22.3,1014.6,Fair
5/10/2023 23:00,61,139,96528,134570,200,231098,WEDNESDAY,0,0,21.7,23,14.8,1015.2,Fair
5/11/2023 0:00,48,47,172046,33575,95,205621,THURSDAY,0,0,20.6,25,18.4,1015.7,Fair
5/11/2023 1:00,25,20,34419,14895,45,49314,THURSDAY,0,0,19.4,28,16.6,1016.3,Fair
5/11/2023 2:00,5,24,31640,17741,29,49381,THURSDAY,0,0,19.4,28,16.6,1016.3,Fair
5/11/2023 3:00,6,7,3836,3423,13,7259,THURSDAY,0,0,18.3,33,22.3,1016.6,Clear
5/11/2023 4:00,8,21,225231,12056,29,237287,THURSDAY,0,0,17.8,34,20.5,1016.5,Fair
5/11/2023 5:00,12,72,9166,46658,84,55824,THURSDAY,0,0,16.7,38,20.5,1016.3,Clear
5/11/2023 6:00,42,236,41078,192786,278,233864,THURSDAY,0,0,16.1,39,22.3,1016.3,Clear
5/11/2023 7:00,111,592,98230,432160,703,530390,THURSDAY,0,0,15.6,41,22.3,1016.6,Clear
5/11/2023 8:00,159,1038,228885,825754,1197,1054639,THURSDAY,0,0,15.6,41,24.1,1016.6,Clear
5/11/2023 9:00,118,556,160812,443004,674,603816,THURSDAY,0,0,14.4,44,16.6,1016.8,Clear
5/11/2023 10:00,102,354,230963,275721,456,506684,THURSDAY,0,0,16.1,41,14.8,1017,Clear
5/11/2023 11:00,145,426,3255360,331989,571,3587349,THURSDAY,0,0,16.1,41,14.8,1017,Fair
5/11/2023 12:00,174,489,1242022,366744,663,1608766,THURSDAY,0,0,18.9,38,13,1017.6,Fair
5/11/2023 13:00,186,421,1742081,312319,607,2054400,THURSDAY,0,0,21.7,34,13,1017.4,Fair
5/11/2023 14:00,239,478,456261,357814,717,814075,THURSDAY,0,0,23.3,31,14.8,1017.1,Fair
5/11/2023 15:00,285,534,2662767,1009245,819,3672012,THURSDAY,0,0,25.6,27,14.8,1016.2,Fair
5/11/2023 16:00,282,788,1737834,631023,1070,2368857,THURSDAY,0,0,25.6,27,14.8,1016.2,Fair
5/11/2023 17:00,421,1072,1361622,1519171,1493,2880793,THURSDAY,0,0,27.2,22,13,1014.6,Fair
5/11/2023 18:00,448,926,1305882,1487102,1374,2792984,THURSDAY,0,0,27.2,22,20.5,1014.1,Fair
5/11/2023 19:00,400,694,2412959,1917204,1094,4330163,THURSDAY,0,0,27.2,22,20.5,1014.1,Fair
5/11/2023 20:00,251,464,1255811,452789,715,1708600,THURSDAY,0,0,22.2,21,7.6,1014.7,Fair
5/11/2023 21:00,126,345,915539,528029,471,1443568,THURSDAY,0,0,22.2,46,7.6,1014.7,Fair
5/11/2023 22:00,175,290,342455,972745,465,1315200,THURSDAY,0,0,19.4,47,14.8,1015.2,Fair
5/11/2023 23:00,104,151,786323,129821,255,916144,THURSDAY,0,0,18.3,54,13,1015.5,Fair
5/12/2023 0:00,81,88,140816,129747,169,270563,FRIDAY,0,0,18.9,52,9.4,1015.9,Fair
5/12/2023 1:00,64,44,732105,31006,108,763111,FRIDAY,0,0,18.3,52,9.4,1016.2,Fair
5/12/2023 2:00,24,19,38162,17437,43,55599,FRIDAY,0,0,18.3,52,9.4,1016.2,Fair
5/12/2023 3:00,7,13,14361,10224,20,24585,FRIDAY,0,0,18.9,47,7.6,1016.2,Fair
5/12/2023 4:00,9,12,14400,7194,21,21594,FRIDAY,0,0,16.7,56,5.4,1016,Fair
5/12/2023 5:00,23,56,72374,39607,79,111981,FRIDAY,0,0,16.7,58,0,1015.8,Fair
5/12/2023 6:00,37,202,35721,150996,239,186717,FRIDAY,0,0,16.7,58,0,1015.8,Fair
5/12/2023 7:00,76,470,80503,1142411,546,1222914,FRIDAY,0,0,17.8,50,11.2,1015.8,Fair
5/12/2023 8:00,103,677,147859,534745,780,682604,FRIDAY,0,0,15,64,5.4,1015.6,Fair
5/12/2023 9:00,113,546,177999,442362,659,620361,FRIDAY,0,0,15.6,62,5.4,1015.7,Fair
5/12/2023 10:00,178,365,1806704,431486,543,2238190,FRIDAY,0,0,15.6,62,5.4,1015.7,Fair
5/12/2023 11:00,215,384,1117839,333835,599,1451674,FRIDAY,0,0,18.9,50,9.4,1016,Cloudy
5/12/2023 12:00,214,489,363391,371810,703,735201,FRIDAY,0,0,19.4,52,24.1,1016.6,Cloudy
5/12/2023 13:00,263,479,432669,364034,742,796703,FRIDAY,0,0,21.7,44,14.8,1016,Cloudy
5/12/2023 14:00,364,502,665192,411611,866,1076803,FRIDAY,0,0,25,37,24.1,1015.5,Cloudy
5/12/2023 15:00,333,614,2524203,511077,947,3035280,FRIDAY,0,0,26.1,35,18.4,1015.2,Cloudy
5/12/2023 16:00,409,868,733511,735660,1277,1469171,FRIDAY,0,0,26.1,35,18.4,1015.2,Fair
5/12/2023 17:00,595,977,2316359,2309867,1572,4626226,FRIDAY,0,0,28.3,31,18.4,1014.2,Fair
5/12/2023 18:00,509,767,5662460,708920,1276,6371380,FRIDAY,0,0,28.9,29,18.4,1013.5,Fair
5/12/2023 19:00,427,635,2299769,589877,1062,2889646,FRIDAY,0,0,28.9,28,22.3,1013.2,Fair
5/12/2023 20:00,281,426,6112086,375439,707,6487525,FRIDAY,0,0,29.4,25,22.3,1013.2,Cloudy
5/12/2023 21:00,267,316,3159736,259327,583,3419063,FRIDAY,0,0,29.4,25,27.7,1013.2,Cloudy
5/12/2023 22:00,354,271,2847358,287810,625,3135168,FRIDAY,0,0,27.8,26,14.8,1012.8,Cloudy
5/12/2023 23:00,194,214,1746155,156672,408,1902827,FRIDAY,0,0,27.8,26,9.4,1013.2,Cloudy
5/13/2023 0:00,152,135,384406,110521,287,494927,SATURDAY,1,0,22.8,40,5.4,1013.5,Cloudy
5/13/2023 1:00,129,86,298761,64692,215,363453,SATURDAY,1,0,21.1,47,0,1013.9,Cloudy
5/13/2023 2:00,56,59,140470,55851,115,196321,SATURDAY,1,0,20.6,51,0,1013.6,Cloudy
5/13/2023 3:00,21,25,87894,25268,46,113162,SATURDAY,1,0,20.6,51,0,1013.6,Cloudy
5/13/2023 4:00,20,16,944617,14282,36,958899,SATURDAY,1,0,21.7,47,14.8,1013.3,Cloudy
5/13/2023 5:00,16,28,11495,21455,44,32950,SATURDAY,1,0,21.1,49,14.8,1013.1,Cloudy
5/13/2023 6:00,28,78,81905,70378,106,152283,SATURDAY,1,0,21.1,49,14.8,1013.1,Cloudy
5/13/2023 7:00,59,142,94156,119997,201,214153,SATURDAY,1,0,20,53,7.6,1013,Cloudy
5/13/2023 8:00,119,243,235317,270846,362,506163,SATURDAY,1,0,19.4,52,9.4,1013.4,Cloudy
5/13/2023 9:00,211,367,316632,308514,578,625146,SATURDAY,1,0,19.4,52,13,1013.9,Cloudy
5/13/2023 10:00,371,487,782964,439640,858,1222604,SATURDAY,1,0,20.6,47,16.6,1014.5,Cloudy
5/13/2023 11:00,444,545,1492736,866497,989,2359233,SATURDAY,1,0,20.6,47,16.6,1014.5,Cloudy
5/13/2023 12:00,563,572,3555166,811700,1135,4366866,SATURDAY,1,0,22.2,48,22.3,1015.3,Cloudy
5/13/2023 13:00,600,580,2521556,725166,1180,3246722,SATURDAY,1,0,22.8,43,22.3,1015.4,Cloudy
5/13/2023 14:00,632,610,3025688,1033469,1242,4059157,SATURDAY,1,0,23.3,40,18.4,1015.5,Cloudy
5/13/2023 15:00,629,502,5413914,1535693,1131,6949607,SATURDAY,1,0,23.9,40,14.8,1014.9,Fair
5/13/2023 16:00,553,550,5239759,906455,1103,6146214,SATURDAY,1,0,23.9,40,14.8,1014.9,Fair
5/13/2023 17:00,519,559,2525075,694242,1078,3219317,SATURDAY,1,0,26.1,22,13,1013.4,Fair
5/13/2023 18:00,666,570,2592290,579364,1236,3171654,SATURDAY,1,0,27.2,14,27.7,1013,Fair
5/13/2023 19:00,564,517,4647388,646045,1081,5293433,SATURDAY,1,0,26.7,13,29.5,1012.8,Fair
5/13/2023 20:00,348,402,1901830,329453,750,2231283,SATURDAY,1,0,25.6,15,33.5,1013.3,Fair
5/13/2023 21:00,288,309,1417084,319396,597,1736480,SATURDAY,1,0,25.6,15,33.5,1013.3,Fair
5/13/2023 22:00,193,208,1111860,895562,401,2007422,SATURDAY,1,0,24.4,18,24.1,1014.2,Fair
5/13/2023 23:00,158,153,1233293,120355,311,1353648,SATURDAY,1,0,23.3,18,24.1,1015.2,Fair
5/14/2023 0:00,109,110,1272298,149953,219,1422251,SUNDAY,1,0,22.2,21,20.5,1015.8,Fair
5/14/2023 1:00,113,81,868226,62355,194,930581,SUNDAY,1,0,22.2,21,20.5,1015.8,Fair
5/14/2023 2:00,86,45,254836,33856,131,288692,SUNDAY,1,0,20.6,25,18.4,1017,Fair
5/14/2023 3:00,9,14,148027,6794,23,154821,SUNDAY,1,0,17.8,31,16.6,1019.2,Fair
5/14/2023 4:00,10,9,39424,10560,19,49984,SUNDAY,1,0,15,53,22.3,1020.3,Clear
5/14/2023 5:00,13,18,34416,11657,31,46073,SUNDAY,1,0,13.3,62,22.3,1020.8,Clear
5/14/2023 6:00,22,45,35983,32199,67,68182,SUNDAY,1,0,13.3,62,22.3,1020.8,Clear
5/14/2023 7:00,30,85,72057,59527,115,131584,SUNDAY,1,0,11.1,69,16.6,1021.4,Clear
5/14/2023 8:00,84,170,173736,150902,254,324638,SUNDAY,1,0,10.6,71,11.2,1021.6,Clear
5/14/2023 9:00,175,324,421505,310852,499,732357,SUNDAY,1,0,11.1,69,5.4,1021.7,Clear
5/14/2023 10:00,308,383,846065,356698,691,1202763,SUNDAY,1,0,12.2,69,14.8,1022.1,Clear
5/14/2023 11:00,417,438,3889271,414607,855,4303878,SUNDAY,1,0,12.2,47,14.8,1022.1,Fair
5/14/2023 12:00,511,464,1896075,457914,975,2353989,SUNDAY,1,0,13.3,37,24.1,1022.1,Fair
5/14/2023 13:00,561,520,3733822,531253,1081,4265075,SUNDAY,1,0,13.9,37,14.8,1022.2,Fair
5/14/2023 14:00,592,569,1400957,631671,1161,2032628,SUNDAY,1,0,14.4,36,18.4,1021.7,Fair
5/14/2023 15:00,586,543,8924257,532649,1129,9456906,SUNDAY,1,0,15.6,32,18.4,1021.1,Fair
5/14/2023 16:00,517,498,1097133,490220,1015,1587353,SUNDAY,1,0,15.6,32,18.4,1021.1,Cloudy
5/14/2023 17:00,504,521,4822961,2076385,1025,6899346,SUNDAY,1,0,16.7,30,16.6,1020.1,Cloudy
5/14/2023 18:00,641,588,5499972,540229,1229,6040201,SUNDAY,1,0,18.9,27,22.3,1019.7,Cloudy
5/14/2023 19:00,390,436,2445402,608258,826,3053660,SUNDAY,1,0,18.9,26,22.3,1019.2,Cloudy
5/14/2023 20:00,251,300,1184373,219013,551,1403386,SUNDAY,1,0,18.9,26,22.3,1019.2,Cloudy
5/14/2023 21:00,153,221,290940,178105,374,469045,SUNDAY,1,0,19.4,22,20.5,1019.7,Cloudy
5/14/2023 22:00,125,175,209495,126064,300,335559,SUNDAY,1,0,18.3,25,20.5,1020.3,Cloudy
5/14/2023 23:00,44,80,82692,51527,124,134219,SUNDAY,1,0,17.2,27,27.7,1021.1,Fair
5/15/2023 0:00,30,44,67887,32466,74,100353,MONDAY,0,0,16.7,27,20.5,1022,Fair
5/15/2023 1:00,7,28,7890,14528,35,22418,MONDAY,0,0,15.6,29,16.6,1022.7,Fair
5/15/2023 2:00,8,9,9605,6076,17,15681,MONDAY,0,0,15.6,29,16.6,1022.7,Fair
5/15/2023 3:00,4,6,3319,1856,10,5175,MONDAY,0,0,13.9,34,16.6,1022.9,Clear
5/15/2023 4:00,3,15,13882,24689,18,38571,MONDAY,0,0,12.8,38,18.4,1022.7,Clear
5/15/2023 5:00,15,58,28220,42122,73,70342,MONDAY,0,0,12.2,40,18.4,1022.3,Clear
5/15/2023 6:00,36,206,49743,181644,242,231387,MONDAY,0,0,12.2,40,20.5,1022.3,Clear
5/15/2023 7:00,63,512,73902,399595,575,473497,MONDAY,0,0,11.1,43,16.6,1022.1,Clear
5/15/2023 8:00,110,878,177563,706015,988,883578,MONDAY,0,0,11.1,41,20.5,1022.1,Clear
5/15/2023 9:00,74,521,101218,366278,595,467496,MONDAY,0,0,11.7,39,18.4,1022.3,Clear
5/15/2023 10:00,121,295,320107,233651,416,553758,MONDAY,0,0,11.7,39,18.4,1022.3,Clear
5/15/2023 11:00,140,328,555072,311662,468,866734,MONDAY,0,0,13.9,36,16.6,1022.5,Fair
5/15/2023 12:00,155,417,337322,311584,572,648906,MONDAY,0,0,15.6,32,13,1021.7,Fair
5/15/2023 13:00,182,394,946180,278619,576,1224799,MONDAY,0,0,17.2,29,14.8,1021.5,Fair
5/15/2023 14:00,195,448,316325,330579,643,646904,MONDAY,0,0,18.9,27,11.2,1020.4,Fair
5/15/2023 15:00,217,485,1126006,444742,702,1570748,MONDAY,0,0,18.9,27,11.2,1020.4,Fair
5/15/2023 16:00,242,790,450861,648088,1032,1098949,MONDAY,0,0,21.1,27,16.6,1018,Cloudy
5/15/2023 17:00,343,1145,1411207,2468942,1488,3880149,MONDAY,0,0,22.8,24,18.4,1016.3,Cloudy
5/15/2023 18:00,391,887,2491585,751440,1278,3243025,MONDAY,0,0,22.8,24,18.4,1016.3,Cloudy
5/15/2023 19:00,267,611,2308038,596742,878,2904780,MONDAY,0,0,22.8,22,24.1,1013.8,Cloudy
5/15/2023 20:00,183,434,1055900,917220,617,1973120,MONDAY,0,0,22.8,22,24.1,1013.8,Cloudy
5/15/2023 21:00,145,300,238265,217521,445,455786,MONDAY,0,0,23.3,21,22.3,1011.8,Cloudy
5/15/2023 22:00,157,237,320431,193513,394,513944,MONDAY,0,0,22.2,23,24.1,1011.6,Fair
5/15/2023 23:00,48,97,40823,67454,145,108277,MONDAY,0,0,21.7,23,20.5,1011.6,Cloudy
5/16/2023 0:00,30,47,673944,30370,77,704314,TUESDAY,0,0,21.7,23,20.5,1011.6,Cloudy
5/16/2023 1:00,18,30,55592,17688,48,73280,TUESDAY,0,0,18.9,33,18.4,1011.9,Cloudy
5/16/2023 2:00,10,4,14996,2439,14,17435,TUESDAY,0,0,18.3,34,18.4,1011.4,Cloudy
5/16/2023 3:00,7,6,309966,2827,13,312793,TUESDAY,0,0,17.2,38,16.6,1010.8,Cloudy
5/16/2023 4:00,4,14,2967,14291,18,17258,TUESDAY,0,0,18.3,32,25.9,1010,Cloudy
5/16/2023 5:00,13,65,13916,49821,78,63737,TUESDAY,0,0,17.2,35,20.5,1009.1,Cloudy
5/16/2023 6:00,36,244,53992,184575,280,238567,TUESDAY,0,0,17.2,35,20.5,1009.1,Cloudy
5/16/2023 7:00,106,575,100585,642386,681,742971,TUESDAY,0,0,17.2,35,22.3,1008,Cloudy
5/16/2023 8:00,155,1045,266669,862709,1200,1129378,TUESDAY,0,0,17.2,35,16.6,1007.4,Cloudy
5/16/2023 9:00,105,637,748710,469963,742,1218673,TUESDAY,0,0,16.7,35,22.3,1007,Cloudy
5/16/2023 10:00,91,330,324134,947211,421,1271345,TUESDAY,0,0,16.7,35,22.3,1007,Fair
5/16/2023 11:00,125,343,257256,257233,468,514489,TUESDAY,0,0,16.7,39,22.3,1006.6,Cloudy
5/16/2023 12:00,135,393,233925,276250,528,510175,TUESDAY,0,0,18.3,36,25.9,1005.9,Cloudy
5/16/2023 13:00,151,326,2131615,1148388,477,3280003,TUESDAY,0,0,19.4,29,25.9,1005.1,Cloudy
5/16/2023 14:00,187,433,364585,427673,620,792258,TUESDAY,0,0,21.1,27,31.7,1004.4,Cloudy
5/16/2023 15:00,209,470,1610666,453203,679,2063869,TUESDAY,0,0,21.1,27,31.7,1004.4,Cloudy
5/16/2023 16:00,314,892,3007509,704412,1206,3711921,TUESDAY,0,0,24.4,25,27.7,1001.8,Cloudy
5/16/2023 17:00,477,1246,752794,2242387,1723,2995181,TUESDAY,0,0,26.1,25,22.3,1000.1,Cloudy
5/16/2023 18:00,449,1017,1208542,2378219,1466,3586761,TUESDAY,0,0,26.7,23,22.3,998.9,Fair
5/16/2023 19:00,278,673,1129129,1044218,951,2173347,TUESDAY,0,0,26.7,22,22.3,997.7,Cloudy
5/16/2023 20:00,165,471,327906,369924,636,697830,TUESDAY,0,0,26.7,22,38.9,997.7,Cloudy
5/16/2023 21:00,176,355,362675,299497,531,662172,TUESDAY,0,0,26.1,17,31.7,996.4,Cloudy
5/16/2023 22:00,162,227,243388,173105,389,416493,TUESDAY,0,0,24.4,25,25.9,996.5,Cloudy
5/16/2023 23:00,81,131,151098,182343,212,333441,TUESDAY,0,0,22.8,26,25.9,996.6,Cloudy
5/17/2023 0:00,40,61,814580,72245,101,886825,WEDNESDAY,0,0,22.8,26,33.5,996.6,Cloudy
5/17/2023 1:00,29,35,77199,20400,64,97599,WEDNESDAY,0,0,20.6,41,24.1,997.4,Cloudy
5/17/2023 2:00,7,14,7874,10128,21,18002,WEDNESDAY,0,0,20.6,42,18.4,997.5,Cloudy
5/17/2023 3:00,2,13,1374,11487,15,12861,WEDNESDAY,0,0,20.6,42,18.4,998.2,Cloudy
5/17/2023 4:00,2,11,13746,10768,13,24514,WEDNESDAY,0,0,16.1,56,16.6,998.6,Cloudy
5/17/2023 5:00,6,47,4154,56001,53,60155,WEDNESDAY,0,0,13.9,72,14.8,999.6,Cloudy
5/17/2023 6:00,30,236,33986,221949,266,255935,WEDNESDAY,0,0,13.9,72,14.8,999.6,Cloudy
5/17/2023 7:00,80,565,104400,514122,645,618522,WEDNESDAY,0,0,13.9,64,20.5,1001.3,Cloudy
5/17/2023 8:00,161,1040,196409,879818,1201,1076227,WEDNESDAY,0,0,12.8,57,20.5,1002.4,Cloudy
5/17/2023 9:00,95,586,134791,432614,681,567405,WEDNESDAY,0,0,10,58,27.7,1003.5,Cloudy
5/17/2023 10:00,85,373,142988,360178,458,503166,WEDNESDAY,0,0,10,54,27.7,1004.3,Cloudy
5/17/2023 11:00,127,332,297966,238026,459,535992,WEDNESDAY,0,0,10,54,31.7,1004.3,Cloudy
5/17/2023 12:00,121,409,2020896,313862,530,2334758,WEDNESDAY,0,0,11.7,41,31.7,1005.5,Fair
5/17/2023 13:00,156,399,260868,316196,555,577064,WEDNESDAY,0,0,12.2,38,27.7,1005.9,Fair
5/17/2023 14:00,168,441,409833,349439,609,759272,WEDNESDAY,0,0,12.8,34,33.5,1006.7,Fair
5/17/2023 15:00,209,467,445050,356805,676,801855,WEDNESDAY,0,0,12.8,34,33.5,1006.7,Fair
5/17/2023 16:00,218,743,301187,590157,961,891344,WEDNESDAY,0,0,14.4,26,35.3,1007.4,Fair
5/17/2023 17:00,352,1155,2849725,995988,1507,3845713,WEDNESDAY,0,0,14.4,24,33.5,1007.8,Fair
5/17/2023 18:00,309,929,411872,794057,1238,1205929,WEDNESDAY,0,0,14.4,23,31.7,1008.3,Fair
5/17/2023 19:00,185,580,601957,497663,765,1099620,WEDNESDAY,0,0,13.9,23,33.5,1009.2,Fair
5/17/2023 20:00,99,359,1167371,258576,458,1425947,WEDNESDAY,0,0,13.9,23,29.5,1009.2,Fair
5/17/2023 21:00,66,244,61660,171735,310,233395,WEDNESDAY,0,0,12.2,24,37.1,1011.6,Fair
5/17/2023 22:00,67,180,74723,138306,247,213029,WEDNESDAY,0,0,11.1,24,38.9,1013,Fair
5/17/2023 23:00,75,177,161811,123962,252,285773,WEDNESDAY,0,0,10,26,31.7,1014.5,Fair
5/18/2023 0:00,27,61,33067,35199,88,68266,THURSDAY,0,0,10,26,31.7,1014.5,Fair
5/18/2023 1:00,11,27,107005,36721,38,143726,THURSDAY,0,0,7.8,32,18.4,1017.9,Fair
5/18/2023 2:00,7,15,20384,7502,22,27886,THURSDAY,0,0,7.2,32,22.3,1019,Fair
5/18/2023 3:00,2,5,1230,1804,7,3034,THURSDAY,0,0,6.7,35,16.6,1020.1,Clear
5/18/2023 4:00,4,11,4376,8431,15,12807,THURSDAY,0,0,6.7,35,16.6,1020.5,Clear
5/18/2023 5:00,8,50,7131,34575,58,41706,THURSDAY,0,0,6.7,35,22.3,1020.5,Clear
5/18/2023 6:00,25,196,33704,137036,221,170740,THURSDAY,0,0,6.1,38,14.8,1021.2,Clear
5/18/2023 7:00,79,508,72409,355641,587,428050,THURSDAY,0,0,5.6,39,18.4,1021.4,Clear
5/18/2023 8:00,125,977,157895,759631,1102,917526,THURSDAY,0,0,5.6,39,18.4,1022.2,Clear
5/18/2023 9:00,111,587,169987,440758,698,610745,THURSDAY,0,0,6.1,39,14.8,1023.3,Clear
5/18/2023 10:00,100,366,166647,258681,466,425328,THURSDAY,0,0,6.1,39,14.8,1023.3,Clear
5/18/2023 11:00,139,362,215278,275398,501,490676,THURSDAY,0,0,8.9,33,14.8,1024.7,Fair
5/18/2023 12:00,169,407,286191,294028,576,580219,THURSDAY,0,0,10.6,29,13,1025.4,Fair
5/18/2023 13:00,169,409,781145,1094121,578,1875266,THURSDAY,0,0,11.1,28,9.4,1025.6,Fair
5/18/2023 14:00,175,431,1432289,344028,606,1776317,THURSDAY,0,0,12.8,25,11.2,1025.8,Fair
5/18/2023 15:00,246,552,483888,461165,798,945053,THURSDAY,0,0,12.8,25,11.2,1025.8,Fair
5/18/2023 16:00,306,856,1295768,777829,1162,2073597,THURSDAY,0,0,15.6,24,11.2,1025.4,Fair
5/18/2023 17:00,411,1104,1959762,995782,1515,2955544,THURSDAY,0,0,16.1,23,11.2,1025,Fair
5/18/2023 18:00,320,915,2215596,1115754,1235,3331350,THURSDAY,0,0,17.2,21,14.8,1024.7,Fair
5/18/2023 19:00,212,621,381907,487121,833,869028,THURSDAY,0,0,17.2,21,14.8,1024.7,Fair
5/18/2023 20:00,156,407,166664,431931,563,598595,THURSDAY,0,0,15.6,44,16.6,1024.2,Fair
5/18/2023 21:00,95,276,1897155,209893,371,2107048,THURSDAY,0,0,15.6,33,16.6,1024.4,Fair
5/18/2023 22:00,77,183,233836,171536,260,405372,THURSDAY,0,0,13.9,36,29.5,1024.9,Fair
5/18/2023 23:00,45,132,84794,90297,177,175091,THURSDAY,0,0,12.8,43,29.5,1025.4,Fair
5/19/2023 0:00,27,66,24646,42940,93,67586,FRIDAY,0,0,12.8,43,29.5,1025.4,Fair
5/19/2023 1:00,23,22,20034,15098,45,35132,FRIDAY,0,0,10.6,56,27.7,1027.4,Fair
5/19/2023 2:00,13,10,21492,7653,23,29145,FRIDAY,0,0,10,58,20.5,1027.8,Fair
5/19/2023 3:00,6,10,9170,5375,16,14545,FRIDAY,0,0,9.4,61,16.6,1028,Clear
5/19/2023 4:00,3,11,2366,12493,14,14859,FRIDAY,0,0,9.4,61,16.6,1028,Clear
5/19/2023 5:00,16,56,11964,44634,72,56598,FRIDAY,0,0,8.9,66,22.3,1027.9,Fair
5/19/2023 6:00,25,175,22943,115188,200,138131,FRIDAY,0,0,8.3,71,20.5,1027.9,Fair
5/19/2023 7:00,76,408,85051,343040,484,428091,FRIDAY,0,0,7.8,76,14.8,1028.2,Clear
5/19/2023 8:00,117,711,1299209,541253,828,1840462,FRIDAY,0,0,7.8,76,14.8,1028.3,Fair
5/19/2023 9:00,108,456,173219,368396,564,541615,FRIDAY,0,0,7.8,76,14.8,1028.3,Fair
5/19/2023 10:00,158,364,304752,288810,522,593562,FRIDAY,0,0,8.3,76,16.6,1028.7,Clear
5/19/2023 11:00,178,391,829744,285890,569,1115634,FRIDAY,0,0,12.2,66,13,1029,Fair
5/19/2023 12:00,209,489,1056309,353418,698,1409727,FRIDAY,0,0,13.9,53,25.9,1028.9,Fair
5/19/2023 13:00,283,499,2895347,345821,782,3241168,FRIDAY,0,0,13.9,53,25.9,1028.9,Fair
5/19/2023 14:00,257,443,2098586,403523,700,2502109,FRIDAY,0,0,15.6,51,16.6,1028.7,Fair
5/19/2023 15:00,326,565,1536660,464926,891,2001586,FRIDAY,0,0,19.4,44,18.4,1027.5,Fair
5/19/2023 16:00,332,757,2307606,696805,1089,3004411,FRIDAY,0,0,19.4,44,18.4,1027.5,Fair
5/19/2023 17:00,416,916,2770336,763574,1332,3533910,FRIDAY,0,0,20.6,42,25.9,1025.9,Cloudy
5/19/2023 18:00,362,782,1782250,657144,1144,2439394,FRIDAY,0,0,20,44,27.7,1025.4,Cloudy
5/19/2023 19:00,292,561,472492,463924,853,936416,FRIDAY,0,0,20,44,27.7,1025.4,Cloudy
5/19/2023 20:00,177,398,554922,306888,575,861810,FRIDAY,0,0,18.9,50,31.7,1024.6,Cloudy
5/19/2023 21:00,118,253,186832,176748,371,363580,FRIDAY,0,0,18.3,50,29.5,1024.4,Cloudy
5/19/2023 22:00,95,185,137235,138254,280,275489,FRIDAY,0,0,17.2,50,27.7,1024.7,Cloudy
5/19/2023 23:00,226,250,587346,220414,476,807760,FRIDAY,0,0,15.6,55,29.5,1025,Cloudy
5/20/2023 0:00,101,107,295403,738646,208,1034049,SATURDAY,1,0,15.6,55,29.5,1025,Cloudy
5/20/2023 1:00,117,102,1951406,81511,219,2032917,SATURDAY,1,0,13.9,67,18.4,1025.3,Cloudy
5/20/2023 2:00,55,51,159379,31234,106,190613,SATURDAY,1,0,13.9,69,22.3,1025.2,Fair
5/20/2023 3:00,15,14,17102,8835,29,25937,SATURDAY,1,0,13.3,72,20.5,1025.1,Fair
5/20/2023 4:00,5,13,8417,11667,18,20084,SATURDAY,1,0,13.3,72,20.5,1025.1,Fair
5/20/2023 5:00,9,15,14398,14616,24,29014,SATURDAY,1,0,12.8,80,16.6,1024,Fair
5/20/2023 6:00,15,62,51018,52902,77,103920,SATURDAY,1,0,12.8,83,13,1023.8,Fair
5/20/2023 7:00,28,107,58466,102931,135,161397,SATURDAY,1,0,11.7,89,9.4,1023.4,Cloudy
5/20/2023 8:00,91,222,354480,200548,313,555028,SATURDAY,1,0,12.2,90,9.4,1023.1,Cloudy
5/20/2023 9:00,174,318,414306,261738,492,676044,SATURDAY,1,0,12.2,90,9.4,1023.1,Cloudy
5/20/2023 10:00,222,393,443236,285058,615,728294,SATURDAY,1,0,13.9,90,0,1023.2,Cloudy
5/20/2023 11:00,170,377,489006,388283,547,877289,SATURDAY,1,0,15,87,5.4,1023,Cloudy
5/20/2023 12:00,77,189,111074,124198,266,235272,SATURDAY,1,0,15.6,83,11.2,1022.7,Rain
5/20/2023 13:00,48,129,55768,99162,177,154930,SATURDAY,1,0,15.6,83,11.2,1022.7,Cloudy
5/20/2023 14:00,29,81,35871,51758,110,87629,SATURDAY,1,0,15.6,83,13,1022.4,Cloudy
5/20/2023 15:00,33,109,913791,148217,142,1062008,SATURDAY,1,0,17.2,81,0,1021.6,Cloudy
5/20/2023 16:00,20,106,12738,74067,126,86805,SATURDAY,1,0,17.8,87,18.4,1020.6,Rain
5/20/2023 17:00,32,113,1054674,78050,145,1132724,SATURDAY,1,0,17.8,87,18.4,1020.6,Rain
5/20/2023 18:00,63,205,74286,132685,268,206971,SATURDAY,1,0,15.6,96,20.5,1019.7,Rain
5/20/2023 19:00,75,212,300407,297979,287,598386,SATURDAY,1,0,15,100,22.3,1018.3,Rain
5/20/2023 20:00,22,53,20720,32141,75,52861,SATURDAY,1,0,15.6,96,20.5,1017.3,Rain
5/20/2023 21:00,20,80,1450169,62269,100,1512438,SATURDAY,1,0,18.3,93,25.9,1015.8,Rain
5/20/2023 22:00,39,70,100590,50062,109,150652,SATURDAY,1,0,18.3,93,25.9,1015,Rain
5/20/2023 23:00,11,39,36579,24100,50,60679,SATURDAY,1,0,18.3,93,25.9,1015,Rain
5/21/2023 0:00,3,29,38834,22433,32,61267,SUNDAY,1,0,17.2,97,14.8,1014,Rain
5/21/2023 1:00,62,38,138629,38930,100,177559,SUNDAY,1,0,18.9,93,22.3,1012,Rain
5/21/2023 2:00,61,42,107775,40071,103,147846,SUNDAY,1,0,18.9,93,22.3,1012,Rain
5/21/2023 3:00,7,14,9516,9383,21,18899,SUNDAY,1,0,18.9,93,18.4,1010.8,Rain
5/21/2023 4:00,4,13,5260,14513,17,19773,SUNDAY,1,0,18.3,97,13,1010.3,Rain
5/21/2023 5:00,14,9,13890,8219,23,22109,SUNDAY,1,0,18.3,93,20.5,1008.9,Rain
5/21/2023 6:00,11,47,12770,40730,58,53500,SUNDAY,1,0,17.8,96,14.8,1008.2,Rain
5/21/2023 7:00,28,80,36885,52441,108,89326,SUNDAY,1,0,17.8,96,11.2,1008,Rain
5/21/2023 8:00,91,209,155291,150256,300,305547,SUNDAY,1,0,17.8,96,13,1007.6,Rain
5/21/2023 9:00,212,270,473665,233384,482,707049,SUNDAY,1,0,17.8,96,13,1007.6,Rain
5/21/2023 10:00,308,390,2134476,349672,698,2484148,SUNDAY,1,0,17.8,84,18.4,1008.6,Rain
5/21/2023 11:00,502,445,1191147,424642,947,1615789,SUNDAY,1,0,16.1,84,20.5,1009.3,Cloudy
5/21/2023 12:00,635,578,1796200,604331,1213,2400531,SUNDAY,1,0,16.1,70,20.5,1010.1,Cloudy
5/21/2023 13:00,719,614,3194863,623240,1333,3818103,SUNDAY,1,0,16.1,70,20.5,1010.1,Cloudy
5/21/2023 14:00,743,651,3508990,1357474,1394,4866464,SUNDAY,1,0,18.3,54,22.3,1009.8,Cloudy
5/21/2023 15:00,829,627,3061818,666852,1456,3728670,SUNDAY,1,0,19.4,51,24.1,1010.5,Cloudy
5/21/2023 16:00,766,665,2103784,664586,1431,2768370,SUNDAY,1,0,20.6,47,18.4,1010.3,Cloudy
5/21/2023 17:00,755,647,2917084,616874,1402,3533958,SUNDAY,1,0,22.2,44,22.3,1010.5,Cloudy
5/21/2023 18:00,643,648,2845860,633619,1291,3479479,SUNDAY,1,0,22.2,43,18.4,1010.6,Cloudy
5/21/2023 19:00,570,488,1276101,423131,1058,1699232,SUNDAY,1,0,22.2,43,18.4,1010.6,Cloudy
5/21/2023 20:00,313,388,1588791,1156078,701,2744869,SUNDAY,1,0,23.9,39,16.6,1011.3,Cloudy
5/21/2023 21:00,193,258,675578,200918,451,876496,SUNDAY,1,0,23.3,40,13,1011.8,Cloudy
5/21/2023 22:00,154,183,408432,140539,337,548971,SUNDAY,1,0,23.3,40,20.5,1012.6,Cloudy
5/21/2023 23:00,121,133,824333,114467,254,938800,SUNDAY,1,0,23.3,40,20.5,1012.6,Cloudy
5/22/2023 0:00,38,34,119441,27302,72,146743,MONDAY,0,0,21.7,46,18.4,1014.4,Cloudy
5/22/2023 1:00,25,31,27246,24539,56,51785,MONDAY,0,0,20,49,18.4,1015.5,Fair
5/22/2023 2:00,12,14,34770,8287,26,43057,MONDAY,0,0,18.9,52,13,1015.9,Fair
5/22/2023 3:00,12,10,940245,9618,22,949863,MONDAY,0,0,18.3,56,13,1016.3,Fair
5/22/2023 4:00,5,17,9073,13454,22,22527,MONDAY,0,0,18.3,56,13,1016.3,Fair
5/22/2023 5:00,11,62,430221,44715,73,474936,MONDAY,0,0,17.2,60,14.8,1017,Fair
5/22/2023 6:00,36,198,924425,140357,234,1064782,MONDAY,0,0,17.2,58,14.8,1017.2,Clear
5/22/2023 7:00,77,493,78308,375232,570,453540,MONDAY,0,0,16.1,65,13,1017.8,Clear
5/22/2023 8:00,144,899,201588,680312,1043,881900,MONDAY,0,0,15.6,67,14.8,1018.6,Fair
5/22/2023 9:00,112,541,192936,408075,653,601011,MONDAY,0,0,15.6,67,14.8,1018.6,Fair
5/22/2023 10:00,139,343,274447,301258,482,575705,MONDAY,0,0,14.4,67,25.9,1021,Fair
5/22/2023 11:00,119,336,546911,256615,455,803526,MONDAY,0,0,14.4,60,25.9,1022.2,Fair
5/22/2023 12:00,156,389,1171808,280110,545,1451918,MONDAY,0,0,15,55,24.1,1023.2,Fair
5/22/2023 13:00,218,361,495141,264749,579,759890,MONDAY,0,0,15,55,24.1,1023.2,Fair
5/22/2023 14:00,227,341,3377480,790258,568,4167738,MONDAY,0,0,15,47,24.1,1023.7,Fair
5/22/2023 15:00,253,472,512546,394409,725,906955,MONDAY,0,0,14.4,56,24.1,1024.6,Fair
5/22/2023 16:00,288,681,507260,1546512,969,2053772,MONDAY,0,0,14.4,57,27.7,1024.7,Fair
5/22/2023 17:00,307,1078,384591,836876,1385,1221467,MONDAY,0,0,14.4,56,25.9,1024.9,Fair
5/22/2023 18:00,278,811,436587,625589,1089,1062176,MONDAY,0,0,14.4,56,25.9,1024.9,Fair
5/22/2023 19:00,233,588,2125256,574430,821,2699686,MONDAY,0,0,13.3,62,24.1,1024.9,Fair
5/22/2023 20:00,153,402,178189,298599,555,476788,MONDAY,0,0,12.2,66,24.1,1024.9,Fair
5/22/2023 21:00,103,251,148811,254049,354,402860,MONDAY,0,0,12.2,66,24.1,1024.9,Fair
5/22/2023 22:00,62,151,79002,1073621,213,1152623,MONDAY,0,0,11.1,71,14.8,1025.4,Fair
5/22/2023 23:00,38,109,74643,76878,147,151521,MONDAY,0,0,11.1,71,14.8,1025.4,Fair
5/23/2023 0:00,14,49,17020,29949,63,46969,TUESDAY,0,0,11.1,74,9.4,1026.2,Fair
5/23/2023 1:00,14,15,15045,9059,29,24104,TUESDAY,0,0,11.1,74,13,1026.9,Fair
5/23/2023 2:00,5,10,26885,4608,15,31493,TUESDAY,0,0,10.6,80,11.2,1026.9,Fair
5/23/2023 3:00,2,9,1609,5417,11,7026,TUESDAY,0,0,10.6,80,9.4,1027.3,Fair
5/23/2023 4:00,2,13,1725,7830,15,9555,TUESDAY,0,0,10.6,80,9.4,1027.3,Fair
5/23/2023 5:00,9,65,12757,43783,74,56540,TUESDAY,0,0,11.1,74,0,1027.7,Clear
5/23/2023 6:00,38,234,36908,160763,272,197671,TUESDAY,0,0,10.6,80,5.4,1027.7,Clear
5/23/2023 7:00,120,611,123251,456241,731,579492,TUESDAY,0,0,10.6,80,0,1027.8,Clear
5/23/2023 8:00,149,1098,168831,876053,1247,1044884,TUESDAY,0,0,10,83,7.6,1027.9,Clear
5/23/2023 9:00,136,643,402041,515861,779,917902,TUESDAY,0,0,10,83,7.6,1027.9,Fair
5/23/2023 10:00,125,318,255246,296494,443,551740,TUESDAY,0,0,11.1,86,5.4,1029.1,Fair
5/23/2023 11:00,146,345,487069,276776,491,763845,TUESDAY,0,0,11.7,83,5.4,1029.3,Fair
5/23/2023 12:00,162,428,1519373,336354,590,1855727,TUESDAY,0,0,12.2,83,11.2,1029.4,Fair
5/23/2023 13:00,207,426,974416,309686,633,1284102,TUESDAY,0,0,12.2,83,11.2,1029.4,Fair
5/23/2023 14:00,165,402,430434,298258,567,728692,TUESDAY,0,0,13.9,74,16.6,1029.2,Fair
5/23/2023 15:00,238,512,585808,416704,750,1002512,TUESDAY,0,0,13.9,72,22.3,1029.2,Fair
5/23/2023 16:00,254,844,1353306,790801,1098,2144107,TUESDAY,0,0,14.4,60,24.1,1028.8,Fair
5/23/2023 17:00,408,1272,1437622,1136446,1680,2574068,TUESDAY,0,0,14.4,65,25.9,1028.3,Fair
5/23/2023 18:00,334,977,1554573,789559,1311,2344132,TUESDAY,0,0,14.4,65,25.9,1028.3,Fair
5/23/2023 19:00,238,640,2187795,575438,878,2763233,TUESDAY,0,0,14.4,57,24.1,1027.3,Fair
5/23/2023 20:00,143,433,206544,313657,576,520201,TUESDAY,0,0,14.4,60,24.1,1026.5,Fair
5/23/2023 21:00,102,326,1309004,229678,428,1538682,TUESDAY,0,0,14.4,62,24.1,1025.9,Fair
5/23/2023 22:00,58,193,59580,136779,251,196359,TUESDAY,0,0,13.9,57,22.3,1025.4,Fair
5/23/2023 23:00,55,133,62608,1386281,188,1448889,TUESDAY,0,0,13.9,57,22.3,1025.4,Fair
5/24/2023 0:00,15,49,45809,32108,64,77917,WEDNESDAY,0,0,12.8,45,18.4,1024.9,Fair
5/24/2023 1:00,13,11,38886,25068,24,63954,WEDNESDAY,0,0,11.7,59,11.2,1025.1,Fair
5/24/2023 2:00,4,15,1137853,10911,19,1148764,WEDNESDAY,0,0,11.1,63,13,1024.4,Fair
5/24/2023 3:00,8,12,15918,8367,20,24285,WEDNESDAY,0,0,11.1,63,14.8,1023.9,Fair
5/24/2023 4:00,1,15,552,13105,16,13657,WEDNESDAY,0,0,11.1,63,14.8,1023.9,Fair
5/24/2023 5:00,8,48,9194,35804,56,44998,WEDNESDAY,0,0,10.6,66,5.4,1022.8,Fair
5/24/2023 6:00,38,253,76339,183317,291,259656,WEDNESDAY,0,0,9.4,69,9.4,1022.1,Clear
5/24/2023 7:00,102,575,116586,422003,677,538589,WEDNESDAY,0,0,9.4,69,7.6,1021.7,Clear
5/24/2023 8:00,192,1068,694448,839523,1260,1533971,WEDNESDAY,0,0,9.4,69,7.6,1021.7,Fair
5/24/2023 9:00,128,648,229194,485232,776,714426,WEDNESDAY,0,0,8.9,73,14.8,1020.8,Fair
5/24/2023 10:00,128,380,219313,285420,508,504733,WEDNESDAY,0,0,10,71,14.8,1020.4,Fair
5/24/2023 11:00,139,418,700890,320879,557,1021769,WEDNESDAY,0,0,12.2,61,9.4,1019.9,Fair
5/24/2023 12:00,180,440,736949,340266,620,1077215,WEDNESDAY,0,0,13.9,53,11.2,1019,Fair
5/24/2023 13:00,159,424,846402,334621,583,1181023,WEDNESDAY,0,0,13.9,53,11.2,1019,Fair
5/24/2023 14:00,202,419,1401753,428038,621,1829791,WEDNESDAY,0,0,17.2,41,9.4,1017.1,Fair
5/24/2023 15:00,226,537,2521599,464956,763,2986555,WEDNESDAY,0,0,17.2,41,16.6,1016.3,Fair
5/24/2023 16:00,345,811,2758325,670721,1156,3429046,WEDNESDAY,0,0,17.8,52,20.5,1015.5,Fair
5/24/2023 17:00,435,1255,2260799,1568474,1690,3829273,WEDNESDAY,0,0,17.2,65,20.5,1014.6,Fair
5/24/2023 18:00,146,583,216967,413532,729,630499,WEDNESDAY,0,0,17.2,65,24.1,1014.6,Fair
5/24/2023 19:00,54,269,104362,200808,323,305170,WEDNESDAY,0,0,21.1,51,14.8,1012.5,Rain
5/24/2023 20:00,48,261,40563,187541,309,228104,WEDNESDAY,0,0,22.8,38,27.7,1011.8,Rain
5/24/2023 21:00,70,210,451564,144252,280,595816,WEDNESDAY,0,0,22.8,38,27.7,1011.8,Rain
5/24/2023 22:00,55,170,884633,118484,225,1003117,WEDNESDAY,0,0,20.6,38,24.1,1011.8,Rain
5/24/2023 23:00,24,110,37513,76919,134,114432,WEDNESDAY,0,0,13.9,87,20.5,1015,Rain
5/25/2023 0:00,18,40,39479,30501,58,69980,THURSDAY,0,0,13.9,83,22.3,1015.3,Cloudy
5/25/2023 1:00,19,13,49675,9255,32,58930,THURSDAY,0,0,12.8,80,24.1,1015.8,Cloudy
5/25/2023 2:00,4,9,1947,7021,13,8968,THURSDAY,0,0,12.2,80,22.3,1015.8,Cloudy
5/25/2023 3:00,2,9,742,3832,11,4574,THURSDAY,0,0,12.2,80,22.3,1015.8,Cloudy
5/25/2023 4:00,10,10,12190,9799,20,21989,THURSDAY,0,0,12.8,80,18.4,1015.7,Cloudy
5/25/2023 5:00,17,64,25704,49273,81,74977,THURSDAY,0,0,11.7,80,22.3,1015.8,Cloudy
5/25/2023 6:00,52,246,884691,185896,298,1070587,THURSDAY,0,0,11.1,80,16.6,1016.1,Cloudy
5/25/2023 7:00,107,566,1230469,526096,673,1756565,THURSDAY,0,0,11.1,80,24.1,1016.5,Cloudy
5/25/2023 8:00,167,963,209165,1541775,1130,1750940,THURSDAY,0,0,11.1,80,24.1,1016.5,Fair
5/25/2023 9:00,136,591,1358214,436864,727,1795078,THURSDAY,0,0,10.6,74,24.1,1017.7,Fair
5/25/2023 10:00,113,343,175152,797087,456,972239,THURSDAY,0,0,11.1,66,24.1,1018.6,Cloudy
5/25/2023 11:00,150,359,1193866,256240,509,1450106,THURSDAY,0,0,12.2,61,16.6,1018.8,Fair
5/25/2023 12:00,152,401,1266390,321538,553,1587928,THURSDAY,0,0,13.3,55,20.5,1018.9,Fair
5/25/2023 13:00,187,410,880663,324860,597,1205523,THURSDAY,0,0,13.3,55,20.5,1018.9,Fair
5/25/2023 14:00,208,436,331967,374651,644,706618,THURSDAY,0,0,16.1,46,22.3,1018.8,Fair
5/25/2023 15:00,278,538,1504928,478661,816,1983589,THURSDAY,0,0,16.1,44,16.6,1018.5,Fair
5/25/2023 16:00,341,852,771183,727220,1193,1498403,THURSDAY,0,0,17.2,40,16.6,1018,Fair
5/25/2023 17:00,414,1146,637105,1021541,1560,1658646,THURSDAY,0,0,17.2,40,22.3,1018,Fair
5/25/2023 18:00,390,871,1833216,754606,1261,2587822,THURSDAY,0,0,18.9,33,16.6,1018.6,Fair
5/25/2023 19:00,293,648,1494924,576756,941,2071680,THURSDAY,0,0,16.1,54,16.6,1018.5,Fair
5/25/2023 20:00,178,463,588093,388332,641,976425,THURSDAY,0,0,14.4,62,20.5,1019,Fair
5/25/2023 21:00,111,261,186070,209585,372,395655,THURSDAY,0,0,15.6,49,9.4,1019.3,Fair
5/25/2023 22:00,119,243,1419496,185987,362,1605483,THURSDAY,0,0,15.6,49,9.4,1019.3,Fair
5/25/2023 23:00,90,161,726853,114113,251,840966,THURSDAY,0,0,16.7,38,18.4,1020.6,Fair
5/26/2023 0:00,51,78,54369,51594,129,105963,FRIDAY,0,0,15.6,42,14.8,1021,Fair
5/26/2023 1:00,37,41,46965,52832,78,99797,FRIDAY,0,0,15.6,42,14.8,1021.7,Fair
5/26/2023 2:00,18,14,31559,426686,32,458245,FRIDAY,0,0,14.4,47,16.6,1021.7,Fair
5/26/2023 3:00,5,14,2282,8874,19,11156,FRIDAY,0,0,14.4,47,16.6,1021.7,Fair
5/26/2023 4:00,5,18,3890,15010,23,18900,FRIDAY,0,0,13.3,49,13,1021.9,Fair
5/26/2023 5:00,15,53,20276,39032,68,59308,FRIDAY,0,0,12.2,55,11.2,1021.8,Fair
5/26/2023 6:00,32,166,310425,120123,198,430548,FRIDAY,0,0,11.7,54,14.8,1021.8,Clear
5/26/2023 7:00,67,396,78780,277126,463,355906,FRIDAY,0,0,11.7,54,14.8,1021.8,Clear
5/26/2023 8:00,124,689,138653,555317,813,693970,FRIDAY,0,0,10.6,59,18.4,1022,Clear
5/26/2023 9:00,149,535,690072,414739,684,1104811,FRIDAY,0,0,10.6,59,20.5,1022.2,Clear
5/26/2023 10:00,164,360,354783,1282584,524,1637367,FRIDAY,0,0,11.7,52,13,1023.1,Fair
5/26/2023 11:00,234,376,1044414,856988,610,1901402,FRIDAY,0,0,14.4,44,14.8,1023.5,Fair
5/26/2023 12:00,281,483,528334,350081,764,878415,FRIDAY,0,0,15,44,14.8,1024.1,Fair
5/26/2023 13:00,273,502,1092181,401065,775,1493246,FRIDAY,0,0,15,44,14.8,1024.1,Fair
5/26/2023 14:00,325,491,1948309,416633,816,2364942,FRIDAY,0,0,14.4,67,13,1024.2,Fair
5/26/2023 15:00,378,574,2071395,923567,952,2994962,FRIDAY,0,0,14.4,67,20.5,1023.9,Fair
5/26/2023 16:00,345,709,606592,1164292,1054,1770884,FRIDAY,0,0,15,64,24.1,1023.6,Fair
5/26/2023 17:00,449,772,2296485,779553,1221,3076038,FRIDAY,0,0,15,64,24.1,1023.6,Fair
5/26/2023 18:00,348,680,776169,590386,1028,1366555,FRIDAY,0,0,14.4,65,22.3,1023.6,Fair
5/26/2023 19:00,289,535,2838951,452903,824,3291854,FRIDAY,0,0,14.4,65,24.1,1023.5,Fair
5/26/2023 20:00,199,368,814643,299797,567,1114440,FRIDAY,0,0,14.4,67,22.3,1023.7,Fair
5/26/2023 21:00,183,245,382446,211183,428,593629,FRIDAY,0,0,14.4,57,20.5,1023.9,Fair
5/26/2023 22:00,181,217,296528,164212,398,460740,FRIDAY,0,0,14.4,57,20.5,1023.9,Fair
5/26/2023 23:00,217,180,360530,147713,397,508243,FRIDAY,0,0,14.4,65,13,1024.1,Fair
5/27/2023 0:00,70,90,1204508,73890,160,1278398,SATURDAY,1,0,13.9,69,11.2,1024.5,Fair
5/27/2023 1:00,80,65,1578656,53685,145,1632341,SATURDAY,1,0,14.4,53,14.8,1024.9,Fair
5/27/2023 2:00,52,45,918760,44089,97,962849,SATURDAY,1,0,13.9,55,14.8,1024.8,Fair
5/27/2023 3:00,16,12,17995,9972,28,27967,SATURDAY,1,0,13.9,55,14.8,1024.8,Fair
5/27/2023 4:00,11,17,18486,17452,28,35938,SATURDAY,1,0,11.7,71,9.4,1025.4,Fair
5/27/2023 5:00,6,11,9972,9010,17,18982,SATURDAY,1,0,12.2,75,9.4,1025.5,Clear
5/27/2023 6:00,14,65,21317,44317,79,65634,SATURDAY,1,0,11.1,83,9.4,1025.6,Clear
5/27/2023 7:00,44,104,90098,79190,148,169288,SATURDAY,1,0,10.6,89,7.6,1025.4,Clear
5/27/2023 8:00,92,187,833841,140266,279,974107,SATURDAY,1,0,10.6,89,7.6,1025.4,Clear
5/27/2023 9:00,149,306,1855776,253473,455,2109249,SATURDAY,1,0,11.1,86,7.6,1026,Clear
5/27/2023 10:00,257,391,1377243,457033,648,1834276,SATURDAY,1,0,13.9,64,11.2,1026.2,Clear
5/27/2023 11:00,374,424,1864089,375901,798,2239990,SATURDAY,1,0,16.1,52,11.2,1026.4,Fair
5/27/2023 12:00,515,484,2578519,473262,999,3051781,SATURDAY,1,0,16.1,52,11.2,1026.4,Fair
5/27/2023 13:00,540,479,2774169,585867,1019,3360036,SATURDAY,1,0,21.7,30,11.2,1026.1,Fair
5/27/2023 14:00,628,464,3526346,486272,1092,4012618,SATURDAY,1,0,21.7,39,13,1025.8,Fair
5/27/2023 15:00,577,435,2238995,598547,1012,2837542,SATURDAY,1,0,22.2,41,5.4,1025.3,Fair
5/27/2023 16:00,499,457,1329825,460647,956,1790472,SATURDAY,1,0,22.8,38,5.4,1024.8,Fair
5/27/2023 17:00,530,444,2646943,464700,974,3111643,SATURDAY,1,0,22.8,38,18.4,1024.8,Fair
5/27/2023 18:00,402,439,833751,436143,841,1269894,SATURDAY,1,0,22.2,40,20.5,1024.1,Fair
5/27/2023 19:00,405,437,2309935,474310,842,2784245,SATURDAY,1,0,22.2,35,24.1,1023.6,Fair
5/27/2023 20:00,302,321,547793,391354,623,939147,SATURDAY,1,0,22.2,38,24.1,1023.2,Fair
5/27/2023 21:00,184,228,280405,249691,412,530096,SATURDAY,1,0,22.2,38,25.9,1023.2,Fair
5/27/2023 22:00,236,179,548025,162401,415,710426,SATURDAY,1,0,22.8,41,20.5,1022.7,Fair
5/27/2023 23:00,293,191,1356942,199638,484,1556580,SATURDAY,1,0,20.6,41,20.5,1022.9,Fair
5/28/2023 0:00,109,85,170145,65116,194,235261,SUNDAY,1,0,19.4,39,20.5,1023.2,Fair
5/28/2023 1:00,91,60,164534,88718,151,253252,SUNDAY,1,0,18.3,45,14.8,1023.4,Fair
5/28/2023 2:00,37,34,66077,28594,71,94671,SUNDAY,1,0,18.3,45,14.8,1023.4,Fair
5/28/2023 3:00,18,18,782113,13447,36,795560,SUNDAY,1,0,17.8,48,18.4,1022.9,Fair
5/28/2023 4:00,6,10,7243,8920,16,16163,SUNDAY,1,0,17.2,50,20.5,1022.5,Fair
5/28/2023 5:00,23,26,40633,26417,49,67050,SUNDAY,1,0,16.7,52,18.4,1022,Fair
5/28/2023 6:00,50,78,157656,46809,128,204465,SUNDAY,1,0,16.7,50,22.3,1021.7,Clear
5/28/2023 7:00,71,123,984894,98139,194,1083033,SUNDAY,1,0,16.7,50,22.3,1021.7,Clear
5/28/2023 8:00,128,171,553956,137107,299,691063,SUNDAY,1,0,16.1,54,7.6,1020.9,Clear
5/28/2023 9:00,247,270,593481,338962,517,932443,SUNDAY,1,0,15.6,57,7.6,1020.7,Fair
5/28/2023 10:00,376,333,1972845,316074,709,2288919,SUNDAY,1,0,18.3,50,0,1020.4,Fair
5/28/2023 11:00,575,369,3032503,326447,944,3358950,SUNDAY,1,0,19.4,49,7.6,1020.1,Fair
5/28/2023 12:00,590,406,1747470,399433,996,2146903,SUNDAY,1,0,19.4,49,7.6,1020.1,Fair
5/28/2023 13:00,675,415,3967791,419564,1090,4387355,SUNDAY,1,0,24.4,42,0,1019.1,Fair
5/28/2023 14:00,800,363,4728888,374401,1163,5103289,SUNDAY,1,0,25.6,42,16.6,1018.4,Fair
5/28/2023 15:00,816,422,5062789,412961,1238,5475750,SUNDAY,1,0,27.8,33,24.1,1017.9,Fair
5/28/2023 16:00,720,400,1761318,458233,1120,2219551,SUNDAY,1,0,28.9,31,24.1,1016.9,Fair
5/28/2023 17:00,653,442,6218018,448863,1095,6666881,SUNDAY,1,0,28.9,31,24.1,1016.9,Fair
5/28/2023 18:00,694,469,6342781,435241,1163,6778022,SUNDAY,1,0,30,29,22.3,1015.2,Fair
5/28/2023 19:00,623,392,1708993,369699,1015,2078692,SUNDAY,1,0,30,30,22.3,1014.2,Fair
5/28/2023 20:00,473,328,1623421,451722,801,2075143,SUNDAY,1,0,30,30,24.1,1013.4,Fair
5/28/2023 21:00,342,238,2101793,330920,580,2432713,SUNDAY,1,0,28.9,33,24.1,1012.5,Fair
5/28/2023 22:00,371,163,726229,153380,534,879609,SUNDAY,1,0,28.9,33,24.1,1012.5,Fair
5/28/2023 23:00,307,134,1741550,118451,441,1860001,SUNDAY,1,0,25,42,22.3,1012.3,Fair
5/29/2023 0:00,103,62,216932,58679,165,275611,MONDAY,0,1,23.3,46,20.5,1012.5,Fair
5/29/2023 1:00,49,43,110038,80643,92,190681,MONDAY,0,1,22.8,46,16.6,1013.1,Fair
5/29/2023 2:00,30,26,73800,18036,56,91836,MONDAY,0,1,22.8,46,16.6,1013.1,Fair
5/29/2023 3:00,3,8,2697,7400,11,10097,MONDAY,0,1,20.6,49,14.8,1013.6,Fair
5/29/2023 4:00,4,13,7491,10929,17,18420,MONDAY,0,1,18.9,54,16.6,1013.5,Fair
5/29/2023 5:00,9,15,14011,12656,24,26667,MONDAY,0,1,18.3,58,11.2,1013.2,Clear
5/29/2023 6:00,27,81,36398,43238,108,79636,MONDAY,0,1,18.3,58,11.2,1013.2,Clear
5/29/2023 7:00,38,109,53263,92904,147,146167,MONDAY,0,1,19.4,51,11.2,1014.1,Clear
5/29/2023 8:00,80,151,185934,673030,231,858964,MONDAY,0,1,17.8,48,31.7,1015.7,Clear
5/29/2023 9:00,158,293,333244,326069,451,659313,MONDAY,0,1,17.2,50,22.3,1016.9,Fair
5/29/2023 10:00,277,312,606854,310721,589,917575,MONDAY,0,1,17.2,48,22.3,1018,Fair
5/29/2023 11:00,380,415,1768407,381427,795,2149834,MONDAY,0,1,18.3,43,25.9,1018.9,Fair
5/29/2023 12:00,455,408,1647500,391497,863,2038997,MONDAY,0,1,18.3,43,25.9,1018.9,Fair
5/29/2023 13:00,494,408,1976962,404581,902,2381543,MONDAY,0,1,18.9,42,25.9,1020.4,Fair
5/29/2023 14:00,482,447,1895639,610581,929,2506220,MONDAY,0,1,18.9,42,25.9,1020.9,Fair
5/29/2023 15:00,470,429,2284134,791957,899,3076091,MONDAY,0,1,18.3,40,31.7,1021.1,Fair
5/29/2023 16:00,422,498,1546451,483496,920,2029947,MONDAY,0,1,18.3,40,33.5,1021.1,Fair
5/29/2023 17:00,402,532,1722919,485630,934,2208549,MONDAY,0,1,16.7,54,29.5,1021.5,Fair
5/29/2023 18:00,327,496,1585655,448131,823,2033786,MONDAY,0,1,16.1,56,22.3,1021.7,Fair
5/29/2023 19:00,336,489,489903,423202,825,913105,MONDAY,0,1,15.6,62,22.3,1021.7,Fair
5/29/2023 20:00,210,398,716637,365420,608,1082057,MONDAY,0,1,15,60,18.4,1021.9,Fair
5/29/2023 21:00,80,163,120371,123061,243,243432,MONDAY,0,1,15,60,18.4,1021.9,Fair
5/29/2023 22:00,244,270,433520,243097,514,676617,MONDAY,0,1,14.4,56,18.4,1022.1,Fair
5/29/2023 23:00,128,167,429803,127491,295,557294,MONDAY,0,1,13.3,60,14.8,1022.4,Fair
5/30/2023 0:00,37,52,200352,32127,89,232479,TUESDAY,0,0,13.3,55,13,1023,Fair
5/30/2023 1:00,22,12,62898,9692,34,72590,TUESDAY,0,0,13.3,55,9.4,1023.2,Fair
5/30/2023 2:00,4,10,12517,7252,14,19769,TUESDAY,0,0,13.3,55,9.4,1023.2,Fair
5/30/2023 3:00,3,7,3378,5098,10,8476,TUESDAY,0,0,12.2,69,9.4,1023.7,Clear
5/30/2023 4:00,1,14,923,21521,15,22444,TUESDAY,0,0,11.1,77,5.4,1023.9,Clear
5/30/2023 5:00,6,69,4329,47401,75,51730,TUESDAY,0,0,11.7,71,7.6,1024,Clear
5/30/2023 6:00,28,234,40335,165430,262,205765,TUESDAY,0,0,11.1,71,7.6,1023.7,Clear
5/30/2023 7:00,100,499,102435,409616,599,512051,TUESDAY,0,0,11.1,71,7.6,1023.7,Clear
5/30/2023 8:00,151,1006,249448,975269,1157,1224717,TUESDAY,0,0,9.4,83,9.4,1024,Clear
5/30/2023 9:00,94,601,111468,488685,695,600153,TUESDAY,0,0,10.6,77,13,1024.4,Fair
5/30/2023 10:00,98,371,167294,290401,469,457695,TUESDAY,0,0,12.2,72,11.2,1024.9,Fair
5/30/2023 11:00,154,344,305348,270749,498,576097,TUESDAY,0,0,12.2,72,11.2,1024.9,Fair
5/30/2023 12:00,179,396,332318,282117,575,614435,TUESDAY,0,0,13.3,69,9.4,1025,Fair
5/30/2023 13:00,167,406,312596,317770,573,630366,TUESDAY,0,0,14.4,65,11.2,1024.9,Fair
5/30/2023 14:00,202,390,365681,758511,592,1124192,TUESDAY,0,0,14.4,65,13,1024.9,Fair
5/30/2023 15:00,179,486,295980,374488,665,670468,TUESDAY,0,0,14.4,70,18.4,1025,Fair
5/30/2023 16:00,269,847,366134,719153,1116,1085287,TUESDAY,0,0,14.4,70,18.4,1025,Fair
5/30/2023 17:00,385,1229,640310,1080226,1614,1720536,TUESDAY,0,0,16.1,60,24.1,1024.3,Fair
5/30/2023 18:00,344,935,1517425,795648,1279,2313073,TUESDAY,0,0,16.1,62,24.1,1023.7,Fair
5/30/2023 19:00,242,615,2077019,577418,857,2654437,TUESDAY,0,0,16.1,62,29.5,1023.2,Fair
5/30/2023 20:00,162,469,280016,352463,631,632479,TUESDAY,0,0,15.6,67,25.9,1023.1,Fair
5/30/2023 21:00,130,326,509740,253836,456,763576,TUESDAY,0,0,15.6,67,25.9,1023.1,Fair
5/30/2023 22:00,93,205,171053,151737,298,322790,TUESDAY,0,0,15.6,69,29.5,1022.4,Fair
5/30/2023 23:00,26,104,33436,74077,130,107513,TUESDAY,0,0,15.6,72,16.6,1022.6,Fair
5/31/2023 0:00,18,44,79697,22803,62,102500,WEDNESDAY,0,0,15,72,18.4,1022.7,Fair
5/31/2023 1:00,5,30,10971,16584,35,27555,WEDNESDAY,0,0,15,72,18.4,1022.7,Fair
5/31/2023 2:00,8,21,12618,10225,29,22843,WEDNESDAY,0,0,12.8,69,11.2,1023.2,Fair
5/31/2023 3:00,5,13,3750,10693,18,14443,WEDNESDAY,0,0,12.8,69,11.2,1023.2,Clear
5/31/2023 4:00,6,19,4603,11997,25,16600,WEDNESDAY,0,0,11.1,83,13,1023.2,Clear
5/31/2023 5:00,10,61,7259,44041,71,51300,WEDNESDAY,0,0,10.6,89,11.2,1022.9,Clear
5/31/2023 6:00,41,255,39841,179378,296,219219,WEDNESDAY,0,0,10.6,89,11.2,1022.9,Clear
5/31/2023 7:00,97,587,106227,439013,684,545240,WEDNESDAY,0,0,10.6,86,11.2,1022.9,Clear
5/31/2023 8:00,177,1115,175200,896594,1292,1071794,WEDNESDAY,0,0,9.4,90,13,1022.9,Clear
5/31/2023 9:00,122,616,179326,483164,738,662490,WEDNESDAY,0,0,10,89,11.2,1023.3,Fair
5/31/2023 10:00,138,381,452972,785357,519,1238329,WEDNESDAY,0,0,10.6,89,9.4,1023.3,Fair
5/31/2023 11:00,129,382,257819,656883,511,914702,WEDNESDAY,0,0,10.6,89,9.4,1023.3,Fair
5/31/2023 12:00,153,416,221282,318670,569,539952,WEDNESDAY,0,0,14.4,75,13,1023.8,Fair
5/31/2023 13:00,171,371,263869,303786,542,567655,WEDNESDAY,0,0,16.1,67,13,1023.6,Fair
5/31/2023 14:00,217,399,427570,339023,616,766593,WEDNESDAY,0,0,17.8,58,14.8,1023.5,Fair
5/31/2023 15:00,252,556,1465248,472387,808,1937635,WEDNESDAY,0,0,20,53,13,1022.8,Fair
5/31/2023 16:00,314,836,463837,1400089,1150,1863926,WEDNESDAY,0,0,20,53,13,1022.8,Fair
5/31/2023 17:00,443,1203,1656614,2093300,1646,3749914,WEDNESDAY,0,0,21.1,57,14.8,1021.6,Fair
5/31/2023 18:00,459,1000,1015376,1520725,1459,2536101,WEDNESDAY,0,0,21.1,57,18.4,1021.1,Fair
5/31/2023 19:00,317,698,841853,744918,1015,1586771,WEDNESDAY,0,0,21.7,55,22.3,1020.5,Fair
5/31/2023 20:00,212,531,1240262,495418,743,1735680,WEDNESDAY,0,0,22.2,53,11.2,1020.3,Fair
5/31/2023 21:00,180,336,858788,301810,516,1160598,WEDNESDAY,0,0,22.2,53,11.2,1020.3,Fair
5/31/2023 22:00,158,230,389774,258214,388,647988,WEDNESDAY,0,0,24.4,31,14.8,1019.4,Fair
5/31/2023 23:00,63,130,130851,160906,193,291757,WEDNESDAY,0,0,24.4,31,14.8,1019.4,Fair
6/1/2023 0:00,31,53,61684,37513,84,99197,THURSDAY,0,0,20.6,53,18.4,1019.9,Fair
6/1/2023 1:00,15,24,16390,17929,39,34319,THURSDAY,0,0,18.9,65,16.6,1020.5,Fair
6/1/2023 2:00,13,11,37476,46673,24,84149,THURSDAY,0,0,18.9,65,16.6,1020.5,Fair
6/1/2023 3:00,4,9,3782,9557,13,13339,THURSDAY,0,0,17.2,70,14.8,1020.1,Clear
6/1/2023 4:00,1,12,104,10924,13,11028,THURSDAY,0,0,16.7,72,16.6,1019.8,Clear
6/1/2023 5:00,18,59,19353,42103,77,61456,THURSDAY,0,0,16.1,75,18.4,1019.6,Fair
6/1/2023 6:00,47,247,38578,176181,294,214759,THURSDAY,0,0,16.1,75,18.4,1019.6,Clear
6/1/2023 7:00,111,593,166189,441451,704,607640,THURSDAY,0,0,15.6,80,18.4,1019,Clear
6/1/2023 8:00,178,1097,189320,925449,1275,1114769,THURSDAY,0,0,15,83,14.8,1018.9,Clear
6/1/2023 9:00,140,615,227866,486931,755,714797,THURSDAY,0,0,15,83,13,1018.9,Fair
6/1/2023 10:00,132,414,224124,360174,546,584298,THURSDAY,0,0,16.7,78,5.4,1018.9,Fair
6/1/2023 11:00,146,373,193532,304863,519,498395,THURSDAY,0,0,16.7,78,5.4,1018.9,Fair
6/1/2023 12:00,183,448,252398,316881,631,569279,THURSDAY,0,0,20.6,63,13,1019.1,Fair
6/1/2023 13:00,158,406,293952,453621,564,747573,THURSDAY,0,0,23.3,56,13,1018.7,Fair
6/1/2023 14:00,149,396,2412735,333657,545,2746392,THURSDAY,0,0,25,50,13,1018.5,Fair
6/1/2023 15:00,208,460,613054,469029,668,1082083,THURSDAY,0,0,26.1,49,13,1018.1,Fair
6/1/2023 16:00,276,838,2663616,751247,1114,3414863,THURSDAY,0,0,26.1,49,13,1018.1,Fair
6/1/2023 17:00,475,1143,767427,1109579,1618,1877006,THURSDAY,0,0,28.3,43,14.8,1016.9,Fair
6/1/2023 18:00,468,980,3722655,868917,1448,4591572,THURSDAY,0,0,28.3,43,18.4,1016.2,Fair
6/1/2023 19:00,329,641,1359800,2568253,970,3928053,THURSDAY,0,0,27.2,46,18.4,1015.7,Fair
6/1/2023 20:00,232,489,998163,473661,721,1471824,THURSDAY,0,0,27.2,46,18.4,1015.7,Fair
6/1/2023 21:00,202,359,374318,320842,561,695160,THURSDAY,0,0,27.2,44,16.6,1014.7,Fair
6/1/2023 22:00,218,298,2253856,1798878,516,4052734,THURSDAY,0,0,27.2,44,13,1014.6,Fair
6/1/2023 23:00,112,162,2510216,115380,274,2625596,THURSDAY,0,0,26.1,52,16.6,1014.8,Fair
6/2/2023 0:00,32,77,628341,72471,109,700812,FRIDAY,0,0,23.9,60,16.6,1015.1,Fair
6/2/2023 1:00,37,23,51668,18982,60,70650,FRIDAY,0,0,23.9,60,16.6,1015.1,Fair
6/2/2023 2:00,15,18,13638,15222,33,28860,FRIDAY,0,0,20.6,63,11.2,1015.4,Fair
6/2/2023 3:00,7,11,5160,9852,18,15012,FRIDAY,0,0,21.1,61,16.6,1015.2,Fair
6/2/2023 4:00,2,10,1311,9035,12,10346,FRIDAY,0,0,20.6,66,16.6,1014.5,Fair
6/2/2023 5:00,14,53,16413,48609,67,65022,FRIDAY,0,0,20,70,14.8,1014,Fair
6/2/2023 6:00,41,209,263855,1932654,250,2196509,FRIDAY,0,0,20,70,14.8,1014,Fair
6/2/2023 7:00,83,431,87078,463246,514,550324,FRIDAY,0,0,20.6,68,5.4,1013,Fair
6/2/2023 8:00,151,812,187435,649460,963,836895,FRIDAY,0,0,18.3,81,5.4,1013,Fair
6/2/2023 9:00,145,528,4133969,441820,673,4575789,FRIDAY,0,0,18.3,81,7.6,1013.1,Fair
6/2/2023 10:00,174,375,372124,291730,549,663854,FRIDAY,0,0,22.2,64,5.4,1012.9,Fair
6/2/2023 11:00,208,390,904666,318582,598,1223248,FRIDAY,0,0,22.2,64,5.4,1012.9,Fair
6/2/2023 12:00,216,499,2660511,383236,715,3043747,FRIDAY,0,0,22.2,71,7.6,1013.1,Fair
6/2/2023 13:00,218,507,1215807,379223,725,1595030,FRIDAY,0,0,24.4,62,7.6,1013,Fair
6/2/2023 14:00,237,455,707662,1138720,692,1846382,FRIDAY,0,0,24.4,60,11.2,1012.8,Fair
6/2/2023 15:00,224,500,1083435,424348,724,1507783,FRIDAY,0,0,24.4,60,11.2,1012.8,Fair
6/2/2023 16:00,294,732,1441612,666612,1026,2108224,FRIDAY,0,0,26.1,54,14.8,1011.8,Fair
6/2/2023 17:00,346,876,5092859,816697,1222,5909556,FRIDAY,0,0,26.1,58,14.8,1011.4,Fair
6/2/2023 18:00,273,625,3352234,534460,898,3886694,FRIDAY,0,0,26.1,58,20.5,1010.9,Fair
6/2/2023 19:00,47,183,63436,127619,230,191055,FRIDAY,0,0,25,60,16.6,1010.2,Cloudy
6/2/2023 20:00,26,79,186285,53690,105,239975,FRIDAY,0,0,25,60,16.6,1010.2,Cloudy
6/2/2023 21:00,22,55,24153,31952,77,56105,FRIDAY,0,0,26.1,50,9.4,1010.4,Rain
6/2/2023 22:00,17,55,17488,46054,72,63542,FRIDAY,0,0,26.7,52,18.4,1011.6,Cloudy
6/2/2023 23:00,46,85,167161,75874,131,243035,FRIDAY,0,0,20.6,78,18.4,1013.4,Cloudy
6/3/2023 0:00,62,87,325395,64537,149,389932,SATURDAY,1,0,20.6,78,29.5,1013.4,Cloudy
6/3/2023 1:00,100,71,1119578,58671,171,1178249,SATURDAY,1,0,17.2,90,22.3,1013.5,Cloudy
6/3/2023 2:00,41,43,1364052,47213,84,1411265,SATURDAY,1,0,14.4,90,33.5,1014.4,Cloudy
6/3/2023 3:00,6,11,7914,6642,17,14556,SATURDAY,1,0,14.4,90,31.7,1014.4,Rain
6/3/2023 4:00,9,7,39888,8442,16,48330,SATURDAY,1,0,13.9,90,29.5,1015.1,Cloudy
6/3/2023 5:00,3,7,1390,6255,10,7645,SATURDAY,1,0,13.3,87,33.5,1015.5,Cloudy
6/3/2023 6:00,14,48,11808,29216,62,41024,SATURDAY,1,0,13.3,87,33.5,1015.5,Rain
6/3/2023 7:00,19,100,29289,77044,119,106333,SATURDAY,1,0,12.2,86,33.5,1015.6,Rain
6/3/2023 8:00,69,171,126038,118337,240,244375,SATURDAY,1,0,12.2,83,35.3,1016,Cloudy
6/3/2023 9:00,91,267,139861,186652,358,326513,SATURDAY,1,0,11.7,89,35.3,1016.9,Rain
6/3/2023 10:00,133,324,446443,238286,457,684729,SATURDAY,1,0,11.1,93,27.7,1016.9,Cloudy
6/3/2023 11:00,127,335,165809,279252,462,445061,SATURDAY,1,0,11.1,93,27.7,1018,Cloudy
6/3/2023 12:00,137,389,198158,608140,526,806298,SATURDAY,1,0,11.1,83,29.5,1018.6,Cloudy
6/3/2023 13:00,141,345,187144,369101,486,556245,SATURDAY,1,0,11.1,86,27.7,1018.9,Cloudy
6/3/2023 14:00,185,371,475598,353511,556,829109,SATURDAY,1,0,11.1,86,29.5,1019.4,Cloudy
6/3/2023 15:00,126,301,234037,846901,427,1080938,SATURDAY,1,0,11.1,86,29.5,1019.4,Cloudy
6/3/2023 16:00,148,289,871416,305533,437,1176949,SATURDAY,1,0,10.6,89,37.1,1019.8,Cloudy
6/3/2023 17:00,108,274,133429,237261,382,370690,SATURDAY,1,0,10,89,27.7,1019.9,Cloudy
6/3/2023 18:00,92,272,161694,663797,364,825491,SATURDAY,1,0,10,89,29.5,1020,Cloudy
6/3/2023 19:00,76,253,145184,184530,329,329714,SATURDAY,1,0,10,89,25.9,1020.5,Cloudy
6/3/2023 20:00,64,201,504165,141341,265,645506,SATURDAY,1,0,10,89,25.9,1020.5,Cloudy
6/3/2023 21:00,62,156,82668,126579,218,209247,SATURDAY,1,0,9.4,86,29.5,1020.7,Cloudy
6/3/2023 22:00,59,97,676104,244513,156,920617,SATURDAY,1,0,9.4,86,24.1,1020.9,Cloudy
6/3/2023 23:00,48,79,279348,59984,127,339332,SATURDAY,1,0,9.4,83,24.1,1020.9,Cloudy
6/4/2023 0:00,61,85,2232141,52225,146,2284366,SUNDAY,1,0,9.4,83,29.5,1020.9,Cloudy
6/4/2023 1:00,96,59,351547,46783,155,398330,SUNDAY,1,0,9.4,90,22.3,1021,Cloudy
6/4/2023 2:00,48,31,1226704,29885,79,1256589,SUNDAY,1,0,8.9,83,27.7,1020.1,Cloudy
6/4/2023 3:00,6,18,5124,17919,24,23043,SUNDAY,1,0,8.9,83,22.3,1019.7,Cloudy
6/4/2023 4:00,9,11,9575,8205,20,17780,SUNDAY,1,0,8.9,89,13,1018.8,Cloudy
6/4/2023 5:00,4,23,6012,15521,27,21533,SUNDAY,1,0,8.9,89,13,1018.8,Cloudy
6/4/2023 6:00,9,44,15243,46725,53,61968,SUNDAY,1,0,9.4,83,18.4,1017.2,Cloudy
6/4/2023 7:00,19,65,35198,61238,84,96436,SUNDAY,1,0,9.4,80,24.1,1016.8,Cloudy
6/4/2023 8:00,53,125,188507,104267,178,292774,SUNDAY,1,0,8.9,80,24.1,1016.7,Cloudy
6/4/2023 9:00,95,266,114392,186305,361,300697,SUNDAY,1,0,8.3,86,13,1016.7,Rain
6/4/2023 10:00,143,332,210557,243771,475,454328,SUNDAY,1,0,8.3,86,13,1016.7,Cloudy
6/4/2023 11:00,170,352,774199,286340,522,1060539,SUNDAY,1,0,8.9,73,22.3,1016.6,Cloudy
6/4/2023 12:00,189,406,2391124,327288,595,2718412,SUNDAY,1,0,8.9,73,22.3,1016.6,Cloudy
6/4/2023 13:00,178,385,3514743,309044,563,3823787,SUNDAY,1,0,10.6,71,22.3,1016.5,Cloudy
6/4/2023 14:00,182,321,346596,250018,503,596614,SUNDAY,1,0,11.1,69,25.9,1016.5,Cloudy
6/4/2023 15:00,178,403,600696,441333,581,1042029,SUNDAY,1,0,11.1,69,25.9,1016.5,Cloudy
6/4/2023 16:00,136,312,2479032,250057,448,2729089,SUNDAY,1,0,12.8,66,22.3,1016,Cloudy
6/4/2023 17:00,42,229,63136,185819,271,248955,SUNDAY,1,0,11.7,69,27.7,1015.8,Cloudy
6/4/2023 18:00,75,274,836142,537241,349,1373383,SUNDAY,1,0,10.6,80,27.7,1015.8,Cloudy
6/4/2023 19:00,39,163,86374,127542,202,213916,SUNDAY,1,0,10.6,80,25.9,1015.8,Cloudy
6/4/2023 20:00,26,123,646999,172557,149,819556,SUNDAY,1,0,10.6,86,24.1,1016,Cloudy
6/4/2023 21:00,24,85,22783,201491,109,224274,SUNDAY,1,0,10,89,22.3,1015.3,Rain
6/4/2023 22:00,32,92,119990,115087,124,235077,SUNDAY,1,0,10.6,89,18.4,1015.5,Cloudy
6/4/2023 23:00,12,50,26322,83869,62,110191,SUNDAY,1,0,10.6,86,22.3,1015.5,Rain
6/5/2023 0:00,22,30,27620,19070,52,46690,MONDAY,0,0,10.6,86,22.3,1015.5,Rain
6/5/2023 1:00,10,13,591516,12899,23,604415,MONDAY,0,0,10.6,89,22.3,1015.4,Rain
6/5/2023 2:00,3,5,2334,5890,8,8224,MONDAY,0,0,10.6,89,22.3,1015,Rain
6/5/2023 3:00,4,5,3192,3379,9,6571,MONDAY,0,0,10.6,89,22.3,1014.3,Rain
6/5/2023 4:00,1,5,2213,4019,6,6232,MONDAY,0,0,10.6,89,24.1,1014.3,Rain
6/5/2023 5:00,5,48,4952,35090,53,40042,MONDAY,0,0,10.6,89,20.5,1013.3,Rain
6/5/2023 6:00,19,134,27751,91242,153,118993,MONDAY,0,0,10.6,89,16.6,1012.2,Rain
6/5/2023 7:00,30,257,43573,185769,287,229342,MONDAY,0,0,10.6,89,16.6,1012.2,Rain
6/5/2023 8:00,48,509,51080,416497,557,467577,MONDAY,0,0,10.6,89,16.6,1011.6,Rain
6/5/2023 9:00,40,314,29358,244054,354,273412,MONDAY,0,0,10.6,89,18.4,1011.2,Rain
6/5/2023 10:00,36,207,38501,151467,243,189968,MONDAY,0,0,10.6,89,18.4,1011.2,Rain
6/5/2023 11:00,60,228,157474,170254,288,327728,MONDAY,0,0,11.1,89,14.8,1011.3,Rain
6/5/2023 12:00,71,326,222977,226113,397,449090,MONDAY,0,0,11.7,86,20.5,1011.2,Rain
6/5/2023 13:00,69,311,111590,553174,380,664764,MONDAY,0,0,12.2,86,20.5,1010.9,Rain
6/5/2023 14:00,99,315,113553,219067,414,332620,MONDAY,0,0,12.2,86,22.3,1010.9,Rain
6/5/2023 15:00,87,288,88431,220871,375,309302,MONDAY,0,0,13.3,77,20.5,1009.9,Rain
6/5/2023 16:00,142,612,842078,473075,754,1315153,MONDAY,0,0,14.4,75,20.5,1009.9,Rain
6/5/2023 17:00,185,883,224081,837023,1068,1061104,MONDAY,0,0,15,69,25.9,1009.6,Rain
6/5/2023 18:00,205,807,799689,1543865,1012,2343554,MONDAY,0,0,15,78,22.3,1009.2,Rain
6/5/2023 19:00,147,611,7928040,1132118,758,9060158,MONDAY,0,0,13.3,90,13,1008.5,Rain
6/5/2023 20:00,102,401,134049,305209,503,439258,MONDAY,0,0,13.9,87,7.6,1008.7,Cloudy
6/5/2023 21:00,74,292,128511,285609,366,414120,MONDAY,0,0,13.9,87,11.2,1008.2,Cloudy
6/5/2023 22:00,53,127,82442,139800,180,222242,MONDAY,0,0,15.6,83,0,1007.9,Cloudy
6/5/2023 23:00,32,85,31176,64822,117,95998,MONDAY,0,0,16.1,70,11.2,1007.9,Cloudy
6/6/2023 0:00,8,35,8194,27268,43,35462,TUESDAY,0,0,16.1,70,11.2,1007.9,Cloudy
6/6/2023 1:00,14,17,16104,13950,31,30054,TUESDAY,0,0,15.6,75,11.2,1007.7,Cloudy
6/6/2023 2:00,3,10,3700,7494,13,11194,TUESDAY,0,0,15,81,9.4,1007.2,Cloudy
6/6/2023 3:00,1,5,2050,5423,6,7473,TUESDAY,0,0,15.6,75,13,1006.6,Cloudy
6/6/2023 4:00,4,15,3551,10917,19,14468,TUESDAY,0,0,15,75,14.8,1005.8,Cloudy
6/6/2023 5:00,13,71,44189,53771,84,97960,TUESDAY,0,0,15,75,14.8,1005.8,Cloudy
6/6/2023 6:00,34,236,35383,176763,270,212146,TUESDAY,0,0,15,72,9.4,1004.9,Cloudy
6/6/2023 7:00,114,673,131310,679397,787,810707,TUESDAY,0,0,14.4,75,11.2,1004.5,Cloudy
6/6/2023 8:00,222,1188,409914,987175,1410,1397089,TUESDAY,0,0,13.9,74,16.6,1004,Cloudy
6/6/2023 9:00,105,637,643028,492424,742,1135452,TUESDAY,0,0,13.9,72,14.8,1003.8,Cloudy
6/6/2023 10:00,100,340,1482027,319109,440,1801136,TUESDAY,0,0,13.9,72,14.8,1003.8,Cloudy
6/6/2023 11:00,120,314,1094168,265908,434,1360076,TUESDAY,0,0,16.1,60,18.4,1002.9,Cloudy
6/6/2023 12:00,138,412,355899,316926,550,672825,TUESDAY,0,0,18.3,50,18.4,1002.5,Cloudy
6/6/2023 13:00,171,376,733108,264581,547,997689,TUESDAY,0,0,18.9,52,22.3,1001.8,Cloudy
6/6/2023 14:00,152,351,349267,316519,503,665786,TUESDAY,0,0,18.9,52,24.1,1001.8,Cloudy
6/6/2023 15:00,209,504,307813,448801,713,756614,TUESDAY,0,0,21.1,46,13,1000.7,Cloudy
6/6/2023 16:00,285,824,445403,3482339,1109,3927742,TUESDAY,0,0,22.2,41,18.4,1000.1,Cloudy
6/6/2023 17:00,388,1345,1910284,1260262,1733,3170546,TUESDAY,0,0,22.8,38,20.5,999.3,Cloudy
6/6/2023 18:00,339,971,1999557,816911,1310,2816468,TUESDAY,0,0,23.9,36,22.3,998.8,Cloudy
6/6/2023 19:00,213,686,302740,650799,899,953539,TUESDAY,0,0,23.3,36,22.3,998.4,Cloudy
6/6/2023 20:00,147,444,306572,365358,591,671930,TUESDAY,0,0,23.3,36,27.7,998.4,Cloudy
6/6/2023 21:00,106,305,1345954,433327,411,1779281,TUESDAY,0,0,22.8,34,24.1,998.7,Cloudy
6/6/2023 22:00,91,198,247264,193298,289,440562,TUESDAY,0,0,22.8,34,24.1,999.2,Cloudy
6/6/2023 23:00,55,101,79904,105086,156,184990,TUESDAY,0,0,15.6,72,13,999.8,Cloudy
6/7/2023 0:00,13,41,59977,29390,54,89367,WEDNESDAY,0,0,16.7,65,9.4,1000.6,Cloudy
6/7/2023 1:00,14,16,26801,11403,30,38204,WEDNESDAY,0,0,16.7,65,9.4,1000.6,Cloudy
6/7/2023 2:00,2,15,2269,14043,17,16312,WEDNESDAY,0,0,17.8,50,7.6,1000.7,Cloudy
6/7/2023 3:00,1,7,471,4622,8,5093,WEDNESDAY,0,0,17.2,50,20.5,1000.5,Cloudy
6/7/2023 4:00,7,15,6899,15661,22,22560,WEDNESDAY,0,0,16.1,54,16.6,1000.1,Fair
6/7/2023 5:00,11,90,9691,55622,101,65313,WEDNESDAY,0,0,16.1,54,16.6,1000.1,Fair
6/7/2023 6:00,46,258,60907,184929,304,245836,WEDNESDAY,0,0,14.4,67,16.6,999.2,Fair
6/7/2023 7:00,121,642,101918,487706,763,589624,WEDNESDAY,0,0,14.4,67,16.6,999.2,Fair
6/7/2023 8:00,199,1175,226703,945322,1374,1172025,WEDNESDAY,0,0,13.9,69,16.6,999.3,Cloudy
6/7/2023 9:00,128,649,234445,515505,777,749950,WEDNESDAY,0,0,13.9,69,16.6,999.3,Cloudy
6/7/2023 10:00,106,364,166494,726722,470,893216,WEDNESDAY,0,0,13.9,69,16.6,1000.1,Cloudy
6/7/2023 11:00,119,292,187922,252066,411,439988,WEDNESDAY,0,0,16.1,60,22.3,1000.2,Cloudy
6/7/2023 12:00,103,375,143751,272346,478,416097,WEDNESDAY,0,0,16.7,56,22.3,1000.1,Cloudy
6/7/2023 13:00,136,372,2179093,285871,508,2464964,WEDNESDAY,0,0,17.2,52,27.7,999.7,Cloudy
6/7/2023 14:00,129,386,237287,303576,515,540863,WEDNESDAY,0,0,17.2,52,25.9,999.7,Cloudy
6/7/2023 15:00,190,532,435096,408401,722,843497,WEDNESDAY,0,0,17.8,52,22.3,999.9,Cloudy
6/7/2023 16:00,255,768,379034,873990,1023,1253024,WEDNESDAY,0,0,17.2,52,20.5,1000.1,Cloudy
6/7/2023 17:00,349,1271,869940,1440714,1620,2310654,WEDNESDAY,0,0,18.3,50,20.5,1000.3,Cloudy
6/7/2023 18:00,312,896,517403,732694,1208,1250097,WEDNESDAY,0,0,17.2,52,20.5,1000.6,Cloudy
6/7/2023 19:00,217,635,1270262,514937,852,1785199,WEDNESDAY,0,0,17.2,52,20.5,1000.6,Cloudy
6/7/2023 20:00,151,462,399432,349381,613,748813,WEDNESDAY,0,0,18.3,50,16.6,1001.1,Cloudy
6/7/2023 21:00,117,304,174635,225071,421,399706,WEDNESDAY,0,0,17.2,52,16.6,1001.6,Cloudy
6/7/2023 22:00,80,205,109532,681520,285,791052,WEDNESDAY,0,0,17.2,52,16.6,1002,Cloudy
6/7/2023 23:00,48,106,509876,95287,154,605163,WEDNESDAY,0,0,17.2,52,14.8,1002.4,Cloudy
6/8/2023 0:00,18,40,22302,27882,58,50184,THURSDAY,0,0,17.2,52,14.8,1002.4,Rain
6/8/2023 1:00,16,25,103189,19076,41,122265,THURSDAY,0,0,15.6,60,13,1003.4,Cloudy
6/8/2023 2:00,2,17,2209,8656,19,10865,THURSDAY,0,0,15.6,60,14.8,1003.6,Cloudy
6/8/2023 3:00,3,4,15776,6389,7,22165,THURSDAY,0,0,15,62,11.2,1003.5,Cloudy
6/8/2023 4:00,5,13,44230,8393,18,52623,THURSDAY,0,0,14.4,65,9.4,1003.7,Cloudy
6/8/2023 5:00,18,75,16327,49140,93,65467,THURSDAY,0,0,14.4,65,9.4,1003.7,Cloudy
6/8/2023 6:00,46,231,38154,166063,277,204217,THURSDAY,0,0,13.9,67,11.2,1003.5,Cloudy
6/8/2023 7:00,98,606,640178,461630,704,1101808,THURSDAY,0,0,13.3,69,13,1003.6,Cloudy
6/8/2023 8:00,184,1106,408281,895081,1290,1303362,THURSDAY,0,0,13.3,72,13,1003.7,Cloudy
6/8/2023 9:00,104,631,89724,445364,735,535088,THURSDAY,0,0,13.3,72,13,1003.7,Cloudy
6/8/2023 10:00,91,333,262508,226494,424,489002,THURSDAY,0,0,13.3,72,9.4,1004.9,Cloudy
6/8/2023 11:00,121,352,1058746,259817,473,1318563,THURSDAY,0,0,13.9,69,11.2,1005.4,Cloudy
6/8/2023 12:00,143,413,239544,318154,556,557698,THURSDAY,0,0,13.9,69,7.6,1005.9,Cloudy
6/8/2023 13:00,163,381,415053,288906,544,703959,THURSDAY,0,0,14.4,67,7.6,1006,Cloudy
6/8/2023 14:00,205,391,842911,384635,596,1227546,THURSDAY,0,0,14.4,67,7.6,1006,Cloudy
6/8/2023 15:00,182,534,256074,464025,716,720099,THURSDAY,0,0,16.1,65,5.4,1005.9,Cloudy
6/8/2023 16:00,280,817,2303752,698411,1097,3002163,THURSDAY,0,0,18.3,52,0,1005.4,Cloudy
6/8/2023 17:00,385,1155,613357,1047433,1540,1660790,THURSDAY,0,0,17.8,60,14.8,1004.9,Cloudy
6/8/2023 18:00,309,953,2122964,1244117,1262,3367081,THURSDAY,0,0,17.8,60,16.6,1004.8,Cloudy
6/8/2023 19:00,245,648,935002,1693379,893,2628381,THURSDAY,0,0,17.8,60,16.6,1004.8,Cloudy
6/8/2023 20:00,185,448,3464797,387022,633,3851819,THURSDAY,0,0,16.7,75,7.6,1005.1,Cloudy
6/8/2023 21:00,144,317,943355,260202,461,1203557,THURSDAY,0,0,17.8,56,16.6,1005,Cloudy
6/8/2023 22:00,102,200,157259,177236,302,334495,THURSDAY,0,0,17.8,52,13,1005.5,Cloudy
6/8/2023 23:00,63,116,80465,81725,179,162190,THURSDAY,0,0,17.8,52,13,1005.5,Cloudy
6/9/2023 0:00,41,58,91086,47487,99,138573,FRIDAY,0,0,15,78,9.4,1006.1,Cloudy
6/9/2023 1:00,37,26,828318,19810,63,848128,FRIDAY,0,0,14.4,81,0,1006.5,Cloudy
6/9/2023 2:00,14,15,83977,17016,29,100993,FRIDAY,0,0,14.4,81,0,1006.5,Cloudy
6/9/2023 3:00,3,6,2934,3393,9,6327,FRIDAY,0,0,15,67,9.4,1006.4,Cloudy
6/9/2023 4:00,6,9,3749,10428,15,14177,FRIDAY,0,0,14.4,72,9.4,1006.2,Cloudy
6/9/2023 5:00,17,69,34943,46960,86,81903,FRIDAY,0,0,14.4,72,9.4,1006.2,Cloudy
6/9/2023 6:00,34,208,38317,150702,242,189019,FRIDAY,0,0,13.3,80,11.2,1005.8,Cloudy
6/9/2023 7:00,73,463,78533,392107,536,470640,FRIDAY,0,0,12.2,86,5.4,1005.8,Cloudy
6/9/2023 8:00,134,883,189338,2191195,1017,2380533,FRIDAY,0,0,12.2,86,5.4,1005.8,Cloudy
6/9/2023 9:00,189,603,269459,480245,792,749704,FRIDAY,0,0,12.2,86,11.2,1006,Cloudy
6/9/2023 10:00,182,341,1502040,258472,523,1760512,FRIDAY,0,0,13.3,84,5.4,1006.8,Cloudy
6/9/2023 11:00,174,386,446004,347397,560,793401,FRIDAY,0,0,13.3,84,5.4,1006.8,Cloudy
6/9/2023 12:00,213,400,1665400,318476,613,1983876,FRIDAY,0,0,15,78,5.4,1007.3,Cloudy
6/9/2023 13:00,157,362,787444,274704,519,1062148,FRIDAY,0,0,16.1,78,11.2,1007.1,Cloudy
6/9/2023 14:00,212,383,2306660,590935,595,2897595,FRIDAY,0,0,16.1,78,11.2,1007.1,Cloudy
6/9/2023 15:00,167,393,338600,330598,560,669198,FRIDAY,0,0,16.7,65,11.2,1006.9,Cloudy
6/9/2023 16:00,127,450,969715,3530111,577,4499826,FRIDAY,0,0,16.1,75,14.8,1006.6,Cloudy
6/9/2023 17:00,181,731,239441,2678590,912,2918031,FRIDAY,0,0,16.1,78,20.5,1006.4,Cloudy
6/9/2023 18:00,145,483,241121,823501,628,1064622,FRIDAY,0,0,15.6,80,14.8,1006,Cloudy
6/9/2023 19:00,168,406,317469,335687,574,653156,FRIDAY,0,0,15.6,80,14.8,1006,Cloudy
6/9/2023 20:00,152,347,439282,299322,499,738604,FRIDAY,0,0,15,81,7.6,1006.1,Rain
6/9/2023 21:00,114,292,1266222,1495547,406,2761769,FRIDAY,0,0,14.4,90,7.6,1005.9,Rain
6/9/2023 22:00,118,192,1245744,285185,310,1530929,FRIDAY,0,0,14.4,90,7.6,1006.2,Rain
6/9/2023 23:00,102,178,192218,257659,280,449877,FRIDAY,0,0,14.4,90,7.6,1006.2,Cloudy
6/10/2023 0:00,116,134,3969085,107719,250,4076804,SATURDAY,1,0,13.3,93,7.6,1006.9,Cloudy
6/10/2023 1:00,131,87,443917,75668,218,519585,SATURDAY,1,0,13.9,93,7.6,1007.1,Cloudy
6/10/2023 2:00,56,49,276376,44202,105,320578,SATURDAY,1,0,13.9,93,0,1006.9,Cloudy
6/10/2023 3:00,9,17,2610441,13250,26,2623691,SATURDAY,1,0,13.9,93,0,1006.9,Cloudy
6/10/2023 4:00,7,10,9025,11272,17,20297,SATURDAY,1,0,12.8,96,5.4,1006.6,Cloudy
6/10/2023 5:00,14,27,33506,131545,41,165051,SATURDAY,1,0,12.8,100,5.4,1006,Cloudy
6/10/2023 6:00,20,54,37172,38318,74,75490,SATURDAY,1,0,12.8,96,0,1005.6,Cloudy
6/10/2023 7:00,41,132,60867,240414,173,301281,SATURDAY,1,0,12.8,96,0,1005.7,Cloudy
6/10/2023 8:00,92,215,239189,186731,307,425920,SATURDAY,1,0,12.8,93,5.4,1005.8,Cloudy
6/10/2023 9:00,149,373,370251,608121,522,978372,SATURDAY,1,0,12.8,93,5.4,1005.8,Cloudy
6/10/2023 10:00,258,429,790336,466614,687,1256950,SATURDAY,1,0,12.8,93,5.4,1006.5,Cloudy
6/10/2023 11:00,354,522,1076309,548022,876,1624331,SATURDAY,1,0,13.9,90,7.6,1006.8,Cloudy
6/10/2023 12:00,412,536,1141312,601195,948,1742507,SATURDAY,1,0,13.9,90,7.6,1006.8,Cloudy
6/10/2023 13:00,422,533,2104243,1751425,955,3855668,SATURDAY,1,0,15,83,7.6,1007.1,Cloudy
6/10/2023 14:00,175,273,996527,246761,448,1243288,SATURDAY,1,0,15,83,5.4,1007.6,Cloudy
6/10/2023 15:00,209,326,468252,301971,535,770223,SATURDAY,1,0,16.1,81,11.2,1007.3,Cloudy
6/10/2023 16:00,346,459,1199386,1499140,805,2698526,SATURDAY,1,0,16.1,81,11.2,1007.3,Cloudy
6/10/2023 17:00,417,554,2511867,580798,971,3092665,SATURDAY,1,0,16.7,78,16.6,1007,Cloudy
6/10/2023 18:00,432,540,3644025,600817,972,4244842,SATURDAY,1,0,14.4,87,9.4,1007,Cloudy
6/10/2023 19:00,245,394,845464,362943,639,1208407,SATURDAY,1,0,16.1,87,16.6,1007.5,Cloudy
6/10/2023 20:00,84,158,110372,151640,242,262012,SATURDAY,1,0,16.7,78,11.2,1007.5,Cloudy
6/10/2023 21:00,100,166,161254,148159,266,309413,SATURDAY,1,0,17.8,73,9.4,1007.8,Cloudy
6/10/2023 22:00,117,161,270655,141006,278,411661,SATURDAY,1,0,18.3,68,7.6,1008.2,Fair
6/10/2023 23:00,80,143,1026442,175118,223,1201560,SATURDAY,1,0,18.3,68,7.6,1008.2,Cloudy
6/11/2023 0:00,104,119,2499092,92049,223,2591141,SUNDAY,1,0,15.6,83,13,1009.3,Cloudy
6/11/2023 1:00,143,86,1182455,76060,229,1258515,SUNDAY,1,0,15.6,83,9.4,1010.1,Fair
6/11/2023 2:00,94,41,340701,41527,135,382228,SUNDAY,1,0,15.6,80,13,1010.2,Fair
6/11/2023 3:00,7,14,454569,10649,21,465218,SUNDAY,1,0,15.6,80,13,1010.2,Fair
6/11/2023 4:00,10,15,23502,13407,25,36909,SUNDAY,1,0,16.1,75,5.4,1010.3,Fair
6/11/2023 5:00,4,18,5093,22636,22,27729,SUNDAY,1,0,15.6,80,7.6,1010.6,Fair
6/11/2023 6:00,20,49,32981,35705,69,68686,SUNDAY,1,0,14.4,87,9.4,1010.8,Fair
6/11/2023 7:00,31,111,67844,91428,142,159272,SUNDAY,1,0,14.4,87,7.6,1011,Fair
6/11/2023 8:00,91,196,145985,165974,287,311959,SUNDAY,1,0,14.4,87,7.6,1011,Fair
6/11/2023 9:00,161,302,2225915,284038,463,2509953,SUNDAY,1,0,13.9,90,0,1012,Fair
6/11/2023 10:00,310,432,699456,379572,742,1079028,SUNDAY,1,0,16.1,75,5.4,1012.2,Fair
6/11/2023 11:00,396,507,969923,589935,903,1559858,SUNDAY,1,0,18.3,68,7.6,1012.4,Fair
6/11/2023 12:00,447,622,950228,692419,1069,1642647,SUNDAY,1,0,18.3,73,7.6,1012.6,Fair
6/11/2023 13:00,516,605,1269923,647665,1121,1917588,SUNDAY,1,0,20.6,63,7.6,1012.5,Fair
6/11/2023 14:00,548,668,4604143,706095,1216,5310238,SUNDAY,1,0,20.6,63,7.6,1012.5,Fair
6/11/2023 15:00,541,676,1934791,694266,1217,2629057,SUNDAY,1,0,22.2,53,13,1012.5,Cloudy
6/11/2023 16:00,538,657,4450956,672200,1195,5123156,SUNDAY,1,0,22.2,53,13,1012.5,Cloudy
6/11/2023 17:00,506,674,2567870,2161674,1180,4729544,SUNDAY,1,0,22.2,49,18.4,1012.2,Cloudy
6/11/2023 18:00,414,593,3329351,577014,1007,3906365,SUNDAY,1,0,22.2,49,25.9,1012.2,Cloudy
6/11/2023 19:00,319,506,818269,473361,825,1291630,SUNDAY,1,0,22.8,50,29.5,1011.6,Cloudy
6/11/2023 20:00,250,342,469648,333667,592,803315,SUNDAY,1,0,21.7,53,18.4,1011.5,Cloudy
6/11/2023 21:00,140,238,260069,213472,378,473541,SUNDAY,1,0,20.6,63,16.6,1011.2,Cloudy
6/11/2023 22:00,107,160,1710796,153294,267,1864090,SUNDAY,1,0,22.2,61,14.8,1011.4,Cloudy
6/11/2023 23:00,44,92,95354,74025,136,169379,SUNDAY,1,0,22.2,61,14.8,1011.4,Cloudy
6/12/2023 0:00,27,28,695105,53376,55,748481,MONDAY,0,0,21.1,59,14.8,1012,Cloudy
6/12/2023 1:00,11,23,5976,18808,34,24784,MONDAY,0,0,20,65,13,1012.4,Cloudy
6/12/2023 2:00,6,10,53808,7778,16,61586,MONDAY,0,0,20,65,13,1012.4,Cloudy
6/12/2023 3:00,6,7,12677,5766,13,18443,MONDAY,0,0,18.9,70,14.8,1012.4,Cloudy
6/12/2023 4:00,1,12,1040,12374,13,13414,MONDAY,0,0,18.9,70,14.8,1012.4,Cloudy
6/12/2023 5:00,15,78,12377,50088,93,62465,MONDAY,0,0,18.3,76,16.6,1011.9,Cloudy
6/12/2023 6:00,28,212,20487,168031,240,188518,MONDAY,0,0,17.2,81,9.4,1011.7,Cloudy
6/12/2023 7:00,92,602,138710,448819,694,587529,MONDAY,0,0,17.2,84,11.2,1011.6,Cloudy
6/12/2023 8:00,175,1045,198695,864698,1220,1063393,MONDAY,0,0,17.2,84,11.2,1011.6,Cloudy
6/12/2023 9:00,108,566,995750,420150,674,1415900,MONDAY,0,0,17.2,90,7.6,1011.6,Cloudy
6/12/2023 10:00,113,300,287750,1825283,413,2113033,MONDAY,0,0,17.8,87,7.6,1011.9,Rain
6/12/2023 11:00,143,333,264598,242072,476,506670,MONDAY,0,0,18.9,84,14.8,1012,Cloudy
6/12/2023 12:00,168,345,378457,383695,513,762152,MONDAY,0,0,19.4,84,13,1012,Cloudy
6/12/2023 13:00,183,341,1715894,352905,524,2068799,MONDAY,0,0,19.4,84,13,1012,Cloudy
6/12/2023 14:00,174,372,1117626,504014,546,1621640,MONDAY,0,0,23.9,71,13,1011.6,Cloudy
6/12/2023 15:00,248,475,1955878,471516,723,2427394,MONDAY,0,0,26.1,58,20.5,1011.2,Cloudy
6/12/2023 16:00,288,804,693949,1297220,1092,1991169,MONDAY,0,0,26.7,51,20.5,1010.8,Cloudy
6/12/2023 17:00,401,1278,759742,2220169,1679,2979911,MONDAY,0,0,26.1,56,20.5,1010.4,Cloudy
6/12/2023 18:00,369,1063,2379627,926429,1432,3306056,MONDAY,0,0,26.1,56,20.5,1010.4,Cloudy
6/12/2023 19:00,334,730,671659,591776,1064,1263435,MONDAY,0,0,25,58,18.4,1009.2,Cloudy
6/12/2023 20:00,217,561,2119648,506991,778,2626639,MONDAY,0,0,22.8,71,18.4,1008.4,Cloudy
6/12/2023 21:00,141,313,200473,265245,454,465718,MONDAY,0,0,20,78,25.9,1008.1,Cloudy
6/12/2023 22:00,37,72,2207503,53489,109,2260992,MONDAY,0,0,20,78,24.1,1008.1,Cloudy
6/12/2023 23:00,27,81,688600,59606,108,748206,MONDAY,0,0,21.1,61,18.4,1008.4,Cloudy
6/13/2023 0:00,23,40,665629,34313,63,699942,TUESDAY,0,0,18.3,87,20.5,1008.3,Cloudy
6/13/2023 1:00,4,15,3206,10854,19,14060,TUESDAY,0,0,18.3,87,20.5,1008.3,Cloudy
6/13/2023 2:00,2,6,131924,27409,8,159333,TUESDAY,0,0,17.2,90,22.3,1007.8,Cloudy
6/13/2023 3:00,3,4,90907,2800,7,93707,TUESDAY,0,0,16.7,100,16.6,1007.3,Cloudy
6/13/2023 4:00,7,12,22368,11264,19,33632,TUESDAY,0,0,17.8,96,14.8,1006.1,Cloudy
6/13/2023 5:00,9,74,7248,50152,83,57400,TUESDAY,0,0,17.2,100,13,1006.1,Cloudy
6/13/2023 6:00,35,215,22223,159336,250,181559,TUESDAY,0,0,17.2,97,20.5,1005.2,Rain
6/13/2023 7:00,105,613,123812,494258,718,618070,TUESDAY,0,0,16.1,100,18.4,1004.5,Cloudy
6/13/2023 8:00,205,1224,221436,1804345,1429,2025781,TUESDAY,0,0,16.7,100,16.6,1004.5,Cloudy
6/13/2023 9:00,109,624,334931,552387,733,887318,TUESDAY,0,0,16.1,100,24.1,1004.1,Cloudy
6/13/2023 10:00,83,316,327191,263137,399,590328,TUESDAY,0,0,16.1,100,24.1,1004.1,Cloudy
6/13/2023 11:00,124,305,301213,255835,429,557048,TUESDAY,0,0,16.1,100,18.4,1004.4,Cloudy
6/13/2023 12:00,122,362,186191,469559,484,655750,TUESDAY,0,0,16.7,96,20.5,1004.8,Cloudy
6/13/2023 13:00,174,366,1212336,293296,540,1505632,TUESDAY,0,0,16.7,96,20.5,1004.8,Cloudy
6/13/2023 14:00,182,427,377347,443833,609,821180,TUESDAY,0,0,16.7,100,9.4,1004.9,Cloudy
6/13/2023 15:00,156,140,397103,115731,296,512834,TUESDAY,0,0,16.7,100,9.4,1004.9,Cloudy
6/13/2023 16:00,283,659,438677,546724,942,985401,TUESDAY,0,0,20.6,84,14.8,1004.5,Cloudy
6/13/2023 17:00,536,1467,852445,1304501,2003,2156946,TUESDAY,0,0,20,84,16.6,1004.4,Cloudy
6/13/2023 18:00,404,1045,2663323,994910,1449,3658233,TUESDAY,0,0,20.6,84,16.6,1004.1,Cloudy
6/13/2023 19:00,281,733,757897,666057,1014,1423954,TUESDAY,0,0,20,84,20.5,1003.3,Cloudy
6/13/2023 20:00,210,492,1054087,394162,702,1448249,TUESDAY,0,0,20,84,20.5,1003.3,Cloudy
6/13/2023 21:00,155,362,302339,345409,517,647748,TUESDAY,0,0,19.4,87,16.6,1003.4,Cloudy
6/13/2023 22:00,123,215,289039,178052,338,467091,TUESDAY,0,0,19.4,87,18.4,1003.7,Cloudy
6/13/2023 23:00,85,119,148194,155463,204,303657,TUESDAY,0,0,17.2,93,20.5,1003.6,Cloudy
6/14/2023 0:00,17,29,21885,19433,46,41318,WEDNESDAY,0,0,17.2,93,16.6,1004.3,Cloudy
6/14/2023 1:00,16,16,52630,8622,32,61252,WEDNESDAY,0,0,17.2,93,16.6,1004.3,Cloudy
6/14/2023 2:00,7,10,30138,9666,17,39804,WEDNESDAY,0,0,16.1,93,9.4,1004.5,Cloudy
6/14/2023 3:00,2,5,1876,3846,7,5722,WEDNESDAY,0,0,16.1,93,9.4,1004.5,Cloudy
6/14/2023 4:00,4,12,10740,7080,16,17820,WEDNESDAY,0,0,15.6,93,13,1003.7,Cloudy
6/14/2023 5:00,21,85,23975,55764,106,79739,WEDNESDAY,0,0,15.6,90,11.2,1003.7,Cloudy
6/14/2023 6:00,59,273,65910,220901,332,286811,WEDNESDAY,0,0,15.6,93,7.6,1003.8,Cloudy
6/14/2023 7:00,132,733,135279,634237,865,769516,WEDNESDAY,0,0,16.1,93,5.4,1003.5,Cloudy
6/14/2023 8:00,233,1293,349504,2187380,1526,2536884,WEDNESDAY,0,0,16.1,93,5.4,1003.5,Cloudy
6/14/2023 9:00,147,666,282581,577139,813,859720,WEDNESDAY,0,0,16.7,90,5.4,1003.4,Cloudy
6/14/2023 10:00,139,344,4057948,273625,483,4331573,WEDNESDAY,0,0,16.7,90,5.4,1003.7,Cloudy
6/14/2023 11:00,129,344,568251,980344,473,1548595,WEDNESDAY,0,0,16.7,90,5.4,1003.7,Cloudy
6/14/2023 12:00,174,436,1486082,1056883,610,2542965,WEDNESDAY,0,0,17.2,87,9.4,1004,Cloudy
6/14/2023 13:00,203,412,373063,334993,615,708056,WEDNESDAY,0,0,20,78,14.8,1003.2,Cloudy
6/14/2023 14:00,178,417,284114,341815,595,625929,WEDNESDAY,0,0,18.9,81,18.4,1003,Cloudy
6/14/2023 15:00,257,556,391595,464461,813,856056,WEDNESDAY,0,0,19.4,81,20.5,1002.5,Cloudy
6/14/2023 16:00,322,906,459430,835035,1228,1294465,WEDNESDAY,0,0,19.4,81,20.5,1002.1,Cloudy
6/14/2023 17:00,478,1455,3073896,1230486,1933,4304382,WEDNESDAY,0,0,19.4,81,20.5,1002.1,Cloudy
6/14/2023 18:00,251,798,971842,788899,1049,1760741,WEDNESDAY,0,0,18.3,84,20.5,1000.7,Cloudy
6/14/2023 19:00,55,243,50055,208893,298,258948,WEDNESDAY,0,0,25.6,47,20.5,1000.1,Cloudy
6/14/2023 20:00,47,199,55710,159371,246,215081,WEDNESDAY,0,0,23.9,54,29.5,999.9,Cloudy
6/14/2023 21:00,67,220,89589,172478,287,262067,WEDNESDAY,0,0,23.9,54,29.5,1000,Rain
6/14/2023 22:00,87,194,135598,215459,281,351057,WEDNESDAY,0,0,20.6,68,27.7,999.4,Cloudy
6/14/2023 23:00,60,105,131013,75829,165,206842,WEDNESDAY,0,0,21.1,78,22.3,999.2,Cloudy
6/15/2023 0:00,28,45,52822,35195,73,88017,THURSDAY,0,0,17.2,90,9.4,999.1,Cloudy
6/15/2023 1:00,9,21,11937,16469,30,28406,THURSDAY,0,0,17.2,90,9.4,999.1,Cloudy
6/15/2023 2:00,7,15,12578,9308,22,21886,THURSDAY,0,0,16.1,97,11.2,998.5,Cloudy
6/15/2023 3:00,3,7,7160,6118,10,13278,THURSDAY,0,0,16.1,97,11.2,998.5,Cloudy
6/15/2023 4:00,2,8,680,7917,10,8597,THURSDAY,0,0,17.2,93,7.6,997.9,Cloudy
6/15/2023 5:00,20,83,21720,62789,103,84509,THURSDAY,0,0,17.2,87,13,997.6,Cloudy
6/15/2023 6:00,53,264,542012,211224,317,753236,THURSDAY,0,0,16.7,86,14.8,997.4,Cloudy
6/15/2023 7:00,121,646,113452,1565076,767,1678528,THURSDAY,0,0,16.1,87,13,997.3,Cloudy
6/15/2023 8:00,218,1179,223067,948312,1397,1171379,THURSDAY,0,0,16.1,87,13,997.3,Cloudy
6/15/2023 9:00,148,699,170785,2222386,847,2393171,THURSDAY,0,0,16.7,84,14.8,997.8,Cloudy
6/15/2023 10:00,130,354,260147,330316,484,590463,THURSDAY,0,0,16.7,84,14.8,997.8,Cloudy
6/15/2023 11:00,170,362,361289,323514,532,684803,THURSDAY,0,0,17.2,81,16.6,998.2,Cloudy
6/15/2023 12:00,171,395,321704,289980,566,611684,THURSDAY,0,0,17.2,84,18.4,998.9,Cloudy
6/15/2023 13:00,190,417,1935159,320105,607,2255264,THURSDAY,0,0,18.9,75,9.4,1000.4,Cloudy
6/15/2023 14:00,268,425,5813121,358667,693,6171788,THURSDAY,0,0,20.6,66,9.4,1000.4,Cloudy
6/15/2023 15:00,255,549,549888,463734,804,1013622,THURSDAY,0,0,21.1,61,11.2,1000.7,Cloudy
6/15/2023 16:00,322,927,2185293,792084,1249,2977377,THURSDAY,0,0,23.3,56,14.8,1000.9,Cloudy
6/15/2023 17:00,508,1315,2387596,2669088,1823,5056684,THURSDAY,0,0,23.3,56,14.8,1000.9,Cloudy
6/15/2023 18:00,486,1068,1536678,2210818,1554,3747496,THURSDAY,0,0,25,48,11.2,1000.6,Cloudy
6/15/2023 19:00,376,847,3419996,884473,1223,4304469,THURSDAY,0,0,25.6,45,16.6,1000.5,Cloudy
6/15/2023 20:00,306,577,1662329,612110,883,2274439,THURSDAY,0,0,26.1,44,16.6,1000.3,Cloudy
6/15/2023 21:00,224,394,3673492,337705,618,4011197,THURSDAY,0,0,26.1,45,18.4,1000.7,Cloudy
6/15/2023 22:00,151,245,569638,223917,396,793555,THURSDAY,0,0,26.1,45,18.4,1000.7,Fair
6/15/2023 23:00,67,137,190409,125973,204,316382,THURSDAY,0,0,25.6,42,14.8,1002,Cloudy
6/16/2023 0:00,36,54,233907,44023,90,277930,FRIDAY,0,0,24.4,47,11.2,1002.6,Fair
6/16/2023 1:00,48,36,404959,33117,84,438076,FRIDAY,0,0,24.4,47,13,1003.5,Fair
6/16/2023 2:00,23,14,21721,10330,37,32051,FRIDAY,0,0,24.4,47,13,1003.5,Fair
6/16/2023 3:00,8,10,15539,9712,18,25251,FRIDAY,0,0,22.8,57,16.6,1003.8,Fair
6/16/2023 4:00,11,25,12452,19187,36,31639,FRIDAY,0,0,21.1,66,14.8,1004,Fair
6/16/2023 5:00,24,71,81537,53512,95,135049,FRIDAY,0,0,20.6,66,14.8,1004.3,Fair
6/16/2023 6:00,38,229,73437,173075,267,246512,FRIDAY,0,0,20.6,66,18.4,1004.7,Fair
6/16/2023 7:00,101,486,2213690,389789,587,2603479,FRIDAY,0,0,19.4,71,14.8,1004.7,Fair
6/16/2023 8:00,185,845,2073552,636359,1030,2709911,FRIDAY,0,0,18.9,70,16.6,1005,Fair
6/16/2023 9:00,154,573,212566,417266,727,629832,FRIDAY,0,0,18.9,70,16.6,1005,Fair
6/16/2023 10:00,145,384,384741,309198,529,693939,FRIDAY,0,0,20,65,18.4,1005.7,Fair
6/16/2023 11:00,230,403,1312356,323266,633,1635622,FRIDAY,0,0,21.7,61,16.6,1006.2,Fair
6/16/2023 12:00,243,469,2029243,1460738,712,3489981,FRIDAY,0,0,21.7,61,16.6,1006.2,Fair
6/16/2023 13:00,267,519,2477170,657986,786,3135156,FRIDAY,0,0,25,48,13,1006.2,Fair
6/16/2023 14:00,346,518,1148033,442420,864,1590453,FRIDAY,0,0,23.9,58,13,1006.5,Fair
6/16/2023 15:00,348,624,3320945,567159,972,3888104,FRIDAY,0,0,24.4,54,16.6,1006.3,Fair
6/16/2023 16:00,377,845,3395369,783087,1222,4178456,FRIDAY,0,0,24.4,54,16.6,1006.3,Fair
6/16/2023 17:00,475,964,4232543,880813,1439,5113356,FRIDAY,0,0,24.4,56,16.6,1005.2,Cloudy
6/16/2023 18:00,404,840,3117258,1017961,1244,4135219,FRIDAY,0,0,21.7,63,25.9,1005.1,Cloudy
6/16/2023 19:00,309,594,681503,633560,903,1315063,FRIDAY,0,0,21.7,63,20.5,1004.9,Cloudy
6/16/2023 20:00,220,433,3246258,359534,653,3605792,FRIDAY,0,0,22.2,64,16.6,1004.8,Cloudy
6/16/2023 21:00,243,308,2142054,324194,551,2466248,FRIDAY,0,0,21.7,71,5.4,1004.4,Cloudy
6/16/2023 22:00,300,309,4847547,323673,609,5171220,FRIDAY,0,0,21.7,71,5.4,1004.4,Cloudy
6/16/2023 23:00,178,200,1038941,155661,378,1194602,FRIDAY,0,0,22.8,61,18.4,1004.5,Cloudy
6/17/2023 0:00,144,127,1040124,683051,271,1723175,SATURDAY,1,0,21.7,63,18.4,1004.3,Cloudy
6/17/2023 1:00,204,123,2553128,148700,327,2701828,SATURDAY,1,0,22.2,59,11.2,1004.8,Cloudy
6/17/2023 2:00,80,64,143871,73102,144,216973,SATURDAY,1,0,22.2,59,11.2,1004.8,Cloudy
6/17/2023 3:00,32,9,892883,7754,41,900637,SATURDAY,1,0,20.6,66,9.4,1005.2,Rain
6/17/2023 4:00,6,14,7388,14293,20,21681,SATURDAY,1,0,19.4,73,11.2,1004.6,Rain
6/17/2023 5:00,2,21,480824,21184,23,502008,SATURDAY,1,0,18.9,75,7.6,1003.6,Rain
6/17/2023 6:00,21,55,427872,47391,76,475263,SATURDAY,1,0,19.4,73,0,1003.3,Rain
6/17/2023 7:00,25,113,29737,89409,138,119146,SATURDAY,1,0,19.4,73,0,1003.3,Rain
6/17/2023 8:00,57,181,99635,154764,238,254399,SATURDAY,1,0,18.3,87,0,1003.3,Rain
6/17/2023 9:00,88,218,137733,441586,306,579319,SATURDAY,1,0,17.8,90,5.4,1003.3,Rain
6/17/2023 10:00,133,277,252534,1166438,410,1418972,SATURDAY,1,0,17.8,90,5.4,1003.3,Rain
6/17/2023 11:00,101,269,138996,288057,370,427053,SATURDAY,1,0,17.8,90,7.6,1002.9,Rain
6/17/2023 12:00,93,256,175147,348761,349,523908,SATURDAY,1,0,17.8,90,14.8,1003,Rain
6/17/2023 13:00,55,158,89771,260273,213,350044,SATURDAY,1,0,17.8,90,14.8,1003,Rain
6/17/2023 14:00,21,96,21269,65806,117,87075,SATURDAY,1,0,18.3,87,9.4,1002.9,Rain
6/17/2023 15:00,57,161,403814,133191,218,537005,SATURDAY,1,0,18.3,84,9.4,1002.6,Rain
6/17/2023 16:00,104,267,276450,213414,371,489864,SATURDAY,1,0,17.2,97,13,1002.3,Rain
6/17/2023 17:00,104,188,472949,324004,292,796953,SATURDAY,1,0,17.2,97,13,1002.3,Rain
6/17/2023 18:00,20,80,42061,109960,100,152021,SATURDAY,1,0,16.7,93,11.2,1002.1,Rain
6/17/2023 19:00,25,88,54169,61092,113,115261,SATURDAY,1,0,16.7,96,13,1002.3,Cloudy
6/17/2023 20:00,16,58,257017,90995,74,348012,SATURDAY,1,0,16.7,93,20.5,1002.1,Rain
6/17/2023 21:00,17,67,26151,43375,84,69526,SATURDAY,1,0,16.1,93,24.1,1002.2,Rain
6/17/2023 22:00,26,54,1402642,34069,80,1436711,SATURDAY,1,0,14.4,93,24.1,1003,Rain
6/17/2023 23:00,26,41,23456,35034,67,58490,SATURDAY,1,0,14.4,93,24.1,1003,Rain
6/18/2023 0:00,31,45,113166,33647,76,146813,SUNDAY,1,0,14.4,93,18.4,1003.6,Rain
6/18/2023 1:00,52,43,64172,54278,95,118450,SUNDAY,1,0,14.4,97,13,1004,Rain
6/18/2023 2:00,36,24,62626,29557,60,92183,SUNDAY,1,0,15,93,9.4,1004.5,Rain
6/18/2023 3:00,5,16,8635,10978,21,19613,SUNDAY,1,0,15,93,14.8,1004.6,Rain
6/18/2023 4:00,7,10,23633,11142,17,34775,SUNDAY,1,0,15,93,14.8,1004.6,Rain
6/18/2023 5:00,5,22,7741,19473,27,27214,SUNDAY,1,0,15.6,90,18.4,1004.4,Rain
6/18/2023 6:00,22,60,208281,50767,82,259048,SUNDAY,1,0,15.6,93,14.8,1004,Rain
6/18/2023 7:00,33,97,43442,76043,130,119485,SUNDAY,1,0,15.6,93,14.8,1004,Rain
6/18/2023 8:00,75,173,170765,130533,248,301298,SUNDAY,1,0,15.6,90,18.4,1004.4,Rain
6/18/2023 9:00,145,279,1423696,243159,424,1666855,SUNDAY,1,0,15.6,90,16.6,1005,Cloudy
6/18/2023 10:00,228,376,525881,356285,604,882166,SUNDAY,1,0,15.6,90,16.6,1005,Cloudy
6/18/2023 11:00,174,323,748140,304191,497,1052331,SUNDAY,1,0,16.7,86,14.8,1006.5,Cloudy
6/18/2023 12:00,237,355,862112,564471,592,1426583,SUNDAY,1,0,16.7,86,14.8,1006.5,Cloudy
6/18/2023 13:00,236,383,2918697,350962,619,3269659,SUNDAY,1,0,17.2,75,11.2,1007.5,Cloudy
6/18/2023 14:00,336,408,2212425,1786780,744,3999205,SUNDAY,1,0,18.3,76,11.2,1007.9,Cloudy
6/18/2023 15:00,381,503,1557086,490765,884,2047851,SUNDAY,1,0,18.3,76,11.2,1007.9,Cloudy
6/18/2023 16:00,477,572,3540536,925871,1049,4466407,SUNDAY,1,0,17.8,75,9.4,1008.5,Cloudy
6/18/2023 17:00,479,621,4160142,1343633,1100,5503775,SUNDAY,1,0,17.2,87,13,1009.2,Cloudy
6/18/2023 18:00,422,571,2695388,571807,993,3267195,SUNDAY,1,0,17.8,78,20.5,1009.7,Cloudy
6/18/2023 19:00,305,449,689895,433904,754,1123799,SUNDAY,1,0,17.2,81,16.6,1010.5,Cloudy
6/18/2023 20:00,199,330,2735239,278473,529,3013712,SUNDAY,1,0,18.3,76,13,1010.8,Cloudy
6/18/2023 21:00,164,229,547203,1398682,393,1945885,SUNDAY,1,0,18.3,76,13,1010.8,Cloudy
6/18/2023 22:00,158,186,1357292,196379,344,1553671,SUNDAY,1,0,17.2,75,14.8,1011.6,Cloudy
6/18/2023 23:00,74,118,282391,96604,192,378995,SUNDAY,1,0,16.7,78,14.8,1012.5,Cloudy
6/19/2023 0:00,51,51,730174,44149,102,774323,MONDAY,0,1,16.7,78,14.8,1012.5,Cloudy
6/19/2023 1:00,42,40,162577,37244,82,199821,MONDAY,0,1,16.7,80,14.8,1014.5,Cloudy
6/19/2023 2:00,19,16,50636,11056,35,61692,MONDAY,0,1,16.7,80,14.8,1014.5,Cloudy
6/19/2023 3:00,9,11,14902,12111,20,27013,MONDAY,0,1,16.1,87,5.4,1014.8,Cloudy
6/19/2023 4:00,7,12,28009,14642,19,42651,MONDAY,0,1,16.1,87,0,1015.2,Cloudy
6/19/2023 5:00,13,46,11556,33294,59,44850,MONDAY,0,1,16.1,87,7.6,1015.4,Cloudy
6/19/2023 6:00,19,130,47800,129676,149,177476,MONDAY,0,1,16.1,87,7.6,1015.4,Cloudy
6/19/2023 7:00,38,222,49315,187636,260,236951,MONDAY,0,1,16.7,84,0,1015.7,Cloudy
6/19/2023 8:00,93,352,164449,278595,445,443044,MONDAY,0,1,16.1,81,9.4,1016.3,Cloudy
6/19/2023 9:00,127,378,803425,327127,505,1130552,MONDAY,0,1,15.6,83,9.4,1016.9,Cloudy
6/19/2023 10:00,195,416,471121,336479,611,807600,MONDAY,0,1,16.1,84,11.2,1017.5,Cloudy
6/19/2023 11:00,261,460,1185845,425338,721,1611183,MONDAY,0,1,16.1,84,11.2,1017.5,Cloudy
6/19/2023 12:00,359,507,1351839,420887,866,1772726,MONDAY,0,1,17.8,75,14.8,1018.8,Cloudy
6/19/2023 13:00,369,524,1662358,482735,893,2145093,MONDAY,0,1,17.8,73,16.6,1019.2,Cloudy
6/19/2023 14:00,334,527,2137460,519185,861,2656645,MONDAY,0,1,17.2,75,16.6,1019.7,Cloudy
6/19/2023 15:00,394,543,1122456,499918,937,1622374,MONDAY,0,1,17.8,73,16.6,1019.8,Cloudy
6/19/2023 16:00,381,610,3147215,546083,991,3693298,MONDAY,0,1,17.8,73,16.6,1019.8,Cloudy
6/19/2023 17:00,382,741,893092,679087,1123,1572179,MONDAY,0,1,17.8,73,18.4,1020,Cloudy
6/19/2023 18:00,370,753,2162459,761270,1123,2923729,MONDAY,0,1,17.2,72,20.5,1020,Cloudy
6/19/2023 19:00,299,598,1414308,490727,897,1905035,MONDAY,0,1,17.2,72,20.5,1020,Cloudy
6/19/2023 20:00,232,465,1022072,367713,697,1389785,MONDAY,0,1,17.2,72,20.5,1019.9,Cloudy
6/19/2023 21:00,149,276,240528,213755,425,454283,MONDAY,0,1,17.2,72,20.5,1019.9,Cloudy
6/19/2023 22:00,105,209,221035,371351,314,592386,MONDAY,0,1,16.7,75,20.5,1020.3,Cloudy
6/19/2023 23:00,49,99,70096,1703609,148,1773705,MONDAY,0,1,16.1,81,20.5,1020.5,Cloudy
6/20/2023 0:00,42,40,66594,28135,82,94729,TUESDAY,0,0,16.1,78,16.6,1021.5,Cloudy
6/20/2023 1:00,15,14,605531,7874,29,613405,TUESDAY,0,0,16.1,78,16.6,1021.5,Cloudy
6/20/2023 2:00,10,9,83858,5902,19,89760,TUESDAY,0,0,15.6,80,11.2,1022.6,Cloudy
6/20/2023 3:00,7,11,43578,8216,18,51794,TUESDAY,0,0,15,83,13,1022.7,Cloudy
6/20/2023 4:00,5,13,4204,10471,18,14675,TUESDAY,0,0,14.4,87,11.2,1023,Fair
6/20/2023 5:00,13,99,22876,81003,112,103879,TUESDAY,0,0,13.9,87,9.4,1022.7,Cloudy
6/20/2023 6:00,57,262,177514,189724,319,367238,TUESDAY,0,0,13.9,87,9.4,1022.7,Cloudy
6/20/2023 7:00,104,638,92620,504758,742,597378,TUESDAY,0,0,13.9,87,7.6,1022.8,Fair
6/20/2023 8:00,216,1312,333389,1325075,1528,1658464,TUESDAY,0,0,13.9,87,7.6,1022.8,Cloudy
6/20/2023 9:00,119,668,180242,611845,787,792087,TUESDAY,0,0,14.4,84,7.6,1023.3,Cloudy
6/20/2023 10:00,115,331,298801,556026,446,854827,TUESDAY,0,0,15,81,0,1023.8,Cloudy
6/20/2023 11:00,155,383,539515,296025,538,835540,TUESDAY,0,0,15,81,0,1023.8,Cloudy
6/20/2023 12:00,167,389,2454436,312933,556,2767369,TUESDAY,0,0,16.1,81,5.4,1024.1,Cloudy
6/20/2023 13:00,151,309,757894,214047,460,971941,TUESDAY,0,0,16.1,78,7.6,1024.2,Cloudy
6/20/2023 14:00,164,380,792576,789092,544,1581668,TUESDAY,0,0,17.8,75,13,1024.3,Cloudy
6/20/2023 15:00,237,493,2044264,390344,730,2434608,TUESDAY,0,0,17.8,73,18.4,1024.3,Cloudy
6/20/2023 16:00,308,825,561743,709447,1133,1271190,TUESDAY,0,0,17.8,73,18.4,1024.3,Cloudy
6/20/2023 17:00,451,1424,1395299,1287390,1875,2682689,TUESDAY,0,0,16.7,78,22.3,1024.9,Cloudy
6/20/2023 18:00,404,1114,1898258,1671408,1518,3569666,TUESDAY,0,0,16.7,80,25.9,1024.8,Cloudy
6/20/2023 19:00,296,796,493171,690716,1092,1183887,TUESDAY,0,0,17.2,78,22.3,1024.7,Cloudy
6/20/2023 20:00,179,542,1686537,503944,721,2190481,TUESDAY,0,0,17.8,75,25.9,1024.6,Cloudy
6/20/2023 21:00,120,368,153691,284433,488,438124,TUESDAY,0,0,17.8,75,25.9,1024.6,Cloudy
6/20/2023 22:00,96,222,755718,188405,318,944123,TUESDAY,0,0,17.2,78,22.3,1024.6,Cloudy
6/20/2023 23:00,54,92,149041,68705,146,217746,TUESDAY,0,0,16.7,78,22.3,1025.2,Cloudy
6/21/2023 0:00,22,31,19834,19964,53,39798,WEDNESDAY,0,0,16.7,80,20.5,1025.7,Cloudy
6/21/2023 1:00,15,15,18416,16361,30,34777,WEDNESDAY,0,0,16.1,81,14.8,1026.4,Cloudy
6/21/2023 2:00,10,8,23033,4084,18,27117,WEDNESDAY,0,0,16.1,81,14.8,1026.4,Cloudy
6/21/2023 3:00,6,6,5052,9183,12,14235,WEDNESDAY,0,0,15.6,80,13,1026.4,Cloudy
6/21/2023 4:00,12,11,13723,9794,23,23517,WEDNESDAY,0,0,15.6,80,13,1026.4,Cloudy
6/21/2023 5:00,17,99,13525,69047,116,82572,WEDNESDAY,0,0,15,83,5.4,1026.5,Cloudy
6/21/2023 6:00,62,264,253519,237787,326,491306,WEDNESDAY,0,0,15,83,5.4,1026.5,Cloudy
6/21/2023 7:00,122,695,2491914,578176,817,3070090,WEDNESDAY,0,0,14.4,87,9.4,1026.6,Cloudy
6/21/2023 8:00,215,1318,434402,1055598,1533,1490000,WEDNESDAY,0,0,14.4,87,5.4,1026.9,Cloudy
6/21/2023 9:00,115,722,169517,558340,837,727857,WEDNESDAY,0,0,14.4,87,5.4,1027.1,Cloudy
6/21/2023 10:00,135,393,2014814,319767,528,2334581,WEDNESDAY,0,0,16.1,84,11.2,1027.4,Cloudy
6/21/2023 11:00,147,358,692771,295315,505,988086,WEDNESDAY,0,0,16.1,84,11.2,1027.4,Cloudy
6/21/2023 12:00,162,423,1375085,295034,585,1670119,WEDNESDAY,0,0,17.2,75,11.2,1028,Cloudy
6/21/2023 13:00,200,418,894708,330375,618,1225083,WEDNESDAY,0,0,17.8,73,14.8,1027.9,Cloudy
6/21/2023 14:00,212,374,2197895,323964,586,2521859,WEDNESDAY,0,0,17.8,70,16.6,1028.1,Cloudy
6/21/2023 15:00,279,544,1430435,478508,823,1908943,WEDNESDAY,0,0,18.3,68,18.4,1028.2,Cloudy
6/21/2023 16:00,358,934,4471316,846675,1292,5317991,WEDNESDAY,0,0,18.3,68,18.4,1028.2,Rain
6/21/2023 17:00,570,1486,4189905,1455367,2056,5645272,WEDNESDAY,0,0,18.3,70,18.4,1027.8,Cloudy
6/21/2023 18:00,460,1230,1021672,1240298,1690,2261970,WEDNESDAY,0,0,18.3,70,18.4,1027.6,Cloudy
6/21/2023 19:00,308,826,3535967,779776,1134,4315743,WEDNESDAY,0,0,18.3,68,20.5,1027.3,Cloudy
6/21/2023 20:00,273,582,1059192,487963,855,1547155,WEDNESDAY,0,0,18.3,68,20.5,1027.3,Cloudy
6/21/2023 21:00,169,421,233548,347855,590,581403,WEDNESDAY,0,0,17.2,75,16.6,1026.7,Cloudy
6/21/2023 22:00,125,209,1112990,268077,334,1381067,WEDNESDAY,0,0,16.7,78,13,1026.6,Fair
6/21/2023 23:00,72,134,168769,141239,206,310008,WEDNESDAY,0,0,16.7,78,13,1026.6,Fair
6/22/2023 0:00,32,46,79837,35752,78,115589,THURSDAY,0,0,15.6,80,13,1026.5,Fair
6/22/2023 1:00,11,18,18853,10175,29,29028,THURSDAY,0,0,15.6,80,13,1026.5,Fair
6/22/2023 2:00,4,7,7820,5884,11,13704,THURSDAY,0,0,15.6,83,13,1026.2,Fair
6/22/2023 3:00,3,6,5461,3889,9,9350,THURSDAY,0,0,15.6,86,11.2,1025.9,Fair
6/22/2023 4:00,8,13,14449,11195,21,25644,THURSDAY,0,0,15.6,86,11.2,1025.9,Fair
6/22/2023 5:00,17,99,37035,69981,116,107016,THURSDAY,0,0,15,90,9.4,1025.7,Fair
6/22/2023 6:00,47,245,40957,206597,292,247554,THURSDAY,0,0,14.4,90,7.6,1025.3,Fair
6/22/2023 7:00,110,678,152309,1194328,788,1346637,THURSDAY,0,0,15,87,5.4,1024.8,Fair
6/22/2023 8:00,231,1266,294775,1056743,1497,1351518,THURSDAY,0,0,15,87,5.4,1024.8,Fair
6/22/2023 9:00,141,645,235625,596894,786,832519,THURSDAY,0,0,15,87,9.4,1025,Cloudy
6/22/2023 10:00,128,399,2561628,352573,527,2914201,THURSDAY,0,0,16.1,81,13,1025.3,Cloudy
6/22/2023 11:00,140,405,236275,1205488,545,1441763,THURSDAY,0,0,16.1,81,13,1025.3,Cloudy
6/22/2023 12:00,229,463,1599023,376977,692,1976000,THURSDAY,0,0,17.2,75,18.4,1025.3,Cloudy
6/22/2023 13:00,211,411,1897047,313413,622,2210460,THURSDAY,0,0,17.8,70,18.4,1025.5,Cloudy
6/22/2023 14:00,203,458,1322603,375182,661,1697785,THURSDAY,0,0,17.8,73,18.4,1025.4,Cloudy
6/22/2023 15:00,269,528,2021879,1932146,797,3954025,THURSDAY,0,0,17.8,73,18.4,1025.4,Cloudy
6/22/2023 16:00,388,864,1741048,750452,1252,2491500,THURSDAY,0,0,18.9,68,22.3,1024.5,Cloudy
6/22/2023 17:00,521,1337,1428542,1204542,1858,2633084,THURSDAY,0,0,18.3,73,24.1,1023.6,Cloudy
6/22/2023 18:00,434,1069,1800504,915560,1503,2716064,THURSDAY,0,0,18.3,73,22.3,1023.2,Cloudy
6/22/2023 19:00,384,757,1635511,737299,1141,2372810,THURSDAY,0,0,18.3,73,20.5,1022.7,Cloudy
6/22/2023 20:00,229,597,1125893,485386,826,1611279,THURSDAY,0,0,18.3,73,20.5,1022.7,Cloudy
6/22/2023 21:00,190,423,1671204,367142,613,2038346,THURSDAY,0,0,17.8,75,18.4,1021.5,Cloudy
6/22/2023 22:00,139,236,177865,208267,375,386132,THURSDAY,0,0,17.2,78,16.6,1021.1,Cloudy
6/22/2023 23:00,79,136,115032,130585,215,245617,THURSDAY,0,0,17.2,78,16.6,1021.1,Cloudy
6/23/2023 0:00,46,59,45212,50240,105,95452,FRIDAY,0,0,16.7,80,13,1020.9,Rain
6/23/2023 1:00,36,24,52321,40609,60,92930,FRIDAY,0,0,16.7,80,13,1020.9,Cloudy
6/23/2023 2:00,35,15,130594,15273,50,145867,FRIDAY,0,0,16.7,80,11.2,1020.3,Cloudy
6/23/2023 3:00,4,8,5097,12416,12,17513,FRIDAY,0,0,16.1,84,16.6,1020,Cloudy
6/23/2023 4:00,4,17,9625,11421,21,21046,FRIDAY,0,0,16.7,84,14.8,1019.6,Cloudy
6/23/2023 5:00,22,82,19984,52036,104,72020,FRIDAY,0,0,16.7,84,11.2,1019.4,Cloudy
6/23/2023 6:00,35,199,57551,166498,234,224049,FRIDAY,0,0,16.7,84,11.2,1019.4,Cloudy
6/23/2023 7:00,68,469,65764,378705,537,444469,FRIDAY,0,0,16.7,84,13,1018.6,Cloudy
6/23/2023 8:00,148,903,455633,706743,1051,1162376,FRIDAY,0,0,16.1,87,5.4,1018.8,Cloudy
6/23/2023 9:00,104,576,137232,441540,680,578772,FRIDAY,0,0,16.1,90,9.4,1018.5,Cloudy
6/23/2023 10:00,127,394,281147,295718,521,576865,FRIDAY,0,0,16.1,90,9.4,1018.5,Cloudy
6/23/2023 11:00,165,374,1906798,307293,539,2214091,FRIDAY,0,0,17.2,87,5.4,1019.1,Cloudy
6/23/2023 12:00,224,489,448489,371893,713,820382,FRIDAY,0,0,17.2,90,5.4,1019.2,Cloudy
6/23/2023 13:00,235,505,794798,388891,740,1183689,FRIDAY,0,0,17.8,87,0,1019.2,Cloudy
6/23/2023 14:00,286,500,604579,415646,786,1020225,FRIDAY,0,0,18.3,87,7.6,1018.9,Cloudy
6/23/2023 15:00,353,608,1064846,504346,961,1569192,FRIDAY,0,0,18.3,87,7.6,1018.9,Cloudy
6/23/2023 16:00,351,802,1991074,2301399,1153,4292473,FRIDAY,0,0,20,81,11.2,1018.1,Cloudy
6/23/2023 17:00,460,1085,1022084,1018407,1545,2040491,FRIDAY,0,0,22.2,76,13,1017.2,Cloudy
6/23/2023 18:00,470,867,1610990,754529,1337,2365519,FRIDAY,0,0,22.2,76,13,1017.2,Cloudy
6/23/2023 19:00,355,712,609415,633590,1067,1243005,FRIDAY,0,0,20.6,81,18.4,1016.5,Cloudy
6/23/2023 20:00,323,545,4284095,567642,868,4851737,FRIDAY,0,0,20.6,81,18.4,1016.5,Cloudy
6/23/2023 21:00,281,361,520348,443750,642,964098,FRIDAY,0,0,21.1,82,14.8,1015.6,Cloudy
6/23/2023 22:00,322,299,621694,324291,621,945985,FRIDAY,0,0,21.1,82,18.4,1015.6,Cloudy
6/23/2023 23:00,246,243,359036,238786,489,597822,FRIDAY,0,0,20.6,87,5.4,1015.3,Cloudy
6/24/2023 0:00,186,153,297180,346982,339,644162,SATURDAY,1,0,23.3,79,18.4,1015.3,Cloudy
6/24/2023 1:00,174,125,686824,495784,299,1182608,SATURDAY,1,0,23.3,79,18.4,1015.3,Cloudy
6/24/2023 2:00,94,68,137207,65516,162,202723,SATURDAY,1,0,21.7,87,16.6,1015.3,Cloudy
6/24/2023 3:00,12,27,14117,473117,39,487234,SATURDAY,1,0,21.7,87,16.6,1015.3,Cloudy
6/24/2023 4:00,6,25,10019,21480,31,31499,SATURDAY,1,0,21.1,90,18.4,1015.2,Cloudy
6/24/2023 5:00,11,29,466562,21799,40,488361,SATURDAY,1,0,21.1,90,18.4,1015.2,Cloudy
6/24/2023 6:00,10,46,9357,32083,56,41440,SATURDAY,1,0,20.6,93,11.2,1014.2,Cloudy
6/24/2023 7:00,27,79,25150,66477,106,91627,SATURDAY,1,0,20.6,93,11.2,1013.7,Cloudy
6/24/2023 8:00,59,176,60750,156335,235,217085,SATURDAY,1,0,20.6,93,7.6,1013.8,Cloudy
6/24/2023 9:00,69,161,82985,146099,230,229084,SATURDAY,1,0,20.6,93,7.6,1013.8,Cloudy
6/24/2023 10:00,81,221,124803,177636,302,302439,SATURDAY,1,0,20,93,9.4,1013.8,Rain
6/24/2023 11:00,109,264,161783,201616,373,363399,SATURDAY,1,0,20.6,96,7.6,1013,Rain
6/24/2023 12:00,202,385,378793,316680,587,695473,SATURDAY,1,0,22.2,94,9.4,1012.9,Rain
6/24/2023 13:00,312,483,631708,387620,795,1019328,SATURDAY,1,0,22.2,94,9.4,1012.9,Rain
6/24/2023 14:00,329,490,1765974,421197,819,2187171,SATURDAY,1,0,22.8,90,16.6,1012.3,Rain
6/24/2023 15:00,395,558,1197281,770113,953,1967394,SATURDAY,1,0,22.8,87,9.4,1011.7,Rain
6/24/2023 16:00,424,555,1599309,706993,979,2306302,SATURDAY,1,0,22.8,87,9.4,1011.7,Rain
6/24/2023 17:00,416,540,1661353,536740,956,2198093,SATURDAY,1,0,23.9,82,16.6,1010.3,Rain
6/24/2023 18:00,410,552,3262768,538981,962,3801749,SATURDAY,1,0,23.9,82,16.6,1010.3,Rain
6/24/2023 19:00,393,515,3941341,557578,908,4498919,SATURDAY,1,0,25,77,20.5,1009,Rain
6/24/2023 20:00,324,357,3311063,1329296,681,4640359,SATURDAY,1,0,25,77,20.5,1009,Rain
6/24/2023 21:00,228,315,361929,278872,543,640801,SATURDAY,1,0,26.1,67,20.5,1008.3,Cloudy
6/24/2023 22:00,243,251,1551746,266663,494,1818409,SATURDAY,1,0,26.1,67,27.7,1008.4,Cloudy
6/24/2023 23:00,254,218,2253357,910107,472,3163464,SATURDAY,1,0,25,71,27.7,1008.5,Cloudy
6/25/2023 0:00,174,151,1598577,134020,325,1732597,SUNDAY,1,0,25,71,25.9,1008.5,Cloudy
6/25/2023 1:00,163,114,399529,107539,277,507068,SUNDAY,1,0,22.8,79,24.1,1009.6,Cloudy
6/25/2023 2:00,112,67,766899,60397,179,827296,SUNDAY,1,0,22.8,79,20.5,1009.5,Cloudy
6/25/2023 3:00,13,18,61010,13939,31,74949,SUNDAY,1,0,22.8,79,20.5,1009.5,Cloudy
6/25/2023 4:00,15,25,70022,23732,40,93754,SUNDAY,1,0,22.2,82,22.3,1009.5,Cloudy
6/25/2023 5:00,11,20,42579,48917,31,91496,SUNDAY,1,0,22.2,82,22.3,1009.5,Cloudy
6/25/2023 6:00,45,85,52877,69077,130,121954,SUNDAY,1,0,22.2,84,13,1009.3,Cloudy
6/25/2023 7:00,62,159,207081,196483,221,403564,SUNDAY,1,0,21.7,87,14.8,1009,Cloudy
6/25/2023 8:00,92,188,235157,192360,280,427517,SUNDAY,1,0,21.7,87,14.8,1009.1,Cloudy
6/25/2023 9:00,221,373,462722,348098,594,810820,SUNDAY,1,0,22.2,84,11.2,1009.5,Cloudy
6/25/2023 10:00,285,515,1075494,496490,800,1571984,SUNDAY,1,0,22.2,84,11.2,1009.5,Cloudy
6/25/2023 11:00,370,533,1637270,575088,903,2212358,SUNDAY,1,0,23.9,79,14.8,1009.7,Cloudy
6/25/2023 12:00,460,570,1063639,772405,1030,1836044,SUNDAY,1,0,25,74,13,1009.7,Cloudy
6/25/2023 13:00,501,604,2824359,581207,1105,3405566,SUNDAY,1,0,26.1,72,14.8,1009.8,Cloudy
6/25/2023 14:00,450,561,1297990,560863,1011,1858853,SUNDAY,1,0,26.1,72,14.8,1009.8,Cloudy
6/25/2023 15:00,446,607,850938,669253,1053,1520191,SUNDAY,1,0,26.1,74,13,1009.7,Cloudy
6/25/2023 16:00,349,541,979852,1084335,890,2064187,SUNDAY,1,0,26.1,74,16.6,1009.5,Cloudy
6/25/2023 17:00,330,527,2583400,620274,857,3203674,SUNDAY,1,0,26.1,74,16.6,1009.5,Cloudy
6/25/2023 18:00,316,500,560713,511627,816,1072340,SUNDAY,1,0,26.1,74,14.8,1008.9,Cloudy
6/25/2023 19:00,310,454,2734186,1111906,764,3846092,SUNDAY,1,0,26.1,74,14.8,1008.9,Cloudy
6/25/2023 20:00,233,373,449822,342731,606,792553,SUNDAY,1,0,27.8,65,9.4,1008.7,Cloudy
6/25/2023 21:00,183,247,1712228,357219,430,2069447,SUNDAY,1,0,27.8,67,5.4,1008.7,Rain
6/25/2023 22:00,183,208,443088,195460,391,638548,SUNDAY,1,0,25.6,74,13,1008.6,Rain
6/25/2023 23:00,116,120,1168843,108941,236,1277784,SUNDAY,1,0,26.7,69,20.5,1008.6,Cloudy
6/26/2023 0:00,43,47,54572,57752,90,112324,MONDAY,0,0,26.7,69,20.5,1008.6,Cloudy
6/26/2023 1:00,12,23,16801,30306,35,47107,MONDAY,0,0,23.9,79,20.5,1009.7,Cloudy
6/26/2023 2:00,17,13,362691,10978,30,373669,MONDAY,0,0,22.8,84,11.2,1009.5,Cloudy
6/26/2023 3:00,5,5,6597,4219,10,10816,MONDAY,0,0,22.2,87,11.2,1009.6,Cloudy
6/26/2023 4:00,2,11,2457,10664,13,13121,MONDAY,0,0,21.7,87,9.4,1009.5,Cloudy
6/26/2023 5:00,16,78,24563,53923,94,78486,MONDAY,0,0,21.7,87,9.4,1009.5,Cloudy
6/26/2023 6:00,36,222,43673,170738,258,214411,MONDAY,0,0,20.6,93,14.8,1009.4,Cloudy
6/26/2023 7:00,83,579,74894,465037,662,539931,MONDAY,0,0,20.6,93,16.6,1009.6,Cloudy
6/26/2023 8:00,169,1076,249170,824502,1245,1073672,MONDAY,0,0,20.6,96,5.4,1009.7,Cloudy
6/26/2023 9:00,109,633,177048,1302601,742,1479649,MONDAY,0,0,20.6,93,11.2,1009.9,Cloudy
6/26/2023 10:00,123,324,797880,252249,447,1050129,MONDAY,0,0,20.6,93,11.2,1009.9,Cloudy
6/26/2023 11:00,134,303,226413,252828,437,479241,MONDAY,0,0,21.1,93,11.2,1010.3,Cloudy
6/26/2023 12:00,163,343,1104807,280207,506,1385014,MONDAY,0,0,21.7,90,7.6,1010.8,Cloudy
6/26/2023 13:00,179,360,536949,277660,539,814609,MONDAY,0,0,21.7,90,7.6,1010.8,Cloudy
6/26/2023 14:00,191,347,597197,282569,538,879766,MONDAY,0,0,23.3,85,11.2,1010.8,Cloudy
6/26/2023 15:00,166,457,317231,411098,623,728329,MONDAY,0,0,23.3,85,18.4,1010.7,Cloudy
6/26/2023 16:00,272,730,2967000,733294,1002,3700294,MONDAY,0,0,23.9,82,20.5,1009.9,Cloudy
6/26/2023 17:00,344,1222,2983856,1216944,1566,4200800,MONDAY,0,0,23.3,82,20.5,1009.6,Cloudy
6/26/2023 18:00,262,987,1566575,815080,1249,2381655,MONDAY,0,0,26.1,72,16.6,1009.1,Cloudy
6/26/2023 19:00,298,734,441470,599812,1032,1041282,MONDAY,0,0,26.1,72,16.6,1009.1,Cloudy
6/26/2023 20:00,183,516,1390340,475736,699,1866076,MONDAY,0,0,27.8,65,22.3,1008.8,Rain
6/26/2023 21:00,116,292,1582734,242669,408,1825403,MONDAY,0,0,26.1,69,16.6,1008.8,Rain
6/26/2023 22:00,104,197,912335,207788,301,1120123,MONDAY,0,0,26.1,69,16.6,1008.8,Rain
6/26/2023 23:00,77,126,207214,117957,203,325171,MONDAY,0,0,25,79,16.6,1008.8,Rain
6/27/2023 0:00,40,55,113915,41547,95,155462,TUESDAY,0,0,23.9,84,14.8,1009.2,Rain
6/27/2023 1:00,9,14,40019,9644,23,49663,TUESDAY,0,0,23.3,85,14.8,1009.7,Rain
6/27/2023 2:00,10,8,28408,3102,18,31510,TUESDAY,0,0,22.8,90,14.8,1009.8,Rain
6/27/2023 3:00,3,3,3728,1644,6,5372,TUESDAY,0,0,22.8,90,14.8,1009.8,Cloudy
6/27/2023 4:00,3,6,6301,14073,9,20374,TUESDAY,0,0,23.3,85,13,1009.3,Rain
6/27/2023 5:00,8,72,6430,44805,80,51235,TUESDAY,0,0,22.2,94,13,1008.6,Rain
6/27/2023 6:00,30,197,60208,191608,227,251816,TUESDAY,0,0,21.7,96,18.4,1008.1,Cloudy
6/27/2023 7:00,93,652,96679,587281,745,683960,TUESDAY,0,0,21.7,96,18.4,1008.1,Rain
6/27/2023 8:00,169,1199,617150,965407,1368,1582557,TUESDAY,0,0,21.1,93,11.2,1008,Rain
6/27/2023 9:00,109,691,576376,560849,800,1137225,TUESDAY,0,0,20.6,93,18.4,1007.6,Rain
6/27/2023 10:00,76,375,145245,537674,451,682919,TUESDAY,0,0,20.6,93,24.1,1007.3,Rain
6/27/2023 11:00,84,233,120929,162629,317,283558,TUESDAY,0,0,20.6,93,24.1,1007.3,Rain
6/27/2023 12:00,98,327,192926,239093,425,432019,TUESDAY,0,0,21.7,90,27.7,1007.6,Rain
6/27/2023 13:00,154,356,289742,280467,510,570209,TUESDAY,0,0,23.3,85,14.8,1007.2,Rain
6/27/2023 14:00,142,406,250257,308282,548,558539,TUESDAY,0,0,23.3,85,11.2,1007.6,Rain
6/27/2023 15:00,219,515,1133702,431054,734,1564756,TUESDAY,0,0,22.2,84,18.4,1008.4,Rain
6/27/2023 16:00,283,819,500273,679396,1102,1179669,TUESDAY,0,0,23.3,82,20.5,1008.4,Rain
6/27/2023 17:00,465,1431,1640200,1309256,1896,2949456,TUESDAY,0,0,23.9,76,16.6,1007.2,Rain
6/27/2023 18:00,420,1133,2424107,1688584,1553,4112691,TUESDAY,0,0,23.9,76,16.6,1007.2,Rain
6/27/2023 19:00,349,867,2086355,2352631,1216,4438986,TUESDAY,0,0,25.6,69,24.1,1006.9,Cloudy
6/27/2023 20:00,254,571,1237216,736608,825,1973824,TUESDAY,0,0,25.6,64,24.1,1007,Cloudy
6/27/2023 21:00,253,445,372334,449997,698,822331,TUESDAY,0,0,25,66,24.1,1006.9,Cloudy
6/27/2023 22:00,144,282,552693,228641,426,781334,TUESDAY,0,0,23.9,71,29.5,1008,Cloudy
6/27/2023 23:00,74,116,75947,167012,190,242959,TUESDAY,0,0,23.9,71,29.5,1008,Cloudy
6/28/2023 0:00,42,33,158026,19421,75,177447,WEDNESDAY,0,0,22.2,82,25.9,1008.8,Cloudy
6/28/2023 1:00,22,19,426874,16531,41,443405,WEDNESDAY,0,0,22.2,82,20.5,1009.2,Cloudy
6/28/2023 2:00,10,18,90284,17576,28,107860,WEDNESDAY,0,0,21.7,84,22.3,1009.4,Cloudy
6/28/2023 3:00,3,9,2187,5790,12,7977,WEDNESDAY,0,0,21.1,87,20.5,1009.9,Cloudy
6/28/2023 4:00,7,16,12139,13005,23,25144,WEDNESDAY,0,0,21.1,87,20.5,1009.9,Cloudy
6/28/2023 5:00,18,79,119117,55074,97,174191,WEDNESDAY,0,0,21.1,90,13,1009.6,Cloudy
6/28/2023 6:00,33,187,27881,128084,220,155965,WEDNESDAY,0,0,21.7,87,7.6,1009.3,Cloudy
6/28/2023 7:00,24,178,16694,134200,202,150894,WEDNESDAY,0,0,21.7,87,7.6,1009.3,Cloudy
6/28/2023 8:00,131,921,125949,707296,1052,833245,WEDNESDAY,0,0,20.6,93,9.4,1009.6,Cloudy
6/28/2023 9:00,113,681,163501,525461,794,688962,WEDNESDAY,0,0,20.6,93,9.4,1009.6,Cloudy
6/28/2023 10:00,99,401,150394,427627,500,578021,WEDNESDAY,0,0,20.6,93,7.6,1009.6,Cloudy
6/28/2023 11:00,110,324,301972,248777,434,550749,WEDNESDAY,0,0,21.1,97,16.6,1010.1,Cloudy
6/28/2023 12:00,128,386,201580,305536,514,507116,WEDNESDAY,0,0,21.1,97,16.6,1010.1,Cloudy
6/28/2023 13:00,167,410,294996,317523,577,612519,WEDNESDAY,0,0,21.7,94,13,1009.8,Cloudy
6/28/2023 14:00,206,427,1431222,345797,633,1777019,WEDNESDAY,0,0,21.7,90,16.6,1009.5,Cloudy
6/28/2023 15:00,186,543,417536,472912,729,890448,WEDNESDAY,0,0,22.2,87,18.4,1009.8,Rain
6/28/2023 16:00,305,888,553494,761593,1193,1315087,WEDNESDAY,0,0,24.4,79,18.4,1009,Rain
6/28/2023 17:00,428,1333,1629814,2307371,1761,3937185,WEDNESDAY,0,0,25.6,74,22.3,1008.5,Rain
6/28/2023 18:00,411,1068,1714060,947534,1479,2661594,WEDNESDAY,0,0,26.7,69,18.4,1008.5,Rain
6/28/2023 19:00,322,746,491723,665625,1068,1157348,WEDNESDAY,0,0,26.7,69,18.4,1008.5,Rain
6/28/2023 20:00,129,419,235724,382343,548,618067,WEDNESDAY,0,0,26.1,72,22.3,1008.4,Rain
6/28/2023 21:00,81,238,129724,212116,319,341840,WEDNESDAY,0,0,25,74,18.4,1008.3,Rain
6/28/2023 22:00,69,163,127416,121733,232,249149,WEDNESDAY,0,0,24.4,74,16.6,1008.9,Rain
6/28/2023 23:00,54,99,891202,134013,153,1025215,WEDNESDAY,0,0,24.4,74,16.6,1008.9,Rain
6/29/2023 0:00,27,60,28140,51207,87,79347,THURSDAY,0,0,23.3,76,16.6,1009.9,Rain
6/29/2023 1:00,23,18,24726,14173,41,38899,THURSDAY,0,0,22.8,79,20.5,1010.8,Cloudy
6/29/2023 2:00,17,11,21167,8272,28,29439,THURSDAY,0,0,21.1,90,13,1011,Cloudy
6/29/2023 3:00,4,5,8540,5279,9,13819,THURSDAY,0,0,21.1,93,13,1011,Cloudy
6/29/2023 4:00,9,17,1620148,15009,26,1635157,THURSDAY,0,0,20.6,93,13,1011.3,Cloudy
6/29/2023 5:00,15,73,14709,52442,88,67151,THURSDAY,0,0,20.6,93,16.6,1012,Cloudy
6/29/2023 6:00,36,228,41452,162357,264,203809,THURSDAY,0,0,20.6,93,11.2,1012.3,Cloudy
6/29/2023 7:00,91,604,81223,1067475,695,1148698,THURSDAY,0,0,20,96,9.4,1012.7,Cloudy
6/29/2023 8:00,193,1153,155506,922005,1346,1077511,THURSDAY,0,0,19.4,97,11.2,1013.3,Cloudy
6/29/2023 9:00,148,687,968977,489738,835,1458715,THURSDAY,0,0,19.4,97,11.2,1013.3,Cloudy
6/29/2023 10:00,104,388,181678,312948,492,494626,THURSDAY,0,0,20,90,13,1014.5,Cloudy
6/29/2023 11:00,181,375,1161239,294609,556,1455848,THURSDAY,0,0,21.1,87,14.8,1014.7,Cloudy
6/29/2023 12:00,157,441,281135,323820,598,604955,THURSDAY,0,0,21.7,79,9.4,1015.3,Cloudy
6/29/2023 13:00,232,431,431932,334328,663,766260,THURSDAY,0,0,23.3,76,11.2,1015.6,Cloudy
6/29/2023 14:00,218,442,901766,355128,660,1256894,THURSDAY,0,0,23.3,76,11.2,1015.6,Cloudy
6/29/2023 15:00,242,566,1456483,555064,808,2011547,THURSDAY,0,0,25,66,9.4,1015.1,Cloudy
6/29/2023 16:00,307,860,1306092,870516,1167,2176608,THURSDAY,0,0,25,66,9.4,1015.1,Cloudy
6/29/2023 17:00,475,1368,2458863,1305022,1843,3763885,THURSDAY,0,0,24.4,74,14.8,1015,Cloudy
6/29/2023 18:00,482,1092,2408152,2213296,1574,4621448,THURSDAY,0,0,24.4,74,18.4,1015,Cloudy
6/29/2023 19:00,334,775,515337,1142791,1109,1658128,THURSDAY,0,0,24.4,74,22.3,1014.8,Rain
6/29/2023 20:00,308,580,6267086,609876,888,6876962,THURSDAY,0,0,23.9,76,16.6,1014.8,Cloudy
6/29/2023 21:00,240,405,1311706,370181,645,1681887,THURSDAY,0,0,23.9,76,11.2,1014.8,Cloudy
6/29/2023 22:00,152,261,945808,268880,413,1214688,THURSDAY,0,0,25,56,16.6,1015.1,Cloudy
6/29/2023 23:00,97,153,1546020,135987,250,1682007,THURSDAY,0,0,25,56,16.6,1015.1,Cloudy
6/30/2023 0:00,88,71,119118,49899,159,169017,FRIDAY,0,0,23.3,64,16.6,1016.3,Cloudy
6/30/2023 1:00,43,39,109881,26591,82,136472,FRIDAY,0,0,22.8,69,16.6,1016.7,Cloudy
6/30/2023 2:00,13,31,111524,28406,44,139930,FRIDAY,0,0,21.1,78,16.6,1017,Cloudy
6/30/2023 3:00,4,11,201810,11380,15,213190,FRIDAY,0,0,21.1,82,14.8,1017.4,Fair
6/30/2023 4:00,5,22,3469,19676,27,23145,FRIDAY,0,0,21.1,82,14.8,1017.4,Fair
6/30/2023 5:00,12,74,236728,50583,86,287311,FRIDAY,0,0,19.4,91,9.4,1017.2,Fair
6/30/2023 6:00,34,186,51031,147689,220,198720,FRIDAY,0,0,19.4,91,13,1017.1,Fair
6/30/2023 7:00,85,412,105398,653763,497,759161,FRIDAY,0,0,19.4,87,9.4,1017,Fair
6/30/2023 8:00,156,812,211811,636741,968,848552,FRIDAY,0,0,19.4,87,9.4,1017,Cloudy
6/30/2023 9:00,142,649,967934,477784,791,1445718,FRIDAY,0,0,20,87,7.6,1017.7,Cloudy
6/30/2023 10:00,166,420,357965,353887,586,711852,FRIDAY,0,0,21.1,82,0,1017.7,Fair
6/30/2023 11:00,222,419,528115,1071204,641,1599319,FRIDAY,0,0,23.3,74,0,1018,Cloudy
6/30/2023 12:00,227,496,1020416,403975,723,1424391,FRIDAY,0,0,22.2,79,13,1018.5,Fair
6/30/2023 13:00,276,561,739467,440550,837,1180017,FRIDAY,0,0,22.2,79,13,1018.5,Fair
6/30/2023 14:00,269,525,482053,548580,794,1030633,FRIDAY,0,0,23.9,74,16.6,1018.6,Fair
6/30/2023 15:00,340,638,943595,523403,978,1466998,FRIDAY,0,0,23.3,76,16.6,1018.7,Fair
6/30/2023 16:00,365,782,1142861,670616,1147,1813477,FRIDAY,0,0,23.9,76,16.6,1018.3,Rain
6/30/2023 17:00,448,1009,5939214,1374211,1457,7313425,FRIDAY,0,0,22.2,82,20.5,1018.1,Cloudy
6/30/2023 18:00,378,779,1932257,690170,1157,2622427,FRIDAY,0,0,22.2,82,20.5,1018.1,Cloudy
6/30/2023 19:00,340,664,3637023,617492,1004,4254515,FRIDAY,0,0,23.3,76,20.5,1017.7,Rain
6/30/2023 20:00,300,495,2418761,427282,795,2846043,FRIDAY,0,0,23.3,76,18.4,1017.7,Cloudy
6/30/2023 21:00,212,371,3133467,321679,583,3455146,FRIDAY,0,0,22.8,76,18.4,1017.6,Cloudy
6/30/2023 22:00,189,265,1829105,231130,454,2060235,FRIDAY,0,0,21.7,79,22.3,1017.7,Cloudy
6/30/2023 23:00,146,205,2649422,177840,351,2827262,FRIDAY,0,0,21.7,79,22.3,1017.7,Cloudy
7/1/2023 0:00,145,144,1069373,130921,289,1200294,SATURDAY,1,0,20,90,11.2,1018.1,Cloudy
7/1/2023 1:00,133,102,1282196,88037,235,1370233,SATURDAY,1,0,19.4,93,9.4,1018.6,Cloudy
7/1/2023 2:00,112,54,255016,50908,166,305924,SATURDAY,1,0,19.4,93,7.6,1018.4,Cloudy
7/1/2023 3:00,12,15,26393,10147,27,36540,SATURDAY,1,0,19.4,93,0,1018.5,Cloudy
7/1/2023 4:00,5,18,11403,17267,23,28670,SATURDAY,1,0,19.4,93,0,1018.5,Cloudy
7/1/2023 5:00,8,24,1021078,24435,32,1045513,SATURDAY,1,0,19.4,93,5.4,1018.4,Cloudy
7/1/2023 6:00,21,61,25016,47029,82,72045,SATURDAY,1,0,18.3,97,7.6,1018.3,Cloudy
7/1/2023 7:00,48,136,77806,110791,184,188597,SATURDAY,1,0,17.8,100,7.6,1018.4,Cloudy
7/1/2023 8:00,81,203,168480,157252,284,325732,SATURDAY,1,0,17.8,100,5.4,1018.5,Cloudy
7/1/2023 9:00,164,312,405676,281991,476,687667,SATURDAY,1,0,17.8,100,0,1018.5,Cloudy
7/1/2023 10:00,264,404,614003,366034,668,980037,SATURDAY,1,0,17.8,100,5.4,1018.6,Cloudy
7/1/2023 11:00,305,510,690312,444625,815,1134937,SATURDAY,1,0,18.3,100,0,1018.8,Cloudy
7/1/2023 12:00,388,541,964469,508630,929,1473099,SATURDAY,1,0,18.3,100,5.4,1019,Cloudy
7/1/2023 13:00,408,489,867249,434060,897,1301309,SATURDAY,1,0,18.3,97,13,1019.5,Cloudy
7/1/2023 14:00,450,556,1000805,542272,1006,1543077,SATURDAY,1,0,20,90,7.6,1019.1,Cloudy
7/1/2023 15:00,431,452,2166253,979359,883,3145612,SATURDAY,1,0,20.6,84,13,1019,Cloudy
7/1/2023 16:00,491,472,1224652,446608,963,1671260,SATURDAY,1,0,21.1,84,16.6,1018.5,Cloudy
7/1/2023 17:00,386,515,881465,477347,901,1358812,SATURDAY,1,0,20.6,90,16.6,1018.1,Cloudy
7/1/2023 18:00,399,568,4722396,517977,967,5240373,SATURDAY,1,0,20.6,90,16.6,1018.1,Cloudy
7/1/2023 19:00,376,472,851534,474762,848,1326296,SATURDAY,1,0,19.4,93,16.6,1017.1,Cloudy
7/1/2023 20:00,282,374,1779315,633843,656,2413158,SATURDAY,1,0,19.4,93,20.5,1016.7,Cloudy
7/1/2023 21:00,230,269,4726681,318283,499,5044964,SATURDAY,1,0,19.4,93,20.5,1015.7,Cloudy
7/1/2023 22:00,194,213,1994106,205146,407,2199252,SATURDAY,1,0,19.4,93,20.5,1015.7,Cloudy
7/1/2023 23:00,181,135,3865050,120577,316,3985627,SATURDAY,1,0,19.4,97,9.4,1015.4,Cloudy
7/2/2023 0:00,100,109,159696,92176,209,251872,SUNDAY,1,0,19.4,93,5.4,1015.6,Cloudy
7/2/2023 1:00,94,82,264520,83912,176,348432,SUNDAY,1,0,19.4,93,0,1015.8,Cloudy
7/2/2023 2:00,69,42,201471,40809,111,242280,SUNDAY,1,0,19.4,91,7.6,1015.7,Cloudy
7/2/2023 3:00,13,13,19461,11548,26,31009,SUNDAY,1,0,19.4,91,7.6,1015.7,Cloudy
7/2/2023 4:00,7,17,15071,16427,24,31498,SUNDAY,1,0,20,81,9.4,1015.5,Cloudy
7/2/2023 5:00,10,30,41400,29695,40,71095,SUNDAY,1,0,20,81,13,1015.2,Cloudy
7/2/2023 6:00,14,48,3154105,46703,62,3200808,SUNDAY,1,0,20,81,11.2,1014.9,Cloudy
7/2/2023 7:00,20,57,29532,41745,77,71277,SUNDAY,1,0,20,81,11.2,1014.9,Cloudy
7/2/2023 8:00,33,103,48813,74318,136,123131,SUNDAY,1,0,19.4,91,9.4,1014.5,Cloudy
7/2/2023 9:00,78,176,186885,132847,254,319732,SUNDAY,1,0,19.4,91,9.4,1014.5,Cloudy
7/2/2023 10:00,116,271,200707,199519,387,400226,SUNDAY,1,0,19.4,91,11.2,1015,Cloudy
7/2/2023 11:00,140,260,528477,204485,400,732962,SUNDAY,1,0,19.4,91,11.2,1015,Cloudy
7/2/2023 12:00,85,158,1244221,129692,243,1373913,SUNDAY,1,0,20,90,7.6,1015.3,Cloudy
7/2/2023 13:00,126,250,223491,615801,376,839292,SUNDAY,1,0,20,90,9.4,1014.9,Cloudy
7/2/2023 14:00,160,267,4718690,239995,427,4958685,SUNDAY,1,0,20,93,11.2,1014.1,Cloudy
7/2/2023 15:00,70,182,94169,145176,252,239345,SUNDAY,1,0,20,93,11.2,1014.1,Rain
7/2/2023 16:00,108,264,230074,296089,372,526163,SUNDAY,1,0,19.4,93,11.2,1013.5,Rain
7/2/2023 17:00,126,311,973861,266371,437,1240232,SUNDAY,1,0,20,93,14.8,1013.5,Cloudy
7/2/2023 18:00,151,364,728268,295509,515,1023777,SUNDAY,1,0,20,96,22.3,1011.3,Cloudy
7/2/2023 19:00,157,322,1445013,280129,479,1725142,SUNDAY,1,0,21.7,100,14.8,1010.8,Rain
7/2/2023 20:00,89,210,163688,225719,299,389407,SUNDAY,1,0,21.7,100,14.8,1010.8,Cloudy
7/2/2023 21:00,59,155,1391972,136556,214,1528528,SUNDAY,1,0,23.9,90,11.2,1010.2,Cloudy
7/2/2023 22:00,67,143,130902,116642,210,247544,SUNDAY,1,0,23.9,90,11.2,1010.2,Rain
7/2/2023 23:00,56,77,183113,83831,133,266944,SUNDAY,1,0,23.9,88,11.2,1010.4,Cloudy
7/3/2023 0:00,20,37,60999,30692,57,91691,MONDAY,0,0,23.9,88,11.2,1010.4,Cloudy
7/3/2023 1:00,5,12,7043,7754,17,14797,MONDAY,0,0,22.8,90,14.8,1010.7,Cloudy
7/3/2023 2:00,2,7,1880,6325,9,8205,MONDAY,0,0,21.7,90,13,1010.7,Cloudy
7/3/2023 3:00,3,3,4548,1438,6,5986,MONDAY,0,0,21.7,90,13,1010.7,Cloudy
7/3/2023 4:00,2,5,5409,1960,7,7369,MONDAY,0,0,20,96,9.4,1010.8,Rain
7/3/2023 5:00,6,39,4709,27858,45,32567,MONDAY,0,0,19.4,97,13,1010.8,Rain
7/3/2023 6:00,10,97,107499,82996,107,190495,MONDAY,0,0,18.9,96,13,1009.8,Rain
7/3/2023 7:00,52,213,82438,170701,265,253139,MONDAY,0,0,18.3,100,13,1009.6,Rain
7/3/2023 8:00,78,390,108160,340225,468,448385,MONDAY,0,0,18.3,97,18.4,1009,Rain
7/3/2023 9:00,99,339,203037,254686,438,457723,MONDAY,0,0,18.3,97,18.4,1009,Cloudy
7/3/2023 10:00,101,269,1427010,201033,370,1628043,MONDAY,0,0,18.3,97,11.2,1009.2,Cloudy
7/3/2023 11:00,171,313,458397,243201,484,701598,MONDAY,0,0,18.9,96,13,1008.8,Cloudy
7/3/2023 12:00,276,447,652827,362189,723,1015016,MONDAY,0,0,18.9,96,13,1008.8,Rain
7/3/2023 13:00,255,456,555334,855446,711,1410780,MONDAY,0,0,19.4,97,13,1009.7,Cloudy
7/3/2023 14:00,326,515,714099,447559,841,1161658,MONDAY,0,0,19.4,97,13,1009.7,Cloudy
7/3/2023 15:00,305,535,727956,440719,840,1168675,MONDAY,0,0,21.1,84,5.4,1010.7,Cloudy
7/3/2023 16:00,366,610,902001,534007,976,1436008,MONDAY,0,0,22.2,79,13,1010.7,Cloudy
7/3/2023 17:00,345,779,856281,706604,1124,1562885,MONDAY,0,0,22.2,79,13,1010.7,Cloudy
7/3/2023 18:00,413,731,908662,651904,1144,1560566,MONDAY,0,0,23.9,74,5.4,1010.9,Cloudy
7/3/2023 19:00,366,597,1512680,550638,963,2063318,MONDAY,0,0,21.7,81,13,1011,Cloudy
7/3/2023 20:00,283,427,644173,420981,710,1065154,MONDAY,0,0,22.8,79,11.2,1010.9,Cloudy
7/3/2023 21:00,166,319,467454,293305,485,760759,MONDAY,0,0,21.7,81,13,1010.9,Cloudy
7/3/2023 22:00,160,216,302061,176612,376,478673,MONDAY,0,0,21.7,81,13,1010.9,Cloudy
7/3/2023 23:00,99,131,172452,103461,230,275913,MONDAY,0,0,20,87,5.4,1010.9,Cloudy
7/4/2023 0:00,104,89,1029666,67159,193,1096825,TUESDAY,0,1,19.4,91,7.6,1011.5,Cloudy
7/4/2023 1:00,42,30,91491,25573,72,117064,TUESDAY,0,1,20.6,90,13,1012.1,Cloudy
7/4/2023 2:00,4,12,1868,10757,16,12625,TUESDAY,0,1,20.6,90,13,1012.1,Cloudy
7/4/2023 3:00,3,7,2804,6117,10,8921,TUESDAY,0,1,20,90,7.6,1012.5,Cloudy
7/4/2023 4:00,7,10,118030,8019,17,126049,TUESDAY,0,1,20,90,7.6,1012,Cloudy
7/4/2023 5:00,3,11,740319,23217,14,763536,TUESDAY,0,1,20,93,0,1012.3,Cloudy
7/4/2023 6:00,7,39,9744,32348,46,42092,TUESDAY,0,1,20,93,0,1012.3,Cloudy
7/4/2023 7:00,24,81,35202,67139,105,102341,TUESDAY,0,1,20,96,0,1011.5,Cloudy
7/4/2023 8:00,54,157,210295,141483,211,351778,TUESDAY,0,1,19.4,97,7.6,1011.5,Cloudy
7/4/2023 9:00,92,215,814964,177117,307,992081,TUESDAY,0,1,19.4,100,5.4,1012.2,Cloudy
7/4/2023 10:00,164,330,2837186,288183,494,3125369,TUESDAY,0,1,20,96,11.2,1012.2,Cloudy
7/4/2023 11:00,178,316,404240,288657,494,692897,TUESDAY,0,1,20,96,5.4,1013,Rain
7/4/2023 12:00,241,355,1041467,314162,596,1355629,TUESDAY,0,1,20,96,5.4,1013,Rain
7/4/2023 13:00,292,418,584689,368576,710,953265,TUESDAY,0,1,20.6,93,7.6,1013.3,Rain
7/4/2023 14:00,170,276,430087,216838,446,646925,TUESDAY,0,1,21.1,93,11.2,1013.4,Rain
7/4/2023 15:00,70,131,261188,90552,201,351740,TUESDAY,0,1,21.1,93,9.4,1012.9,Rain
7/4/2023 16:00,42,76,76984,57368,118,134352,TUESDAY,0,1,21.1,93,9.4,1012.9,Rain
7/4/2023 17:00,109,258,2006575,248291,367,2254866,TUESDAY,0,1,20.6,90,14.8,1012.8,Rain
7/4/2023 18:00,277,386,1507096,395433,663,1902529,TUESDAY,0,1,20.6,90,14.8,1012.8,Rain
7/4/2023 19:00,325,409,775969,503990,734,1279959,TUESDAY,0,1,20,93,13,1012.9,Rain
7/4/2023 20:00,364,409,4707981,415898,773,5123879,TUESDAY,0,1,19.4,97,11.2,1012.8,Cloudy
7/4/2023 21:00,397,392,990259,484293,789,1474552,TUESDAY,0,1,19.4,97,11.2,1012.8,Cloudy
7/4/2023 22:00,347,256,2371504,415117,603,2786621,TUESDAY,0,1,19.4,97,9.4,1013.5,Cloudy
7/4/2023 23:00,680,569,4907114,1172815,1249,6079929,TUESDAY,0,1,20,96,0,1013.5,Cloudy
7/5/2023 0:00,109,138,6064583,149243,247,6213826,WEDNESDAY,0,0,21.1,87,0,1013.3,Cloudy
7/5/2023 1:00,47,46,118431,41275,93,159706,WEDNESDAY,0,0,18.9,100,0,1013.8,Cloudy
7/5/2023 2:00,24,16,4118768,10830,40,4129598,WEDNESDAY,0,0,20,96,13,1014.8,Cloudy
7/5/2023 3:00,17,7,568769,4235,24,573004,WEDNESDAY,0,0,20,96,13,1014.8,Cloudy
7/5/2023 4:00,6,15,5900,307379,21,313279,WEDNESDAY,0,0,20,96,11.2,1014,Cloudy
7/5/2023 5:00,15,76,14062,125505,91,139567,WEDNESDAY,0,0,20,96,9.4,1014.2,Cloudy
7/5/2023 6:00,30,173,25081,145304,203,170385,WEDNESDAY,0,0,20,96,9.4,1013.9,Cloudy
7/5/2023 7:00,74,476,75855,407466,550,483321,WEDNESDAY,0,0,20,96,9.4,1013.9,Cloudy
7/5/2023 8:00,154,911,218733,718875,1065,937608,WEDNESDAY,0,0,20.6,96,7.6,1013.9,Cloudy
7/5/2023 9:00,126,583,778385,3189436,709,3967821,WEDNESDAY,0,0,21.1,93,7.6,1013.9,Cloudy
7/5/2023 10:00,150,363,323940,317564,513,641504,WEDNESDAY,0,0,22.2,87,7.6,1014.1,Cloudy
7/5/2023 11:00,194,369,348686,359712,563,708398,WEDNESDAY,0,0,23.3,79,11.2,1014.3,Cloudy
7/5/2023 12:00,182,427,1102773,304049,609,1406822,WEDNESDAY,0,0,23.3,79,11.2,1014.3,Cloudy
7/5/2023 13:00,209,390,451360,327860,599,779220,WEDNESDAY,0,0,25,69,9.4,1014.5,Cloudy
7/5/2023 14:00,204,399,1614718,423757,603,2038475,WEDNESDAY,0,0,25,74,11.2,1014.7,Fair
7/5/2023 15:00,230,519,1599742,528109,749,2127851,WEDNESDAY,0,0,25,74,11.2,1014.6,Fair
7/5/2023 16:00,259,780,7544549,1194928,1039,8739477,WEDNESDAY,0,0,26.7,69,13,1014.5,Fair
7/5/2023 17:00,385,1213,973993,1326093,1598,2300086,WEDNESDAY,0,0,26.7,67,14.8,1013.9,Fair
7/5/2023 18:00,392,1098,2387384,1040631,1490,3428015,WEDNESDAY,0,0,26.7,67,14.8,1013.9,Fair
7/5/2023 19:00,310,753,3186935,641994,1063,3828929,WEDNESDAY,0,0,26.1,65,18.4,1013.8,Rain
7/5/2023 20:00,240,608,3434594,550159,848,3984753,WEDNESDAY,0,0,27.2,62,13,1013.4,Cloudy
7/5/2023 21:00,228,443,3757869,499873,671,4257742,WEDNESDAY,0,0,27.2,62,13,1013.4,Cloudy
7/5/2023 22:00,115,222,143513,197641,337,341154,WEDNESDAY,0,0,25,69,11.2,1013.6,Fair
7/5/2023 23:00,56,132,547281,115678,188,662959,WEDNESDAY,0,0,23.9,76,11.2,1013.7,Fair
7/6/2023 0:00,33,46,677188,37521,79,714709,THURSDAY,0,0,24.4,74,9.4,1013.9,Fair
7/6/2023 1:00,24,29,53292,28921,53,82213,THURSDAY,0,0,24.4,74,9.4,1013.9,Fair
7/6/2023 2:00,6,19,5628,15226,25,20854,THURSDAY,0,0,23.9,88,7.6,1014,Fair
7/6/2023 3:00,3,6,59359,5363,9,64722,THURSDAY,0,0,23.9,88,7.6,1014,Fair
7/6/2023 4:00,5,16,32326,12459,21,44785,THURSDAY,0,0,23.9,84,5.4,1014,Fair
7/6/2023 5:00,16,91,25000,75638,107,100638,THURSDAY,0,0,22.8,90,11.2,1014.1,Fair
7/6/2023 6:00,42,246,45041,273480,288,318521,THURSDAY,0,0,23.3,91,13,1014.4,Fair
7/6/2023 7:00,115,614,120589,475196,729,595785,THURSDAY,0,0,23.3,91,13,1014.4,Fair
7/6/2023 8:00,178,1078,237366,1063992,1256,1301358,THURSDAY,0,0,22.8,90,9.4,1014.4,Fair
7/6/2023 9:00,142,659,212281,495738,801,708019,THURSDAY,0,0,22.2,94,7.6,1014.2,Fair
7/6/2023 10:00,125,368,1486315,302332,493,1788647,THURSDAY,0,0,22.2,94,7.6,1014.2,Fair
7/6/2023 11:00,184,371,388660,254489,555,643149,THURSDAY,0,0,25,85,9.4,1014,Fair
7/6/2023 12:00,174,404,296444,312426,578,608870,THURSDAY,0,0,25,85,9.4,1014,Fair
7/6/2023 13:00,198,373,355856,277663,571,633519,THURSDAY,0,0,28.3,70,0,1013.9,Fair
7/6/2023 14:00,217,402,354642,285959,619,640601,THURSDAY,0,0,27.8,74,13,1013.8,Fair
7/6/2023 15:00,240,458,2734645,2076567,698,4811212,THURSDAY,0,0,27.8,74,13,1013.8,Fair
7/6/2023 16:00,286,732,515330,605030,1018,1120360,THURSDAY,0,0,28.9,70,20.5,1013.4,Fair
7/6/2023 17:00,352,1164,695753,988950,1516,1684703,THURSDAY,0,0,28.9,70,20.5,1012.9,Fair
7/6/2023 18:00,374,995,1222607,843636,1369,2066243,THURSDAY,0,0,28.9,70,20.5,1012.9,Fair
7/6/2023 19:00,283,781,4363942,907005,1064,5270947,THURSDAY,0,0,28.9,65,20.5,1011.7,Fair
7/6/2023 20:00,229,543,539287,462845,772,1002132,THURSDAY,0,0,28.9,65,24.1,1011.7,Cloudy
7/6/2023 21:00,165,395,1164985,372505,560,1537490,THURSDAY,0,0,30,61,13,1010.8,Cloudy
7/6/2023 22:00,193,260,2839842,255503,453,3095345,THURSDAY,0,0,30,61,13,1010.8,Fair
7/6/2023 23:00,89,135,235104,116441,224,351545,THURSDAY,0,0,28.3,63,14.8,1011.4,Fair
7/7/2023 0:00,40,69,768604,58600,109,827204,FRIDAY,0,0,28.3,63,14.8,1011.4,Fair
7/7/2023 1:00,35,27,48559,24784,62,73343,FRIDAY,0,0,25.6,71,14.8,1012.3,Fair
7/7/2023 2:00,17,21,58687,248080,38,306767,FRIDAY,0,0,25.6,71,14.8,1012.3,Fair
7/7/2023 3:00,4,9,3807,7438,13,11245,FRIDAY,0,0,23.9,76,11.2,1012.3,Fair
7/7/2023 4:00,12,18,27057,18306,30,45363,FRIDAY,0,0,23.3,79,13,1012,Fair
7/7/2023 5:00,23,83,25830,58204,106,84034,FRIDAY,0,0,23.3,79,13,1012,Fair
7/7/2023 6:00,47,221,64083,168835,268,232918,FRIDAY,0,0,22.2,87,14.8,1011.8,Fair
7/7/2023 7:00,83,460,90625,360699,543,451324,FRIDAY,0,0,21.7,90,11.2,1011.9,Fair
7/7/2023 8:00,140,791,212610,619017,931,831627,FRIDAY,0,0,21.1,93,11.2,1012.1,Fair
7/7/2023 9:00,118,564,242186,420140,682,662326,FRIDAY,0,0,21.1,93,11.2,1012.1,Fair
7/7/2023 10:00,149,373,276170,320173,522,596343,FRIDAY,0,0,22.8,84,14.8,1012.2,Fair
7/7/2023 11:00,156,320,359656,249392,476,609048,FRIDAY,0,0,23.3,82,13,1012.4,Fair
7/7/2023 12:00,205,450,4110772,335242,655,4446014,FRIDAY,0,0,25,77,11.2,1012.4,Fair
7/7/2023 13:00,240,410,544955,319692,650,864647,FRIDAY,0,0,26.7,69,14.8,1012.2,Fair
7/7/2023 14:00,215,453,1145792,347234,668,1493026,FRIDAY,0,0,26.7,69,14.8,1012.2,Fair
7/7/2023 15:00,289,489,6868166,408132,778,7276298,FRIDAY,0,0,28.9,61,14.8,1011.7,Fair
7/7/2023 16:00,260,725,943200,698195,985,1641395,FRIDAY,0,0,27.8,65,14.8,1011,Rain
7/7/2023 17:00,336,987,526834,809127,1323,1335961,FRIDAY,0,0,28.9,61,13,1010.4,Fair
7/7/2023 18:00,408,829,892358,1008576,1237,1900934,FRIDAY,0,0,30,57,13,1009.8,Fair
7/7/2023 19:00,383,688,766653,640268,1071,1406921,FRIDAY,0,0,30,57,13,1009.8,Rain
7/7/2023 20:00,306,492,1366672,426147,798,1792819,FRIDAY,0,0,30,57,20.5,1009.6,Cloudy
7/7/2023 21:00,253,411,2568726,429671,664,2998397,FRIDAY,0,0,28.9,55,18.4,1010,Cloudy
7/7/2023 22:00,242,297,2209389,277894,539,2487283,FRIDAY,0,0,27.8,58,16.6,1010.7,Cloudy
7/7/2023 23:00,135,215,1031306,196211,350,1227517,FRIDAY,0,0,26.1,72,16.6,1010.8,Cloudy
7/8/2023 0:00,127,145,2099030,120058,272,2219088,SATURDAY,1,0,26.1,72,16.6,1010.8,Cloudy
7/8/2023 1:00,164,103,2818040,103192,267,2921232,SATURDAY,1,0,24.4,82,16.6,1011,Cloudy
7/8/2023 2:00,76,53,1828203,48207,129,1876410,SATURDAY,1,0,23.9,84,11.2,1010.4,Cloudy
7/8/2023 3:00,22,20,122485,16021,42,138506,SATURDAY,1,0,23.9,84,11.2,1010.4,Cloudy
7/8/2023 4:00,8,15,676638,15061,23,691699,SATURDAY,1,0,23.3,88,11.2,1010.5,Cloudy
7/8/2023 5:00,6,28,9679,19307,34,28986,SATURDAY,1,0,23.3,88,11.2,1010.5,Cloudy
7/8/2023 6:00,19,66,72519,58390,85,130909,SATURDAY,1,0,23.3,88,13,1010.8,Cloudy
7/8/2023 7:00,51,132,292256,109943,183,402199,SATURDAY,1,0,23.3,88,13,1010.8,Cloudy
7/8/2023 8:00,78,266,148172,211358,344,359530,SATURDAY,1,0,22.8,90,11.2,1011.1,Cloudy
7/8/2023 9:00,168,418,1265322,398236,586,1663558,SATURDAY,1,0,22.8,90,11.2,1011.1,Cloudy
7/8/2023 10:00,266,478,685729,450998,744,1136727,SATURDAY,1,0,22.8,90,7.6,1011.5,Cloudy
7/8/2023 11:00,329,520,760623,516939,849,1277562,SATURDAY,1,0,23.3,91,7.6,1011.5,Cloudy
7/8/2023 12:00,376,558,1394476,567547,934,1962023,SATURDAY,1,0,25,82,13,1011.8,Cloudy
7/8/2023 13:00,422,521,2080750,465642,943,2546392,SATURDAY,1,0,23.9,88,13,1011.6,Cloudy
7/8/2023 14:00,447,537,1479689,507567,984,1987256,SATURDAY,1,0,23.9,88,13,1011.6,Cloudy
7/8/2023 15:00,463,551,3415017,541376,1014,3956393,SATURDAY,1,0,23.9,88,18.4,1011.7,Cloudy
7/8/2023 16:00,424,555,991604,1059901,979,2051505,SATURDAY,1,0,23.9,88,18.4,1011.7,Cloudy
7/8/2023 17:00,400,589,1000320,1673695,989,2674015,SATURDAY,1,0,23.9,84,16.6,1011.4,Cloudy
7/8/2023 18:00,414,623,1909747,793555,1037,2703302,SATURDAY,1,0,23.3,88,22.3,1011,Cloudy
7/8/2023 19:00,444,564,1410366,713667,1008,2124033,SATURDAY,1,0,23.3,88,22.3,1011,Cloudy
7/8/2023 20:00,311,466,4913103,576637,777,5489740,SATURDAY,1,0,22.8,87,24.1,1010.9,Cloudy
7/8/2023 21:00,243,360,445951,374093,603,820044,SATURDAY,1,0,22.8,87,24.1,1010.9,Cloudy
7/8/2023 22:00,200,254,1417345,321368,454,1738713,SATURDAY,1,0,21.7,94,24.1,1010.3,Cloudy
7/8/2023 23:00,191,201,3581123,199591,392,3780714,SATURDAY,1,0,21.7,94,14.8,1010.5,Cloudy
7/9/2023 0:00,160,126,2042213,184308,286,2226521,SUNDAY,1,0,20,100,11.2,1010.7,Cloudy
7/9/2023 1:00,146,104,2210855,100661,250,2311516,SUNDAY,1,0,20,100,13,1011,Cloudy
7/9/2023 2:00,97,48,217299,45929,145,263228,SUNDAY,1,0,20,100,13,1011,Cloudy
7/9/2023 3:00,20,17,692515,10944,37,703459,SUNDAY,1,0,20.6,96,7.6,1011,Cloudy
7/9/2023 4:00,13,15,69583,14990,28,84573,SUNDAY,1,0,20,100,7.6,1010.9,Cloudy
7/9/2023 5:00,12,24,15741,29149,36,44890,SUNDAY,1,0,20.6,96,0,1011.1,Cloudy
7/9/2023 6:00,18,54,164390,72062,72,236452,SUNDAY,1,0,20.6,96,0,1011.1,Cloudy
7/9/2023 7:00,41,124,61381,102208,165,163589,SUNDAY,1,0,22.2,94,11.2,1011.3,Cloudy
7/9/2023 8:00,90,187,184505,132859,277,317364,SUNDAY,1,0,21.7,94,11.2,1011.3,Cloudy
7/9/2023 9:00,166,295,1690750,273445,461,1964195,SUNDAY,1,0,21.7,94,11.2,1011.3,Cloudy
7/9/2023 10:00,218,393,432652,395816,611,828468,SUNDAY,1,0,21.7,94,11.2,1011.6,Cloudy
7/9/2023 11:00,341,481,812369,452405,822,1264774,SUNDAY,1,0,21.7,94,11.2,1011.6,Cloudy
7/9/2023 12:00,401,621,1414465,616312,1022,2030777,SUNDAY,1,0,22.8,87,7.6,1011.9,Cloudy
7/9/2023 13:00,423,606,3113086,570732,1029,3683818,SUNDAY,1,0,23.3,88,11.2,1012.1,Cloudy
7/9/2023 14:00,468,629,986915,590648,1097,1577563,SUNDAY,1,0,23.9,82,14.8,1012,Cloudy
7/9/2023 15:00,461,619,2579491,686812,1080,3266303,SUNDAY,1,0,23.9,82,14.8,1012,Cloudy
7/9/2023 16:00,417,667,3829822,680773,1084,4510595,SUNDAY,1,0,23.9,84,22.3,1011.7,Cloudy
7/9/2023 17:00,498,670,2512083,1234702,1168,3746785,SUNDAY,1,0,23.9,84,22.3,1011.7,Cloudy
7/9/2023 18:00,385,637,3149574,2985508,1022,6135082,SUNDAY,1,0,22.8,87,25.9,1011.4,Cloudy
7/9/2023 19:00,259,489,397550,528948,748,926498,SUNDAY,1,0,21.7,94,20.5,1011.3,Cloudy
7/9/2023 20:00,189,403,353022,398668,592,751690,SUNDAY,1,0,22.2,87,16.6,1011.2,Cloudy
7/9/2023 21:00,127,267,181363,319059,394,500422,SUNDAY,1,0,21.1,93,18.4,1011,Cloudy
7/9/2023 22:00,84,190,323834,534647,274,858481,SUNDAY,1,0,21.1,93,14.8,1011.2,Cloudy
7/9/2023 23:00,72,91,2043255,72989,163,2116244,SUNDAY,1,0,21.1,93,14.8,1012,Cloudy
7/10/2023 0:00,31,45,61807,90375,76,152182,MONDAY,0,0,21.1,93,18.4,1011.6,Cloudy
7/10/2023 1:00,17,19,1655331,18434,36,1673765,MONDAY,0,0,20.6,96,18.4,1011.4,Cloudy
7/10/2023 2:00,9,17,14704,14492,26,29196,MONDAY,0,0,20.6,96,18.4,1011.1,Cloudy
7/10/2023 3:00,2,9,8746,10959,11,19705,MONDAY,0,0,20.6,96,20.5,1011.1,Cloudy
7/10/2023 4:00,4,19,709179,16509,23,725688,MONDAY,0,0,20,100,18.4,1011,Cloudy
7/10/2023 5:00,8,77,5220,75114,85,80334,MONDAY,0,0,20,100,14.8,1009.9,Cloudy
7/10/2023 6:00,42,217,69158,202567,259,271725,MONDAY,0,0,20,100,14.8,1009.7,Cloudy
7/10/2023 7:00,67,468,302292,437299,535,739591,MONDAY,0,0,20,100,16.6,1009.5,Cloudy
7/10/2023 8:00,38,382,30905,265002,420,295907,MONDAY,0,0,20,100,16.6,1009.5,Cloudy
7/10/2023 9:00,21,260,19101,179418,281,198519,MONDAY,0,0,20,100,18.4,1009.2,Cloudy
7/10/2023 10:00,48,220,78530,157300,268,235830,MONDAY,0,0,20,100,16.6,1009.5,Cloudy
7/10/2023 11:00,43,217,67549,163780,260,231329,MONDAY,0,0,20,100,16.6,1009.5,Rain
7/10/2023 12:00,33,170,39556,188818,203,228374,MONDAY,0,0,20,100,22.3,1009.3,Rain
7/10/2023 13:00,20,80,41672,53284,100,94956,MONDAY,0,0,20,100,22.3,1009.3,Cloudy
7/10/2023 14:00,12,82,48580,55285,94,103865,MONDAY,0,0,20,100,18.4,1009.2,Cloudy
7/10/2023 15:00,48,260,308737,196681,308,505418,MONDAY,0,0,20,100,24.1,1008.9,Cloudy
7/10/2023 16:00,139,535,216045,423970,674,640015,MONDAY,0,0,20,100,16.6,1008.9,Rain
7/10/2023 17:00,205,954,273051,1334815,1159,1607866,MONDAY,0,0,20,100,16.6,1008.9,Rain
7/10/2023 18:00,134,609,400848,455217,743,856065,MONDAY,0,0,20,100,16.6,1008.5,Rain
7/10/2023 19:00,56,322,1022007,221771,378,1243778,MONDAY,0,0,20,100,18.4,1007.8,Cloudy
7/10/2023 20:00,47,277,1269453,209396,324,1478849,MONDAY,0,0,20.6,96,16.6,1007.4,Cloudy
7/10/2023 21:00,51,255,711298,227547,306,938845,MONDAY,0,0,20,100,14.8,1007.7,Cloudy
7/10/2023 22:00,39,149,39618,102304,188,141922,MONDAY,0,0,20,100,14.8,1007.7,Cloudy
7/10/2023 23:00,32,102,40813,86484,134,127297,MONDAY,0,0,20,100,9.4,1008,Cloudy
7/11/2023 0:00,17,32,30982,28598,49,59580,TUESDAY,0,0,20,100,11.2,1007.4,Cloudy
7/11/2023 1:00,19,23,18021,13161,42,31182,TUESDAY,0,0,20.6,96,5.4,1007.4,Cloudy
7/11/2023 2:00,10,13,13338,9639,23,22977,TUESDAY,0,0,21.1,97,11.2,1007.4,Rain
7/11/2023 3:00,1,4,1226,3816,5,5042,TUESDAY,0,0,21.1,97,11.2,1007.4,Cloudy
7/11/2023 4:00,2,23,1581,13129,25,14710,TUESDAY,0,0,21.7,90,11.2,1007.5,Cloudy
7/11/2023 5:00,15,109,13964,449182,124,463146,TUESDAY,0,0,20.6,87,16.6,1007.2,Cloudy
7/11/2023 6:00,61,315,62275,291803,376,354078,TUESDAY,0,0,20,90,9.4,1006.8,Cloudy
7/11/2023 7:00,111,792,219594,845499,903,1065093,TUESDAY,0,0,20,90,9.4,1006.8,Fair
7/11/2023 8:00,203,1340,227385,1331183,1543,1558568,TUESDAY,0,0,18.9,93,14.8,1006.8,Fair
7/11/2023 9:00,114,689,1447056,690523,803,2137579,TUESDAY,0,0,20,84,22.3,1007.8,Fair
7/11/2023 10:00,131,367,313768,501841,498,815609,TUESDAY,0,0,20.6,84,20.5,1008.4,Fair
7/11/2023 11:00,148,362,2542409,327998,510,2870407,TUESDAY,0,0,21.7,79,20.5,1008.6,Fair
7/11/2023 12:00,138,416,1022847,2000017,554,3022864,TUESDAY,0,0,23.3,74,22.3,1009.1,Fair
7/11/2023 13:00,168,386,2169864,314412,554,2484276,TUESDAY,0,0,23.3,74,22.3,1009.1,Fair
7/11/2023 14:00,173,405,730813,323510,578,1054323,TUESDAY,0,0,26.1,62,22.3,1008.9,Fair
7/11/2023 15:00,203,515,1207485,426573,718,1634058,TUESDAY,0,0,27.2,58,18.4,1008.9,Fair
7/11/2023 16:00,321,903,440227,1304449,1224,1744676,TUESDAY,0,0,28.3,51,22.3,1009,Fair
7/11/2023 17:00,450,1525,946036,1516760,1975,2462796,TUESDAY,0,0,30,45,22.3,1008.6,Fair
7/11/2023 18:00,390,1198,2015855,1142056,1588,3157911,TUESDAY,0,0,30,45,22.3,1008.6,Fair
7/11/2023 19:00,334,909,1571459,891546,1243,2463005,TUESDAY,0,0,30.6,42,20.5,1009.4,Rain
7/11/2023 20:00,235,694,1138063,622771,929,1760834,TUESDAY,0,0,30.6,45,18.4,1009.3,Fair
7/11/2023 21:00,207,432,505845,2284999,639,2790844,TUESDAY,0,0,30.6,45,18.4,1009.3,Fair
7/11/2023 22:00,105,269,602970,242770,374,845740,TUESDAY,0,0,30,48,13,1009.4,Fair
7/11/2023 23:00,56,128,140136,117674,184,257810,TUESDAY,0,0,30,48,13,1009.4,Fair
7/12/2023 0:00,38,62,76840,116060,100,192900,WEDNESDAY,0,0,27.8,56,13,1010.3,Fair
7/12/2023 1:00,30,28,1044548,20892,58,1065440,WEDNESDAY,0,0,27.2,58,9.4,1010.6,Fair
7/12/2023 2:00,18,19,2550286,20746,37,2571032,WEDNESDAY,0,0,26.7,60,7.6,1010.8,Fair
7/12/2023 3:00,4,12,14339,26311,16,40650,WEDNESDAY,0,0,26.7,60,7.6,1010.8,Fair
7/12/2023 4:00,5,15,5353,7425,20,12778,WEDNESDAY,0,0,26.1,62,7.6,1011,Fair
7/12/2023 5:00,27,96,2297107,74469,123,2371576,WEDNESDAY,0,0,23.3,79,13,1010.9,Fair
7/12/2023 6:00,64,287,57210,220011,351,277221,WEDNESDAY,0,0,22.8,79,7.6,1011.1,Clear
7/12/2023 7:00,132,757,129588,594395,889,723983,WEDNESDAY,0,0,22.8,79,7.6,1011.4,Clear
7/12/2023 8:00,208,1263,216051,1028791,1471,1244842,WEDNESDAY,0,0,22.8,79,7.6,1011.4,Clear
7/12/2023 9:00,152,657,272271,1259107,809,1531378,WEDNESDAY,0,0,24.4,71,11.2,1012,Fair
7/12/2023 10:00,109,353,403767,322912,462,726679,WEDNESDAY,0,0,24.4,71,11.2,1012,Fair
7/12/2023 11:00,143,356,611014,262636,499,873650,WEDNESDAY,0,0,26.1,65,9.4,1012.6,Fair
7/12/2023 12:00,172,420,5226610,333681,592,5560291,WEDNESDAY,0,0,27.8,60,7.6,1012.8,Fair
7/12/2023 13:00,137,426,2403705,321924,563,2725629,WEDNESDAY,0,0,27.8,60,7.6,1012.8,Fair
7/12/2023 14:00,164,344,247841,256296,508,504137,WEDNESDAY,0,0,28.9,59,11.2,1012.7,Fair
7/12/2023 15:00,183,507,1110902,412277,690,1523179,WEDNESDAY,0,0,28.9,59,14.8,1012.3,Fair
7/12/2023 16:00,311,896,450837,829316,1207,1280153,WEDNESDAY,0,0,30.6,39,16.6,1012.1,Fair
7/12/2023 17:00,433,1419,3631542,1459811,1852,5091353,WEDNESDAY,0,0,29.4,53,16.6,1011.7,Fair
7/12/2023 18:00,380,1223,1931359,1769569,1603,3700928,WEDNESDAY,0,0,28.9,59,22.3,1011.5,Fair
7/12/2023 19:00,335,866,3648425,1003714,1201,4652139,WEDNESDAY,0,0,28.9,59,22.3,1011.5,Cloudy
7/12/2023 20:00,246,645,1415198,643305,891,2058503,WEDNESDAY,0,0,31.7,44,18.4,1011,Cloudy
7/12/2023 21:00,165,386,327017,352289,551,679306,WEDNESDAY,0,0,31.7,42,14.8,1011,Cloudy
7/12/2023 22:00,100,230,1009568,204950,330,1214518,WEDNESDAY,0,0,29.4,59,16.6,1011.5,Cloudy
7/12/2023 23:00,103,145,154762,130443,248,285205,WEDNESDAY,0,0,29.4,59,16.6,1011.5,Cloudy
7/13/2023 0:00,58,74,1054851,67072,132,1121923,THURSDAY,0,0,28.9,57,18.4,1012.5,Cloudy
7/13/2023 1:00,26,41,35189,38367,67,73556,THURSDAY,0,0,28.3,55,16.6,1012.8,Cloudy
7/13/2023 2:00,9,15,43181,10933,24,54114,THURSDAY,0,0,26.7,58,11.2,1013,Cloudy
7/13/2023 3:00,10,9,17080,12370,19,29450,THURSDAY,0,0,26.7,58,11.2,1013,Fair
7/13/2023 4:00,5,17,4895,13189,22,18084,THURSDAY,0,0,23.3,74,9.4,1012.7,Fair
7/13/2023 5:00,20,88,41862,68499,108,110361,THURSDAY,0,0,23.9,74,0,1012.4,Fair
7/13/2023 6:00,78,263,88892,201861,341,290753,THURSDAY,0,0,23.3,76,0,1012.2,Fair
7/13/2023 7:00,201,779,353037,643430,980,996467,THURSDAY,0,0,22.2,84,7.6,1012.5,Fair
7/13/2023 8:00,237,1227,266122,1031773,1464,1297895,THURSDAY,0,0,22.2,84,7.6,1012.5,Fair
7/13/2023 9:00,130,682,234280,551131,812,785411,THURSDAY,0,0,22.8,84,7.6,1012.8,Cloudy
7/13/2023 10:00,105,366,1229882,319573,471,1549455,THURSDAY,0,0,23.3,85,7.6,1013.2,Cloudy
7/13/2023 11:00,167,395,308692,324970,562,633662,THURSDAY,0,0,24.4,79,9.4,1013.3,Cloudy
7/13/2023 12:00,159,494,293183,1097585,653,1390768,THURSDAY,0,0,24.4,79,11.2,1013.1,Cloudy
7/13/2023 13:00,188,382,329298,366703,570,696001,THURSDAY,0,0,24.4,79,11.2,1013.1,Cloudy
7/13/2023 14:00,205,389,1794745,298413,594,2093158,THURSDAY,0,0,27.8,72,13,1012.7,Cloudy
7/13/2023 15:00,282,577,2798911,3774451,859,6573362,THURSDAY,0,0,28.9,65,14.8,1012.4,Cloudy
7/13/2023 16:00,295,964,448339,893682,1259,1342021,THURSDAY,0,0,28.9,65,14.8,1012.4,Cloudy
7/13/2023 17:00,479,1422,1076263,1304952,1901,2381215,THURSDAY,0,0,31.1,48,22.3,1011.6,Cloudy
7/13/2023 18:00,458,1181,1247713,1663643,1639,2911356,THURSDAY,0,0,30.6,51,27.7,1010.9,Cloudy
7/13/2023 19:00,393,833,3016610,871690,1226,3888300,THURSDAY,0,0,29.4,51,27.7,1010.9,Cloudy
7/13/2023 20:00,271,674,515243,800932,945,1316175,THURSDAY,0,0,28.9,53,29.5,1010.6,Cloudy
7/13/2023 21:00,188,430,2419250,423368,618,2842618,THURSDAY,0,0,27.8,60,25.9,1010.8,Cloudy
7/13/2023 22:00,135,323,587654,308350,458,896004,THURSDAY,0,0,27.8,60,25.9,1010.8,Cloudy
7/13/2023 23:00,83,140,120884,138418,223,259302,THURSDAY,0,0,26.1,60,25.9,1011,Cloudy
7/14/2023 0:00,22,40,56559,81260,62,137819,FRIDAY,0,0,25.6,64,18.4,1011,Cloudy
7/14/2023 1:00,22,28,41952,24885,50,66837,FRIDAY,0,0,24.4,71,16.6,1011.9,Cloudy
7/14/2023 2:00,10,18,14970,10507,28,25477,FRIDAY,0,0,24.4,71,16.6,1011.9,Cloudy
7/14/2023 3:00,7,5,10235,3693,12,13928,FRIDAY,0,0,24.4,79,18.4,1011.8,Cloudy
7/14/2023 4:00,3,24,835047,32289,27,867336,FRIDAY,0,0,22.2,79,14.8,1012.8,Cloudy
7/14/2023 5:00,5,23,1545,17079,28,18624,FRIDAY,0,0,21.1,87,16.6,1012.9,Cloudy
7/14/2023 6:00,33,194,132526,146070,227,278596,FRIDAY,0,0,21.1,87,16.6,1012.9,Cloudy
7/14/2023 7:00,108,525,159733,421222,633,580955,FRIDAY,0,0,21.1,87,11.2,1012.1,Cloudy
7/14/2023 8:00,150,900,171674,768469,1050,940143,FRIDAY,0,0,21.7,81,20.5,1013.7,Cloudy
7/14/2023 9:00,145,611,262286,487222,756,749508,FRIDAY,0,0,21.7,81,20.5,1013.7,Cloudy
7/14/2023 10:00,131,362,219441,274281,493,493722,FRIDAY,0,0,20.6,93,7.6,1012.8,Cloudy
7/14/2023 11:00,180,426,619417,330636,606,950053,FRIDAY,0,0,22.2,84,9.4,1013.2,Cloudy
7/14/2023 12:00,162,465,352144,1322144,627,1674288,FRIDAY,0,0,22.2,84,9.4,1013.2,Cloudy
7/14/2023 13:00,197,511,798498,356217,708,1154715,FRIDAY,0,0,23.3,79,7.6,1013.4,Cloudy
7/14/2023 14:00,248,472,534417,378117,720,912534,FRIDAY,0,0,23.9,79,11.2,1013.9,Cloudy
7/14/2023 15:00,263,526,2057049,458311,789,2515360,FRIDAY,0,0,23.9,79,7.6,1014.5,Rain
7/14/2023 16:00,326,857,2875265,714775,1183,3590040,FRIDAY,0,0,23.9,79,7.6,1014.5,Rain
7/14/2023 17:00,401,1027,4089565,900481,1428,4990046,FRIDAY,0,0,25.6,74,13,1014.3,Rain
7/14/2023 18:00,429,999,4813853,1752443,1428,6566296,FRIDAY,0,0,25.6,71,11.2,1014.3,Rain
7/14/2023 19:00,388,789,3200577,710607,1177,3911184,FRIDAY,0,0,26.7,67,16.6,1013.9,Rain
7/14/2023 20:00,309,556,4433000,529892,865,4962892,FRIDAY,0,0,26.7,69,20.5,1013.8,Rain
7/14/2023 21:00,263,401,700392,356746,664,1057138,FRIDAY,0,0,26.7,69,24.1,1013.5,Rain
7/14/2023 22:00,219,308,1316030,265855,527,1581885,FRIDAY,0,0,26.7,69,24.1,1013.5,Rain
7/14/2023 23:00,183,248,2002326,309679,431,2312005,FRIDAY,0,0,25,77,13,1013.6,Rain
7/15/2023 0:00,157,170,356057,591246,327,947303,SATURDAY,1,0,24.4,79,14.8,1014.2,Rain
7/15/2023 1:00,168,141,907589,173401,309,1080990,SATURDAY,1,0,23.3,82,11.2,1014.5,Rain
7/15/2023 2:00,89,81,678410,1176545,170,1854955,SATURDAY,1,0,23.3,82,11.2,1014.5,Rain
7/15/2023 3:00,23,20,34011,15916,43,49927,SATURDAY,1,0,22.8,84,11.2,1014.4,Cloudy
7/15/2023 4:00,11,17,633750,14860,28,648610,SATURDAY,1,0,22.2,87,14.8,1014.6,Cloudy
7/15/2023 5:00,16,23,40961,20311,39,61272,SATURDAY,1,0,21.7,90,9.4,1014.6,Cloudy
7/15/2023 6:00,27,86,230765,65343,113,296108,SATURDAY,1,0,22.2,91,7.6,1014.5,Cloudy
7/15/2023 7:00,60,128,67025,116349,188,183374,SATURDAY,1,0,22.2,91,7.6,1014.5,Cloudy
7/15/2023 8:00,133,284,2207227,260268,417,2467495,SATURDAY,1,0,22.2,91,9.4,1013.8,Cloudy
7/15/2023 9:00,209,406,390527,354652,615,745179,SATURDAY,1,0,21.7,94,7.6,1014.2,Cloudy
7/15/2023 10:00,299,502,1116195,967689,801,2083884,SATURDAY,1,0,21.7,94,7.6,1014.2,Cloudy
7/15/2023 11:00,404,576,1540063,492568,980,2032631,SATURDAY,1,0,25.6,82,14.8,1014.3,Cloudy
7/15/2023 12:00,409,604,1056337,562681,1013,1619018,SATURDAY,1,0,25.6,82,14.8,1014.3,Cloudy
7/15/2023 13:00,452,621,1680767,1166300,1073,2847067,SATURDAY,1,0,26.7,76,18.4,1015.4,Cloudy
7/15/2023 14:00,494,647,4309534,635818,1141,4945352,SATURDAY,1,0,27.8,74,18.4,1015.5,Cloudy
7/15/2023 15:00,544,599,1042040,676054,1143,1718094,SATURDAY,1,0,28.3,72,18.4,1015.2,Cloudy
7/15/2023 16:00,523,580,1450053,561938,1103,2011991,SATURDAY,1,0,28.3,72,16.6,1014.7,Cloudy
7/15/2023 17:00,478,634,1740584,625559,1112,2366143,SATURDAY,1,0,28.3,72,16.6,1014.7,Cloudy
7/15/2023 18:00,481,675,1021181,744239,1156,1765420,SATURDAY,1,0,28.3,72,14.8,1014,Cloudy
7/15/2023 19:00,464,595,2005903,581568,1059,2587471,SATURDAY,1,0,28.9,67,20.5,1013.8,Cloudy
7/15/2023 20:00,407,496,2450138,487943,903,2938081,SATURDAY,1,0,30,65,24.1,1013.2,Cloudy
7/15/2023 21:00,282,381,657864,791495,663,1449359,SATURDAY,1,0,30,65,24.1,1013.2,Cloudy
7/15/2023 22:00,240,290,2637780,294422,530,2932202,SATURDAY,1,0,28.3,72,20.5,1013.1,Cloudy
7/15/2023 23:00,198,216,4589517,203898,414,4793415,SATURDAY,1,0,27.2,74,20.5,1013.8,Cloudy
7/16/2023 0:00,165,154,3132700,142607,319,3275307,SUNDAY,1,0,25.6,82,18.4,1014,Cloudy
7/16/2023 1:00,177,143,2899112,147684,320,3046796,SUNDAY,1,0,25,85,14.8,1014.5,Cloudy
7/16/2023 2:00,102,69,368065,71389,171,439454,SUNDAY,1,0,25,85,14.8,1014.5,Cloudy
7/16/2023 3:00,24,16,460313,18096,40,478409,SUNDAY,1,0,24.4,88,9.4,1014.6,Cloudy
7/16/2023 4:00,9,29,20865,22480,38,43345,SUNDAY,1,0,25,88,7.6,1014.2,Cloudy
7/16/2023 5:00,24,19,56997,24847,43,81844,SUNDAY,1,0,23.3,94,5.4,1014.2,Cloudy
7/16/2023 6:00,13,64,14937,52971,77,67908,SUNDAY,1,0,24.4,91,11.2,1013.6,Cloudy
7/16/2023 7:00,27,89,52024,70383,116,122407,SUNDAY,1,0,24.4,91,11.2,1013.6,Cloudy
7/16/2023 8:00,59,172,173608,138459,231,312067,SUNDAY,1,0,24.4,91,13,1013.2,Cloudy
7/16/2023 9:00,115,322,275991,276950,437,552941,SUNDAY,1,0,24.4,91,25.9,1013.2,Cloudy
7/16/2023 10:00,63,179,66303,122066,242,188369,SUNDAY,1,0,24.4,94,18.4,1012.7,Rain
7/16/2023 11:00,29,82,44432,111692,111,156124,SUNDAY,1,0,25,90,20.5,1012.1,Rain
7/16/2023 12:00,47,121,64310,87979,168,152289,SUNDAY,1,0,25,90,20.5,1012.1,Rain
7/16/2023 13:00,34,120,53023,114453,154,167476,SUNDAY,1,0,26.1,82,27.7,1011.5,Rain
7/16/2023 14:00,23,100,532272,74864,123,607136,SUNDAY,1,0,25.6,87,29.5,1011,Rain
7/16/2023 15:00,43,157,55030,120633,200,175663,SUNDAY,1,0,24.4,94,14.8,1011,Rain
7/16/2023 16:00,116,321,5113617,241626,437,5355243,SUNDAY,1,0,24.4,94,14.8,1011,Rain
7/16/2023 17:00,46,145,62255,115258,191,177513,SUNDAY,1,0,25.6,90,25.9,1010,Rain
7/16/2023 18:00,29,112,33002,84248,141,117250,SUNDAY,1,0,24.4,91,27.7,1010.2,Rain
7/16/2023 19:00,10,74,7130,54193,84,61323,SUNDAY,1,0,24.4,91,25.9,1010.2,Rain
7/16/2023 20:00,27,101,34945,74704,128,109649,SUNDAY,1,0,24.4,91,11.2,1009.9,Rain
7/16/2023 21:00,12,58,759991,40200,70,800191,SUNDAY,1,0,24.4,91,11.2,1009.9,Rain
7/16/2023 22:00,35,80,74273,67352,115,141625,SUNDAY,1,0,23.3,94,13,1009.9,Rain
7/16/2023 23:00,50,89,114433,70287,139,184720,SUNDAY,1,0,23.3,94,20.5,1009.8,Rain
7/17/2023 0:00,6,40,8794,34817,46,43611,MONDAY,0,0,23.3,94,20.5,1009.8,Rain
7/17/2023 1:00,13,28,18106,22780,41,40886,MONDAY,0,0,22.8,96,16.6,1009.7,Rain
7/17/2023 2:00,7,10,9150,8099,17,17249,MONDAY,0,0,23.3,94,16.6,1010.1,Rain
7/17/2023 3:00,9,6,9121,3412,15,12533,MONDAY,0,0,23.3,94,16.6,1010.1,Rain
7/17/2023 4:00,1,32,1524,30996,33,32520,MONDAY,0,0,23.3,94,14.8,1009.5,Rain
7/17/2023 5:00,22,94,31804,63253,116,95057,MONDAY,0,0,23.3,94,13,1009.7,Rain
7/17/2023 6:00,34,290,40969,225105,324,266074,MONDAY,0,0,23.3,97,11.2,1009.7,Rain
7/17/2023 7:00,98,678,106608,579935,776,686543,MONDAY,0,0,23.3,97,11.2,1009.7,Rain
7/17/2023 8:00,193,1102,202470,1138816,1295,1341286,MONDAY,0,0,23.3,94,11.2,1010.4,Cloudy
7/17/2023 9:00,139,641,235542,469333,780,704875,MONDAY,0,0,23.3,94,11.2,1010.4,Cloudy
7/17/2023 10:00,153,331,364026,290778,484,654804,MONDAY,0,0,23.9,90,14.8,1011.4,Rain
7/17/2023 11:00,166,317,1573710,266657,483,1840367,MONDAY,0,0,25,85,13,1011.7,Cloudy
7/17/2023 12:00,185,413,2351471,301305,598,2652776,MONDAY,0,0,25,85,13,1011.7,Cloudy
7/17/2023 13:00,151,360,258634,1224457,511,1483091,MONDAY,0,0,27.8,63,7.6,1012.1,Cloudy
7/17/2023 14:00,198,370,2720861,1169858,568,3890719,MONDAY,0,0,28.9,53,5.4,1012.5,Cloudy
7/17/2023 15:00,212,505,987770,387202,717,1374972,MONDAY,0,0,29.4,53,14.8,1012.5,Cloudy
7/17/2023 16:00,300,847,3731308,2695167,1147,6426475,MONDAY,0,0,29.4,53,14.8,1012.5,Cloudy
7/17/2023 17:00,439,1433,3308151,1282026,1872,4590177,MONDAY,0,0,31.1,43,14.8,1012.4,Cloudy
7/17/2023 18:00,377,1160,1331137,984080,1537,2315217,MONDAY,0,0,31.1,47,14.8,1012.3,Cloudy
7/17/2023 19:00,311,863,599349,1174501,1174,1773850,MONDAY,0,0,31.1,47,14.8,1012.3,Cloudy
7/17/2023 20:00,283,656,1009500,616328,939,1625828,MONDAY,0,0,30.6,46,24.1,1012.2,Cloudy
7/17/2023 21:00,178,429,524751,422210,607,946961,MONDAY,0,0,30.6,46,24.1,1012.2,Cloudy
7/17/2023 22:00,109,259,288302,249910,368,538212,MONDAY,0,0,30,50,16.6,1012.7,Cloudy
7/17/2023 23:00,78,105,124273,78795,183,203068,MONDAY,0,0,28.3,57,13,1013.1,Cloudy
7/18/2023 0:00,33,41,361449,68981,74,430430,TUESDAY,0,0,26.7,74,14.8,1013.6,Cloudy
7/18/2023 1:00,19,21,22593,18676,40,41269,TUESDAY,0,0,26.7,74,14.8,1014.1,Cloudy
7/18/2023 2:00,11,11,58659,8494,22,67153,TUESDAY,0,0,26.7,74,14.8,1014.1,Cloudy
7/18/2023 3:00,9,7,569840,8332,16,578172,TUESDAY,0,0,25.6,71,18.4,1015,Fair
7/18/2023 4:00,10,22,23247,15579,32,38826,TUESDAY,0,0,23.3,82,9.4,1015.2,Fair
7/18/2023 5:00,27,114,94667,84717,141,179384,TUESDAY,0,0,22.8,87,11.2,1015.1,Fair
7/18/2023 6:00,61,334,56877,352718,395,409595,TUESDAY,0,0,22.8,87,11.2,1015.1,Fair
7/18/2023 7:00,142,821,143231,1072589,963,1215820,TUESDAY,0,0,22.2,94,9.4,1014.9,Fair
7/18/2023 8:00,217,1316,809087,1821562,1533,2630649,TUESDAY,0,0,22.8,90,7.6,1015,Fair
7/18/2023 9:00,118,665,521536,877764,783,1399300,TUESDAY,0,0,22.2,94,5.4,1014.9,Cloudy
7/18/2023 10:00,128,355,626637,319482,483,946119,TUESDAY,0,0,22.8,90,11.2,1014.9,Cloudy
7/18/2023 11:00,117,353,268665,323070,470,591735,TUESDAY,0,0,22.8,90,11.2,1014.9,Cloudy
7/18/2023 12:00,198,473,1588742,341991,671,1930733,TUESDAY,0,0,24.4,88,13,1015.4,Cloudy
7/18/2023 13:00,198,391,2632295,285402,589,2917697,TUESDAY,0,0,25,82,14.8,1015.7,Cloudy
7/18/2023 14:00,168,438,562358,644338,606,1206696,TUESDAY,0,0,25.6,82,16.6,1015.5,Cloudy
7/18/2023 15:00,200,560,298554,458662,760,757216,TUESDAY,0,0,27.2,77,13,1015.1,Cloudy
7/18/2023 16:00,264,876,377537,952805,1140,1330342,TUESDAY,0,0,27.2,77,13,1015.1,Cloudy
7/18/2023 17:00,506,1533,675756,2160627,2039,2836383,TUESDAY,0,0,28.9,67,22.3,1014,Cloudy
7/18/2023 18:00,384,1201,697595,1147114,1585,1844709,TUESDAY,0,0,28.3,63,22.3,1013.5,Cloudy
7/18/2023 19:00,328,830,607563,731276,1158,1338839,TUESDAY,0,0,28.9,65,24.1,1013,Cloudy
7/18/2023 20:00,224,648,3524057,645048,872,4169105,TUESDAY,0,0,28.9,65,27.7,1012.8,Cloudy
7/18/2023 21:00,177,472,1630971,449387,649,2080358,TUESDAY,0,0,27.8,72,18.4,1013,Cloudy
7/18/2023 22:00,124,295,166929,234695,419,401624,TUESDAY,0,0,27.8,72,18.4,1013,Cloudy
7/18/2023 23:00,59,128,73917,123883,187,197800,TUESDAY,0,0,26.7,71,9.4,1012.9,Cloudy
7/19/2023 0:00,36,57,1206289,84496,93,1290785,WEDNESDAY,0,0,25.6,79,14.8,1012.8,Cloudy
7/19/2023 1:00,25,38,37613,38411,63,76024,WEDNESDAY,0,0,25.6,82,18.4,1013.3,Cloudy
7/19/2023 2:00,7,14,44917,10021,21,54938,WEDNESDAY,0,0,25.6,82,18.4,1013.3,Cloudy
7/19/2023 3:00,6,8,1458395,6017,14,1464412,WEDNESDAY,0,0,25,71,16.6,1013.7,Cloudy
7/19/2023 4:00,6,19,5824,11368,25,17192,WEDNESDAY,0,0,23.9,76,14.8,1013.8,Cloudy
7/19/2023 5:00,15,93,10504,93584,108,104088,WEDNESDAY,0,0,23.3,85,14.8,1013.4,Cloudy
7/19/2023 6:00,59,303,54804,218886,362,273690,WEDNESDAY,0,0,23.3,85,14.8,1013.4,Cloudy
7/19/2023 7:00,139,800,772228,651001,939,1423229,WEDNESDAY,0,0,22.8,90,13,1013.2,Cloudy
7/19/2023 8:00,239,1362,301046,1164450,1601,1465496,WEDNESDAY,0,0,22.8,87,9.4,1013.3,Cloudy
7/19/2023 9:00,132,709,546946,621150,841,1168096,WEDNESDAY,0,0,22.8,87,13,1013.9,Cloudy
7/19/2023 10:00,120,377,1220366,311264,497,1531630,WEDNESDAY,0,0,23.3,85,11.2,1014.3,Rain
7/19/2023 11:00,126,399,3185031,642138,525,3827169,WEDNESDAY,0,0,23.3,85,11.2,1014.3,Cloudy
7/19/2023 12:00,147,452,794465,330356,599,1124821,WEDNESDAY,0,0,25.6,67,13,1015,Cloudy
7/19/2023 13:00,169,412,447150,381744,581,828894,WEDNESDAY,0,0,26.1,65,9.4,1014.8,Fair
7/19/2023 14:00,167,403,1823048,895549,570,2718597,WEDNESDAY,0,0,26.1,65,9.4,1014.8,Fair
7/19/2023 15:00,238,553,1930229,643061,791,2573290,WEDNESDAY,0,0,27.2,61,14.8,1015,Fair
7/19/2023 16:00,309,936,569746,1021436,1245,1591182,WEDNESDAY,0,0,27.2,61,14.8,1015,Cloudy
7/19/2023 17:00,496,1569,3683400,1527909,2065,5211309,WEDNESDAY,0,0,28.9,49,9.4,1014.6,Cloudy
7/19/2023 18:00,432,1314,814277,1297130,1746,2111407,WEDNESDAY,0,0,28.9,45,16.6,1014.4,Cloudy
7/19/2023 19:00,340,923,1020429,1951396,1263,2971825,WEDNESDAY,0,0,29.4,43,14.8,1014.3,Rain
7/19/2023 20:00,255,688,448866,633978,943,1082844,WEDNESDAY,0,0,29.4,43,16.6,1014.7,Cloudy
7/19/2023 21:00,254,493,407927,413842,747,821769,WEDNESDAY,0,0,29.4,43,16.6,1014.7,Cloudy
7/19/2023 22:00,150,258,316343,265048,408,581391,WEDNESDAY,0,0,28.9,43,11.2,1014.8,Cloudy
7/19/2023 23:00,74,152,173568,155159,226,328727,WEDNESDAY,0,0,28.3,44,13,1014.6,Cloudy
7/20/2023 0:00,32,61,35019,45105,93,80124,THURSDAY,0,0,27.8,46,11.2,1015,Cloudy
7/20/2023 1:00,18,27,355537,22643,45,378180,THURSDAY,0,0,27.8,46,11.2,1015,Fair
7/20/2023 2:00,10,12,10567,8523,22,19090,THURSDAY,0,0,26.1,62,11.2,1016,Fair
7/20/2023 3:00,6,7,47276,7038,13,54314,THURSDAY,0,0,25,69,11.2,1016,Fair
7/20/2023 4:00,3,18,7662,15492,21,23154,THURSDAY,0,0,24.4,69,9.4,1015.8,Fair
7/20/2023 5:00,26,83,18833,59270,109,78103,THURSDAY,0,0,23.3,64,9.4,1015.7,Fair
7/20/2023 6:00,64,300,68373,217896,364,286269,THURSDAY,0,0,23.3,64,9.4,1015.7,Fair
7/20/2023 7:00,126,775,153819,606275,901,760094,THURSDAY,0,0,22.2,66,9.4,1015.6,Fair
7/20/2023 8:00,229,1297,1974686,1070228,1526,3044914,THURSDAY,0,0,21.7,66,13,1015.8,Fair
7/20/2023 9:00,143,705,252528,905703,848,1158231,THURSDAY,0,0,21.7,66,13,1016.2,Fair
7/20/2023 10:00,153,384,752469,321741,537,1074210,THURSDAY,0,0,22.2,64,9.4,1016.4,Rain
7/20/2023 11:00,193,404,862981,320417,597,1183398,THURSDAY,0,0,22.2,64,9.4,1016.4,Fair
7/20/2023 12:00,205,511,1219156,380883,716,1600039,THURSDAY,0,0,25,52,13,1016.4,Fair
7/20/2023 13:00,208,451,3494271,333214,659,3827485,THURSDAY,0,0,25.6,52,13,1016.4,Fair
7/20/2023 14:00,222,433,978700,352091,655,1330791,THURSDAY,0,0,25.6,52,13,1016.4,Fair
7/20/2023 15:00,280,529,607745,475121,809,1082866,THURSDAY,0,0,25,56,14.8,1016.1,Fair
7/20/2023 16:00,414,980,659019,1345177,1394,2004196,THURSDAY,0,0,25.6,58,16.6,1015.8,Fair
7/20/2023 17:00,556,1521,2921164,1396393,2077,4317557,THURSDAY,0,0,25.6,58,16.6,1015.8,Fair
7/20/2023 18:00,490,1287,2268999,1185059,1777,3454058,THURSDAY,0,0,24.4,69,22.3,1014.9,Fair
7/20/2023 19:00,460,862,2349281,3127866,1322,5477147,THURSDAY,0,0,24.4,69,22.3,1014.9,Rain
7/20/2023 20:00,335,706,1618091,766357,1041,2384448,THURSDAY,0,0,23.9,71,22.3,1014.5,Fair
7/20/2023 21:00,214,509,447206,595878,723,1043084,THURSDAY,0,0,23.9,66,14.8,1014,Fair
7/20/2023 22:00,191,301,249024,334421,492,583445,THURSDAY,0,0,23.9,64,14.8,1013.6,Fair
7/20/2023 23:00,112,171,168491,162048,283,330539,THURSDAY,0,0,23.3,67,11.2,1013.3,Fair
7/21/2023 0:00,65,94,98158,79842,159,178000,FRIDAY,0,0,22.2,68,13,1013.1,Cloudy
7/21/2023 1:00,46,52,264242,46748,98,310990,FRIDAY,0,0,22.2,68,13,1013.1,Cloudy
7/21/2023 2:00,33,27,87490,20289,60,107779,FRIDAY,0,0,21.7,73,5.4,1013.2,Fair
7/21/2023 3:00,5,15,7935,9133,20,17068,FRIDAY,0,0,21.1,73,9.4,1012.8,Fair
7/21/2023 4:00,4,17,36008,14865,21,50873,FRIDAY,0,0,21.1,76,9.4,1012.6,Fair
7/21/2023 5:00,19,78,18379,47799,97,66178,FRIDAY,0,0,20,81,5.4,1011.6,Fair
7/21/2023 6:00,51,249,75347,201653,300,277000,FRIDAY,0,0,20,81,5.4,1011.6,Fair
7/21/2023 7:00,89,523,324839,448332,612,773171,FRIDAY,0,0,20,84,7.6,1010.9,Fair
7/21/2023 8:00,204,940,302853,1348713,1144,1651566,FRIDAY,0,0,20,87,7.6,1010.9,Fair
7/21/2023 9:00,152,591,228171,470211,743,698382,FRIDAY,0,0,18.9,93,11.2,1010.9,Fair
7/21/2023 10:00,173,381,1843437,280514,554,2123951,FRIDAY,0,0,18.9,93,11.2,1010.9,Fair
7/21/2023 11:00,183,393,1616816,619584,576,2236400,FRIDAY,0,0,20.6,90,9.4,1010.6,Cloudy
7/21/2023 12:00,274,499,2577600,395550,773,2973150,FRIDAY,0,0,21.7,84,9.4,1010.2,Cloudy
7/21/2023 13:00,294,500,882564,748865,794,1631429,FRIDAY,0,0,21.1,87,16.6,1009.4,Cloudy
7/21/2023 14:00,312,542,1411021,427953,854,1838974,FRIDAY,0,0,21.1,87,18.4,1009.2,Cloudy
7/21/2023 15:00,361,588,603471,496211,949,1099682,FRIDAY,0,0,21.1,87,18.4,1009.2,Cloudy
7/21/2023 16:00,423,922,1305774,959089,1345,2264863,FRIDAY,0,0,21.1,90,9.4,1008.9,Cloudy
7/21/2023 17:00,534,1189,1037896,1182697,1723,2220593,FRIDAY,0,0,21.7,87,13,1008.4,Cloudy
7/21/2023 18:00,425,949,2018573,1031163,1374,3049736,FRIDAY,0,0,21.7,87,13,1008.4,Cloudy
7/21/2023 19:00,238,622,1837825,668855,860,2506680,FRIDAY,0,0,21.1,90,24.1,1007.2,Cloudy
7/21/2023 20:00,79,243,2054114,331304,322,2385418,FRIDAY,0,0,22.8,81,25.9,1007.2,Cloudy
7/21/2023 21:00,27,65,28731,72577,92,101308,FRIDAY,0,0,21.7,84,20.5,1006.9,Cloudy
7/21/2023 22:00,25,50,29198,47139,75,76337,FRIDAY,0,0,21.7,84,20.5,1006.9,Cloudy
7/21/2023 23:00,49,84,447432,63170,133,510602,FRIDAY,0,0,21.7,84,13,1007.9,Cloudy
7/22/2023 0:00,65,97,830263,79388,162,909651,SATURDAY,1,0,20.6,78,20.5,1007.7,Cloudy
7/22/2023 1:00,142,91,975809,107125,233,1082934,SATURDAY,1,0,18.9,93,18.4,1007.6,Cloudy
7/22/2023 2:00,66,50,123933,81454,116,205387,SATURDAY,1,0,18.9,96,11.2,1007.4,Cloudy
7/22/2023 3:00,13,24,12535,26437,37,38972,SATURDAY,1,0,18.9,93,7.6,1006.5,Cloudy
7/22/2023 4:00,12,15,17913,13791,27,31704,SATURDAY,1,0,18.9,93,22.3,1006.5,Cloudy
7/22/2023 5:00,20,28,23896,22812,48,46708,SATURDAY,1,0,18.3,97,0,1006.8,Cloudy
7/22/2023 6:00,25,68,63241,54565,93,117806,SATURDAY,1,0,18.3,97,0,1006.8,Cloudy
7/22/2023 7:00,59,157,98420,127320,216,225740,SATURDAY,1,0,18.9,93,5.4,1006,Cloudy
7/22/2023 8:00,125,279,213010,309749,404,522759,SATURDAY,1,0,19.4,91,7.6,1006.1,Cloudy
7/22/2023 9:00,216,448,392506,405624,664,798130,SATURDAY,1,0,19.4,91,9.4,1006.6,Cloudy
7/22/2023 10:00,349,489,1063581,442420,838,1506001,SATURDAY,1,0,19.4,91,5.4,1007.1,Cloudy
7/22/2023 11:00,453,603,2091265,1157649,1056,3248914,SATURDAY,1,0,19.4,91,5.4,1007.1,Cloudy
7/22/2023 12:00,506,605,1362823,668814,1111,2031637,SATURDAY,1,0,20.6,84,7.6,1007.7,Cloudy
7/22/2023 13:00,583,652,4135416,620733,1235,4756149,SATURDAY,1,0,21.7,79,11.2,1008,Cloudy
7/22/2023 14:00,570,631,2475966,660144,1201,3136110,SATURDAY,1,0,21.7,79,16.6,1008.1,Cloudy
7/22/2023 15:00,492,619,1119846,641440,1111,1761286,SATURDAY,1,0,21.7,79,16.6,1008.1,Cloudy
7/22/2023 16:00,680,661,1459498,632399,1341,2091897,SATURDAY,1,0,23.9,74,11.2,1007.7,Cloudy
7/22/2023 17:00,547,704,4061174,662478,1251,4723652,SATURDAY,1,0,23.9,76,16.6,1007.7,Cloudy
7/22/2023 18:00,526,655,2063470,533421,1181,2596891,SATURDAY,1,0,24.4,74,16.6,1007.5,Cloudy
7/22/2023 19:00,464,573,6261548,552463,1037,6814011,SATURDAY,1,0,24.4,74,11.2,1007.7,Cloudy
7/22/2023 20:00,413,528,1550718,580703,941,2131421,SATURDAY,1,0,24.4,74,11.2,1007.7,Cloudy
7/22/2023 21:00,281,330,3685590,525027,611,4210617,SATURDAY,1,0,22.8,79,13,1008.1,Cloudy
7/22/2023 22:00,304,316,3243973,322635,620,3566608,SATURDAY,1,0,23.9,71,11.2,1008.3,Cloudy
7/22/2023 23:00,200,216,482383,259975,416,742358,SATURDAY,1,0,23.3,76,9.4,1008.5,Cloudy
7/23/2023 0:00,154,143,237651,149725,297,387376,SUNDAY,1,0,23.3,79,7.6,1009.1,Cloudy
7/23/2023 1:00,202,126,2511898,125737,328,2637635,SUNDAY,1,0,23.3,79,7.6,1009.1,Cloudy
7/23/2023 2:00,110,69,268393,107382,179,375775,SUNDAY,1,0,23.9,69,5.4,1009.7,Cloudy
7/23/2023 3:00,28,30,66601,64387,58,130988,SUNDAY,1,0,23.3,69,9.4,1009.7,Fair
7/23/2023 4:00,14,12,27422,9341,26,36763,SUNDAY,1,0,22.2,73,0,1010.1,Fair
7/23/2023 5:00,7,17,11802,17948,24,29750,SUNDAY,1,0,22.2,73,0,1010.1,Cloudy
7/23/2023 6:00,23,68,66368,51730,91,118098,SUNDAY,1,0,21.7,71,13,1010.9,Cloudy
7/23/2023 7:00,41,143,44087,128270,184,172357,SUNDAY,1,0,21.1,76,13,1010.9,Fair
7/23/2023 8:00,106,239,271516,234564,345,506080,SUNDAY,1,0,21.1,73,9.4,1011.5,Fair
7/23/2023 9:00,183,346,1562054,360156,529,1922210,SUNDAY,1,0,21.1,73,11.2,1012.2,Fair
7/23/2023 10:00,294,428,1353223,374779,722,1728002,SUNDAY,1,0,21.1,73,11.2,1012.2,Rain
7/23/2023 11:00,387,539,957493,460084,926,1417577,SUNDAY,1,0,22.8,66,0,1013.2,Fair
7/23/2023 12:00,495,564,1189084,530172,1059,1719256,SUNDAY,1,0,24.4,64,0,1013.4,Fair
7/23/2023 13:00,416,597,2332520,607034,1013,2939554,SUNDAY,1,0,24.4,69,11.2,1013.6,Fair
7/23/2023 14:00,554,620,3487239,602750,1174,4089989,SUNDAY,1,0,25.6,58,9.4,1013.7,Fair
7/23/2023 15:00,481,616,2729743,601216,1097,3330959,SUNDAY,1,0,27.8,46,5.4,1013.9,Fair
7/23/2023 16:00,544,626,1717073,1421450,1170,3138523,SUNDAY,1,0,27.8,46,5.4,1013.9,Fair
7/23/2023 17:00,462,667,2323052,680730,1129,3003782,SUNDAY,1,0,28.9,38,14.8,1013.6,Fair
7/23/2023 18:00,465,746,964885,795679,1211,1760564,SUNDAY,1,0,29.4,39,9.4,1013.4,Fair
7/23/2023 19:00,460,568,4459336,589088,1028,5048424,SUNDAY,1,0,29.4,39,9.4,1013.4,Rain
7/23/2023 20:00,322,472,3692660,1327281,794,5019941,SUNDAY,1,0,26.7,49,13,1013.5,Fair
7/23/2023 21:00,224,307,1052609,315905,531,1368514,SUNDAY,1,0,26.1,54,16.6,1013.7,Fair
7/23/2023 22:00,240,262,563822,488400,502,1052222,SUNDAY,1,0,25,60,14.8,1014.2,Fair
7/23/2023 23:00,75,105,130153,168266,180,298419,SUNDAY,1,0,24.4,67,14.8,1014.5,Fair
7/24/2023 0:00,52,63,158093,680930,115,839023,MONDAY,0,0,24.4,67,14.8,1014.5,Fair
7/24/2023 1:00,34,25,46564,19005,59,65569,MONDAY,0,0,23.3,71,13,1016,Fair
7/24/2023 2:00,16,16,25698,15105,32,40803,MONDAY,0,0,23.9,66,16.6,1016.6,Fair
7/24/2023 3:00,3,4,5711,4394,7,10105,MONDAY,0,0,23.9,64,16.6,1017.1,Fair
7/24/2023 4:00,9,22,14756,23729,31,38485,MONDAY,0,0,23.3,62,18.4,1017.4,Fair
7/24/2023 5:00,24,81,20747,56640,105,77387,MONDAY,0,0,23.3,62,18.4,1017.4,Fair
7/24/2023 6:00,55,278,73441,219028,333,292469,MONDAY,0,0,22.8,66,14.8,1017.5,Clear
7/24/2023 7:00,85,668,128979,643622,753,772601,MONDAY,0,0,22.2,71,11.2,1017.7,Clear
7/24/2023 8:00,175,1174,947965,945368,1349,1893333,MONDAY,0,0,21.7,71,7.6,1018.1,Clear
7/24/2023 9:00,140,627,623568,1119388,767,1742956,MONDAY,0,0,21.1,76,7.6,1018.5,Fair
7/24/2023 10:00,134,334,1089710,330672,468,1420382,MONDAY,0,0,22.2,73,9.4,1018.9,Rain
7/24/2023 11:00,189,343,358659,276866,532,635525,MONDAY,0,0,22.2,73,9.4,1018.9,Fair
7/24/2023 12:00,191,404,1140747,311571,595,1452318,MONDAY,0,0,26.1,60,7.6,1019.1,Fair
7/24/2023 13:00,152,384,272711,296689,536,569400,MONDAY,0,0,26.1,65,13,1018.8,Fair
7/24/2023 14:00,203,415,1397731,319574,618,1717305,MONDAY,0,0,27.2,62,13,1019.1,Cloudy
7/24/2023 15:00,258,509,2430691,415955,767,2846646,MONDAY,0,0,27.2,62,13,1019.1,Cloudy
7/24/2023 16:00,277,904,1086105,716086,1181,1802191,MONDAY,0,0,27.8,63,13,1018.9,Cloudy
7/24/2023 17:00,416,1382,803869,1332819,1798,2136688,MONDAY,0,0,29.4,53,22.3,1018.5,Cloudy
7/24/2023 18:00,379,1142,893906,1325593,1521,2219499,MONDAY,0,0,29.4,53,22.3,1018.5,Cloudy
7/24/2023 19:00,312,834,752788,1040611,1146,1793399,MONDAY,0,0,29.4,55,22.3,1018.2,Cloudy
7/24/2023 20:00,222,629,2195684,593297,851,2788981,MONDAY,0,0,29.4,57,22.3,1017.5,Cloudy
7/24/2023 21:00,179,448,497803,456241,627,954044,MONDAY,0,0,27.8,65,16.6,1017.5,Cloudy
7/24/2023 22:00,131,249,1426003,416307,380,1842310,MONDAY,0,0,28.3,63,20.5,1017.5,Cloudy
7/24/2023 23:00,79,112,1707635,188300,191,1895935,MONDAY,0,0,27.8,63,22.3,1017.8,Cloudy
7/25/2023 0:00,47,51,1270008,85227,98,1355235,TUESDAY,0,0,26.1,67,18.4,1018.1,Cloudy
7/25/2023 1:00,30,26,1431769,20080,56,1451849,TUESDAY,0,0,25,69,16.6,1018.5,Cloudy
7/25/2023 2:00,14,17,17213,13627,31,30840,TUESDAY,0,0,24.4,69,16.6,1018.6,Fair
7/25/2023 3:00,6,8,14045,4958,14,19003,TUESDAY,0,0,23.9,71,14.8,1019,Fair
7/25/2023 4:00,4,21,6541,12987,25,19528,TUESDAY,0,0,23.9,74,16.6,1018.8,Fair
7/25/2023 5:00,28,113,24866,120159,141,145025,TUESDAY,0,0,22.2,82,9.4,1018.4,Fair
7/25/2023 6:00,55,327,63718,285200,382,348918,TUESDAY,0,0,22.2,79,14.8,1018.3,Fair
7/25/2023 7:00,144,817,156359,761092,961,917451,TUESDAY,0,0,21.7,81,14.8,1018.7,Fair
7/25/2023 8:00,230,1323,1713276,1669690,1553,3382966,TUESDAY,0,0,21.1,87,14.8,1018.6,Fair
7/25/2023 9:00,161,678,362962,578033,839,940995,TUESDAY,0,0,20.6,93,5.4,1018.3,Fair
7/25/2023 10:00,134,377,307167,297136,511,604303,TUESDAY,0,0,21.1,93,5.4,1019,Rain
7/25/2023 11:00,208,358,412563,929087,566,1341650,TUESDAY,0,0,22.2,87,11.2,1018.8,Fair
7/25/2023 12:00,196,417,2002822,285001,613,2287823,TUESDAY,0,0,23.3,85,14.8,1018.6,Fair
7/25/2023 13:00,205,410,560319,418902,615,979221,TUESDAY,0,0,25,74,20.5,1018.6,Fair
7/25/2023 14:00,213,464,927171,408935,677,1336106,TUESDAY,0,0,26.1,72,20.5,1018.6,Fair
7/25/2023 15:00,84,212,1222699,147861,296,1370560,TUESDAY,0,0,28.3,65,16.6,1018.1,Fair
7/25/2023 16:00,63,306,802625,313608,369,1116233,TUESDAY,0,0,28.3,65,16.6,1018.1,Fair
7/25/2023 17:00,113,622,117940,549787,735,667727,TUESDAY,0,0,28.9,61,24.1,1016.6,Cloudy
7/25/2023 18:00,170,706,477567,639753,876,1117320,TUESDAY,0,0,28.9,61,22.3,1016.6,Cloudy
7/25/2023 19:00,111,456,193611,374510,567,568121,TUESDAY,0,0,27.8,67,7.6,1015.9,Cloudy
7/25/2023 20:00,90,357,94078,294319,447,388397,TUESDAY,0,0,21.7,87,7.6,1018,Cloudy
7/25/2023 21:00,93,325,138983,313973,418,452956,TUESDAY,0,0,21.1,84,14.8,1017.4,Cloudy
7/25/2023 22:00,103,231,245662,237535,334,483197,TUESDAY,0,0,21.7,84,13,1017.5,Cloudy
7/25/2023 23:00,105,145,158502,113276,250,271778,TUESDAY,0,0,21.1,84,18.4,1018,Cloudy
7/26/2023 0:00,64,59,121464,99825,123,221289,WEDNESDAY,0,0,21.1,84,18.4,1018,Cloudy
7/26/2023 1:00,31,25,39235,17850,56,57085,WEDNESDAY,0,0,20.6,87,18.4,1017.3,Cloudy
7/26/2023 2:00,19,12,61363,10691,31,72054,WEDNESDAY,0,0,21.7,79,9.4,1016.8,Cloudy
7/26/2023 3:00,7,8,9207,7028,15,16235,WEDNESDAY,0,0,21.1,82,11.2,1017.1,Cloudy
7/26/2023 4:00,6,22,6197,21474,28,27671,WEDNESDAY,0,0,20.6,84,0,1016.6,Cloudy
7/26/2023 5:00,23,109,19552,81241,132,100793,WEDNESDAY,0,0,20.6,84,0,1016.6,Cloudy
7/26/2023 6:00,77,318,97477,233649,395,331126,WEDNESDAY,0,0,21.7,76,7.6,1016.6,Cloudy
7/26/2023 7:00,159,818,170061,715034,977,885095,WEDNESDAY,0,0,21.1,76,11.2,1016.7,Cloudy
7/26/2023 8:00,257,1411,1076593,1148822,1668,2225415,WEDNESDAY,0,0,21.1,73,7.6,1017,Cloudy
7/26/2023 9:00,166,706,269736,623308,872,893044,WEDNESDAY,0,0,20,81,11.2,1017.2,Cloudy
7/26/2023 10:00,162,360,343859,319181,522,663040,WEDNESDAY,0,0,20,81,11.2,1017.2,Rain
7/26/2023 11:00,160,387,379083,308490,547,687573,WEDNESDAY,0,0,22.2,73,11.2,1017.6,Fair
7/26/2023 12:00,205,448,1257916,1733659,653,2991575,WEDNESDAY,0,0,23.9,69,11.2,1017.9,Fair
7/26/2023 13:00,185,433,314933,332374,618,647307,WEDNESDAY,0,0,25.6,64,9.4,1018.1,Fair
7/26/2023 14:00,181,413,386867,326216,594,713083,WEDNESDAY,0,0,25.6,64,9.4,1018.1,Fair
7/26/2023 15:00,265,539,2121085,440318,804,2561403,WEDNESDAY,0,0,28.9,55,11.2,1017.9,Fair
7/26/2023 16:00,381,1026,619259,834478,1407,1453737,WEDNESDAY,0,0,30,45,11.2,1017.4,Fair
7/26/2023 17:00,530,1576,3160864,1409113,2106,4569977,WEDNESDAY,0,0,30,46,11.2,1016.6,Fair
7/26/2023 18:00,531,1292,771089,1131342,1823,1902431,WEDNESDAY,0,0,30.6,45,22.3,1016.2,Fair
7/26/2023 19:00,316,880,765988,762429,1196,1528417,WEDNESDAY,0,0,30.6,45,22.3,1016.2,Rain
7/26/2023 20:00,249,682,414709,603553,931,1018262,WEDNESDAY,0,0,30.6,45,22.3,1015.7,Fair
7/26/2023 21:00,281,489,1338243,644058,770,1982301,WEDNESDAY,0,0,29.4,50,22.3,1015.4,Fair
7/26/2023 22:00,226,366,342031,424323,592,766354,WEDNESDAY,0,0,29.4,50,25.9,1015.4,Fair
7/26/2023 23:00,94,201,155562,202989,295,358551,WEDNESDAY,0,0,28.3,57,20.5,1016,Fair
7/27/2023 0:00,39,78,114876,131752,117,246628,THURSDAY,0,0,28.3,57,20.5,1016,Cloudy
7/27/2023 1:00,27,40,61034,37054,67,98088,THURSDAY,0,0,26.1,62,16.6,1016.9,Cloudy
7/27/2023 2:00,14,19,15619,15162,33,30781,THURSDAY,0,0,25,71,24.1,1016.4,Fair
7/27/2023 3:00,7,10,7487,11602,17,19089,THURSDAY,0,0,24.4,74,16.6,1016.1,Fair
7/27/2023 4:00,2,26,1692,20986,28,22678,THURSDAY,0,0,23.9,74,20.5,1016.3,Fair
7/27/2023 5:00,27,86,39326,74138,113,113464,THURSDAY,0,0,23.9,74,20.5,1016.3,Fair
7/27/2023 6:00,66,290,80053,207106,356,287159,THURSDAY,0,0,22.8,76,16.6,1015.7,Fair
7/27/2023 7:00,160,774,177555,618088,934,795643,THURSDAY,0,0,22.2,79,16.6,1015.5,Fair
7/27/2023 8:00,214,1298,1051528,1117579,1512,2169107,THURSDAY,0,0,22.2,82,14.8,1015.4,Fair
7/27/2023 9:00,140,732,203757,585944,872,789701,THURSDAY,0,0,22.2,82,14.8,1015.4,Fair
7/27/2023 10:00,157,374,875762,297423,531,1173185,THURSDAY,0,0,22.2,87,13,1015.4,Rain
7/27/2023 11:00,211,390,399093,277741,601,676834,THURSDAY,0,0,23.3,85,13,1015.6,Cloudy
7/27/2023 12:00,191,449,1408812,308998,640,1717810,THURSDAY,0,0,25,82,14.8,1015.4,Cloudy
7/27/2023 13:00,174,360,1350333,694006,534,2044339,THURSDAY,0,0,26.7,76,20.5,1014.2,Cloudy
7/27/2023 14:00,220,428,744683,324675,648,1069358,THURSDAY,0,0,26.7,76,20.5,1014.2,Cloudy
7/27/2023 15:00,222,512,344804,399219,734,744023,THURSDAY,0,0,28.9,70,22.3,1012.9,Cloudy
7/27/2023 16:00,319,914,2153016,1046900,1233,3199916,THURSDAY,0,0,28.9,72,29.5,1011.9,Cloudy
7/27/2023 17:00,412,1340,2308001,1093595,1752,3401596,THURSDAY,0,0,31.1,63,33.5,1010.6,Cloudy
7/27/2023 18:00,126,559,244560,589597,685,834157,THURSDAY,0,0,31.7,59,31.7,1009.7,Cloudy
7/27/2023 19:00,70,371,105876,413618,441,519494,THURSDAY,0,0,31.7,59,31.7,1009.7,Cloudy
7/27/2023 20:00,98,439,173872,560206,537,734078,THURSDAY,0,0,31.7,59,31.7,1009.2,Rain
7/27/2023 21:00,106,346,218426,396186,452,614612,THURSDAY,0,0,31.7,59,37.1,1009.2,Rain
7/27/2023 22:00,76,216,186241,257434,292,443675,THURSDAY,0,0,30.6,65,29.5,1009.3,Rain
7/27/2023 23:00,76,161,177589,153073,237,330662,THURSDAY,0,0,25,82,25.9,1010.4,Rain
7/28/2023 0:00,84,100,445498,102160,184,547658,FRIDAY,0,0,23.9,88,24.1,1011,Cloudy
7/28/2023 1:00,58,42,152726,74011,100,226737,FRIDAY,0,0,24.4,82,24.1,1011.2,Cloudy
7/28/2023 2:00,29,20,38300,33048,49,71348,FRIDAY,0,0,24.4,82,18.4,1011.2,Cloudy
7/28/2023 3:00,9,13,16044,13065,22,29109,FRIDAY,0,0,24.4,82,18.4,1011.9,Cloudy
7/28/2023 4:00,2,26,1299,20694,28,21993,FRIDAY,0,0,24.4,82,18.4,1011.9,Cloudy
7/28/2023 5:00,18,72,24817,56303,90,81120,FRIDAY,0,0,24.4,85,14.8,1012.1,Cloudy
7/28/2023 6:00,47,255,53672,238205,302,291877,FRIDAY,0,0,24.4,85,13,1012.1,Cloudy
7/28/2023 7:00,129,574,138858,430658,703,569516,FRIDAY,0,0,24.4,85,13,1012.1,Fair
7/28/2023 8:00,186,964,218519,700383,1150,918902,FRIDAY,0,0,23.9,84,13,1013.1,Fair
7/28/2023 9:00,158,585,294572,509370,743,803942,FRIDAY,0,0,23.9,84,13,1013.1,Fair
7/28/2023 10:00,153,374,1006803,631518,527,1638321,FRIDAY,0,0,24.4,82,13,1014.5,Rain
7/28/2023 11:00,201,394,1306701,1025887,595,2332588,FRIDAY,0,0,25.6,71,20.5,1014.5,Fair
7/28/2023 12:00,223,466,417604,367129,689,784733,FRIDAY,0,0,26.7,67,14.8,1014.6,Fair
7/28/2023 13:00,258,477,711319,1007743,735,1719062,FRIDAY,0,0,27.8,63,9.4,1014.6,Fair
7/28/2023 14:00,262,450,2256319,340391,712,2596710,FRIDAY,0,0,27.8,63,9.4,1014.6,Fair
7/28/2023 15:00,280,629,1037838,748194,909,1786032,FRIDAY,0,0,26.7,71,16.6,1014.7,Fair
7/28/2023 16:00,320,822,1524940,668563,1142,2193503,FRIDAY,0,0,28.3,65,14.8,1014.4,Fair
7/28/2023 17:00,314,997,1512944,888300,1311,2401244,FRIDAY,0,0,28.3,63,18.4,1013.7,Fair
7/28/2023 18:00,400,930,1381911,918013,1330,2299924,FRIDAY,0,0,28.3,63,18.4,1013.7,Fair
7/28/2023 19:00,333,725,4468325,647842,1058,5116167,FRIDAY,0,0,28.3,65,14.8,1012.8,Rain
7/28/2023 20:00,285,565,1326162,552084,850,1878246,FRIDAY,0,0,30.6,57,5.4,1011.9,Fair
7/28/2023 21:00,250,419,2228337,428517,669,2656854,FRIDAY,0,0,31.7,50,16.6,1011.7,Fair
7/28/2023 22:00,249,351,1325173,424085,600,1749258,FRIDAY,0,0,31.1,52,20.5,1011.4,Fair
7/28/2023 23:00,235,257,1222288,361725,492,1584013,FRIDAY,0,0,31.1,52,20.5,1011.4,Fair
7/29/2023 0:00,136,174,380975,215038,310,596013,SATURDAY,1,0,29.4,57,16.6,1012.1,Fair
7/29/2023 1:00,211,143,687393,145583,354,832976,SATURDAY,1,0,27.8,65,14.8,1012.3,Fair
7/29/2023 2:00,127,78,885060,87953,205,973013,SATURDAY,1,0,27.2,69,16.6,1012.2,Fair
7/29/2023 3:00,26,22,40729,20489,48,61218,SATURDAY,1,0,27.2,72,22.3,1012.4,Fair
7/29/2023 4:00,8,15,7970,10613,23,18583,SATURDAY,1,0,27.2,72,22.3,1012.4,Fair
7/29/2023 5:00,17,24,23422,20053,41,43475,SATURDAY,1,0,26.1,77,14.8,1011.3,Fair
7/29/2023 6:00,23,82,60486,69002,105,129488,SATURDAY,1,0,26.1,77,14.8,1011.3,Fair
7/29/2023 7:00,54,133,195493,129209,187,324702,SATURDAY,1,0,24.4,85,16.6,1009.7,Fair
7/29/2023 8:00,87,263,168107,315123,350,483230,SATURDAY,1,0,24.4,85,13,1010,Fair
7/29/2023 9:00,176,420,287425,334741,596,622166,SATURDAY,1,0,24.4,85,13,1010,Cloudy
7/29/2023 10:00,239,453,552990,360911,692,913901,SATURDAY,1,0,25.6,82,14.8,1010.5,Fair
7/29/2023 11:00,326,574,787085,546421,900,1333506,SATURDAY,1,0,25.6,82,7.6,1009.9,Cloudy
7/29/2023 12:00,355,565,1585936,550598,920,2136534,SATURDAY,1,0,26.7,76,7.6,1009.3,Cloudy
7/29/2023 13:00,136,199,331108,257701,335,588809,SATURDAY,1,0,27.8,77,13,1009.2,Cloudy
7/29/2023 14:00,164,257,849682,225813,421,1075495,SATURDAY,1,0,27.8,77,13,1009.2,Cloudy
7/29/2023 15:00,292,489,2634737,433548,781,3068285,SATURDAY,1,0,30,67,16.6,1007.8,Cloudy
7/29/2023 16:00,200,366,1568652,300457,566,1869109,SATURDAY,1,0,27.8,72,22.3,1007,Cloudy
7/29/2023 17:00,39,98,207299,181713,137,389012,SATURDAY,1,0,27.8,72,22.3,1007,Rain
7/29/2023 18:00,43,226,71081,322388,269,393469,SATURDAY,1,0,23.9,79,9.4,1007,Rain
7/29/2023 19:00,90,265,987287,466791,355,1454078,SATURDAY,1,0,26.7,69,7.6,1004.7,Rain
7/29/2023 20:00,16,38,156198,60958,54,217156,SATURDAY,1,0,26.7,69,7.6,1004.7,Rain
7/29/2023 21:00,12,52,16808,97342,64,114150,SATURDAY,1,0,23.9,82,9.4,1003.5,Rain
7/29/2023 22:00,53,96,982816,112576,149,1095392,SATURDAY,1,0,22.2,94,24.1,1003,Rain
7/29/2023 23:00,67,101,1212400,115426,168,1327826,SATURDAY,1,0,22.2,94,18.4,1002.8,Rain
7/30/2023 0:00,66,83,276577,557883,149,834460,SUNDAY,1,0,22.2,97,16.6,1004.5,Rain
7/30/2023 1:00,157,81,812968,78865,238,891833,SUNDAY,1,0,19.4,91,16.6,1005.4,Rain
7/30/2023 2:00,66,42,220312,40344,108,260656,SUNDAY,1,0,19.4,91,38.9,1005.4,Rain
7/30/2023 3:00,14,17,74980,14924,31,89904,SUNDAY,1,0,18.3,87,24.1,1006.1,Rain
7/30/2023 4:00,12,12,299033,10782,24,309815,SUNDAY,1,0,17.8,87,18.4,1008,Rain
7/30/2023 5:00,9,22,16165,28753,31,44918,SUNDAY,1,0,18.3,84,20.5,1008.3,Rain
7/30/2023 6:00,19,56,28505,78993,75,107498,SUNDAY,1,0,18.3,84,20.5,1008.3,Rain
7/30/2023 7:00,62,137,129767,116282,199,246049,SUNDAY,1,0,17.2,72,20.5,1008.5,Rain
7/30/2023 8:00,106,247,246742,482111,353,728853,SUNDAY,1,0,17.2,72,20.5,1008.5,Cloudy
7/30/2023 9:00,238,390,828481,337971,628,1166452,SUNDAY,1,0,16.1,75,16.6,1009.8,Cloudy
7/30/2023 10:00,305,516,721377,502902,821,1224279,SUNDAY,1,0,16.7,72,20.5,1010.3,Cloudy
7/30/2023 11:00,431,567,972136,553246,998,1525382,SUNDAY,1,0,17.8,68,20.5,1011,Cloudy
7/30/2023 12:00,482,640,4023983,620106,1122,4644089,SUNDAY,1,0,19.4,63,16.6,1011.5,Cloudy
7/30/2023 13:00,553,636,1867171,1440992,1189,3308163,SUNDAY,1,0,21.1,57,11.2,1011.7,Cloudy
7/30/2023 14:00,540,694,1614454,808944,1234,2423398,SUNDAY,1,0,21.1,57,11.2,1011.7,Cloudy
7/30/2023 15:00,587,671,4401397,717456,1258,5118853,SUNDAY,1,0,21.7,53,5.4,1012.4,Cloudy
7/30/2023 16:00,565,678,2119042,758456,1243,2877498,SUNDAY,1,0,22.2,51,13,1012.2,Rain
7/30/2023 17:00,586,753,3675627,881986,1339,4557613,SUNDAY,1,0,23.3,48,18.4,1011.8,Cloudy
7/30/2023 18:00,521,666,2503768,736687,1187,3240455,SUNDAY,1,0,23.3,48,18.4,1011.8,Cloudy
7/30/2023 19:00,452,606,1671679,759044,1058,2430723,SUNDAY,1,0,25,42,16.6,1011.4,Cloudy
7/30/2023 20:00,327,450,1640101,454397,777,2094498,SUNDAY,1,0,26.1,39,16.6,1011.3,Cloudy
7/30/2023 21:00,192,308,406341,250221,500,656562,SUNDAY,1,0,26.1,38,18.4,1011.1,Cloudy
7/30/2023 22:00,142,202,989971,159359,344,1149330,SUNDAY,1,0,25,37,18.4,1011.7,Fair
7/30/2023 23:00,75,99,177855,91193,174,269048,SUNDAY,1,0,23.9,40,13,1012.1,Fair
7/31/2023 0:00,25,78,69893,173463,103,243356,MONDAY,0,0,23.9,40,13,1012.1,Fair
7/31/2023 1:00,29,33,73151,25949,62,99100,MONDAY,0,0,22.8,46,11.2,1013.1,Fair
7/31/2023 2:00,16,12,40746,13637,28,54383,MONDAY,0,0,22.2,48,11.2,1013.2,Fair
7/31/2023 3:00,4,7,14370,6619,11,20989,MONDAY,0,0,20.6,57,7.6,1013.2,Fair
7/31/2023 4:00,4,21,60693,17212,25,77905,MONDAY,0,0,20.6,57,7.6,1013.2,Fair
7/31/2023 5:00,17,75,11281,51931,92,63212,MONDAY,0,0,19.4,66,13,1012.8,Fair
7/31/2023 6:00,61,301,87465,220470,362,307935,MONDAY,0,0,18.9,68,0,1012.8,Fair
7/31/2023 7:00,95,628,96783,525620,723,622403,MONDAY,0,0,17.8,75,0,1012.4,Clear
7/31/2023 8:00,173,1167,240470,889663,1340,1130133,MONDAY,0,0,17.8,75,0,1012.4,Fair
7/31/2023 9:00,130,611,175701,480885,741,656586,MONDAY,0,0,17.2,81,5.4,1012.8,Fair
7/31/2023 10:00,165,384,769969,299959,549,1069928,MONDAY,0,0,18.3,78,7.6,1013.1,Rain
7/31/2023 11:00,194,367,1489290,1765836,561,3255126,MONDAY,0,0,21.1,64,9.4,1013.7,Fair
7/31/2023 12:00,214,427,1964278,305961,641,2270239,MONDAY,0,0,21.1,64,9.4,1013.7,Fair
7/31/2023 13:00,203,392,1051298,308620,595,1359918,MONDAY,0,0,22.2,59,5.4,1013.8,Fair
7/31/2023 14:00,244,434,1744889,374955,678,2119844,MONDAY,0,0,25,47,0,1013.6,Fair
7/31/2023 15:00,280,554,1384121,436329,834,1820450,MONDAY,0,0,25,47,0,1013.6,Fair
7/31/2023 16:00,308,893,1053585,848619,1201,1902204,MONDAY,0,0,26.7,37,20.5,1013,Fair
7/31/2023 17:00,469,1386,755717,1170181,1855,1925898,MONDAY,0,0,27.2,37,18.4,1012.7,Fair
7/31/2023 18:00,464,1171,1733288,1200741,1635,2934029,MONDAY,0,0,27.2,37,18.4,1012.7,Fair
7/31/2023 19:00,277,733,556776,697783,1010,1254559,MONDAY,0,0,27.2,38,18.4,1011.9,Fair
7/31/2023 20:00,182,542,518455,507764,724,1026219,MONDAY,0,0,27.2,39,16.6,1012,Fair
7/31/2023 21:00,154,342,275227,357339,496,632566,MONDAY,0,0,26.7,41,16.6,1012.5,Fair
7/31/2023 22:00,111,239,203104,742517,350,945621,MONDAY,0,0,26.1,41,16.6,1013.3,Fair
7/31/2023 23:00,79,113,152044,80753,192,232797,MONDAY,0,0,26.1,41,20.5,1013.3,Fair
8/1/2023 0:00,29,49,51280,1730495,78,1781775,TUESDAY,0,0,23.3,56,14.8,1014.7,Fair
8/1/2023 1:00,51,34,7026165,22286,85,7048451,TUESDAY,0,0,22.2,57,18.4,1015.4,Fair
8/1/2023 2:00,8,9,26859,5610,17,32469,TUESDAY,0,0,22.2,55,14.8,1016,Fair
8/1/2023 3:00,3,9,6398,8439,12,14837,TUESDAY,0,0,22.2,55,14.8,1016,Fair
8/1/2023 4:00,1,18,2470,16033,19,18503,TUESDAY,0,0,20.6,59,14.8,1016.4,Fair
8/1/2023 5:00,22,100,61035,105272,122,166307,TUESDAY,0,0,20.6,57,18.4,1016.2,Fair
8/1/2023 6:00,64,320,86924,253686,384,340610,TUESDAY,0,0,19.4,63,16.6,1016.4,Fair
8/1/2023 7:00,148,821,186392,679586,969,865978,TUESDAY,0,0,18.3,68,11.2,1016.7,Fair
8/1/2023 8:00,229,1355,270745,1087002,1584,1357747,TUESDAY,0,0,18.3,68,11.2,1016.7,Fair
8/1/2023 9:00,150,718,308181,5985236,868,6293417,TUESDAY,0,0,18.3,68,14.8,1018,Fair
8/1/2023 10:00,121,426,2656689,342776,547,2999465,TUESDAY,0,0,18.9,61,14.8,1018.8,Rain
8/1/2023 11:00,188,368,407129,292065,556,699194,TUESDAY,0,0,20,57,16.6,1019.1,Fair
8/1/2023 12:00,232,456,818647,347142,688,1165789,TUESDAY,0,0,21.1,51,11.2,1019.3,Fair
8/1/2023 13:00,228,434,625881,339693,662,965574,TUESDAY,0,0,21.1,51,11.2,1019.3,Fair
8/1/2023 14:00,226,467,471850,377466,693,849316,TUESDAY,0,0,23.3,43,16.6,1019.4,Fair
8/1/2023 15:00,340,625,1774851,5665752,965,7440603,TUESDAY,0,0,23.3,41,9.4,1019.2,Fair
8/1/2023 16:00,396,1037,600860,4615538,1433,5216398,TUESDAY,0,0,23.3,38,16.6,1019,Fair
8/1/2023 17:00,550,1587,8751052,1383106,2137,10134158,TUESDAY,0,0,23.9,39,13,1018.6,Fair
8/1/2023 18:00,511,1161,4089762,1222901,1672,5312663,TUESDAY,0,0,23.9,39,13,1018.6,Fair
8/1/2023 19:00,397,904,796997,892271,1301,1689268,TUESDAY,0,0,24.4,35,20.5,1018.9,Rain
8/1/2023 20:00,242,632,1590987,685303,874,2276290,TUESDAY,0,0,23.9,34,16.6,1019,Fair
8/1/2023 21:00,177,433,3989333,356464,610,4345797,TUESDAY,0,0,23.3,37,13,1019,Fair
8/1/2023 22:00,123,296,184720,247739,419,432459,TUESDAY,0,0,23.3,38,16.6,1019.4,Fair
8/1/2023 23:00,143,151,466289,134736,294,601025,TUESDAY,0,0,23.3,38,16.6,1019.4,Fair
8/2/2023 0:00,38,64,952562,3911421,102,4863983,WEDNESDAY,0,0,21.7,42,14.8,1020.9,Fair
8/2/2023 1:00,35,38,37485,39334,73,76819,WEDNESDAY,0,0,21.1,44,11.2,1021.4,Fair
8/2/2023 2:00,12,20,12374,16123,32,28497,WEDNESDAY,0,0,20,49,9.4,1021.4,Fair
8/2/2023 3:00,7,15,66997,13578,22,80575,WEDNESDAY,0,0,20,49,9.4,1021.4,Fair
8/2/2023 4:00,4,17,2049,12986,21,15035,WEDNESDAY,0,0,18.3,56,14.8,1021.5,Fair
8/2/2023 5:00,18,86,14097,58357,104,72454,WEDNESDAY,0,0,17.8,56,18.4,1021.6,Fair
8/2/2023 6:00,53,298,49374,219929,351,269303,WEDNESDAY,0,0,17.2,60,14.8,1021.7,Clear
8/2/2023 7:00,134,784,147450,627640,918,775090,WEDNESDAY,0,0,16.1,65,7.6,1021.4,Clear
8/2/2023 8:00,234,1376,287415,1125607,1610,1413022,WEDNESDAY,0,0,16.1,65,7.6,1021.4,Clear
8/2/2023 9:00,145,749,441310,630654,894,1071964,WEDNESDAY,0,0,16.1,65,9.4,1022.2,Clear
8/2/2023 10:00,176,391,11152975,337031,567,11490006,WEDNESDAY,0,0,16.7,65,13,1022.9,Rain
8/2/2023 11:00,184,410,486340,337152,594,823492,WEDNESDAY,0,0,18.9,56,9.4,1023.1,Fair
8/2/2023 12:00,198,462,383167,348891,660,732058,WEDNESDAY,0,0,18.9,56,9.4,1023.1,Fair
8/2/2023 13:00,225,456,7240375,380565,681,7620940,WEDNESDAY,0,0,21.1,46,11.2,1023.2,Fair
8/2/2023 14:00,239,439,3824757,335446,678,4160203,WEDNESDAY,0,0,21.1,49,13,1023.3,Fair
8/2/2023 15:00,289,598,477133,488372,887,965505,WEDNESDAY,0,0,21.1,53,18.4,1022.7,Fair
8/2/2023 16:00,404,1043,3225582,892519,1447,4118101,WEDNESDAY,0,0,21.1,49,16.6,1022.5,Fair
8/2/2023 17:00,630,1559,1284121,2078237,2189,3362358,WEDNESDAY,0,0,21.1,49,16.6,1022.5,Fair
8/2/2023 18:00,538,1271,1828162,1285467,1809,3113629,WEDNESDAY,0,0,20.6,55,20.5,1022.4,Fair
8/2/2023 19:00,468,919,5891265,951807,1387,6843072,WEDNESDAY,0,0,21.7,53,20.5,1022,Rain
8/2/2023 20:00,263,630,526680,579960,893,1106640,WEDNESDAY,0,0,21.1,55,20.5,1021.7,Fair
8/2/2023 21:00,219,466,422813,499933,685,922746,WEDNESDAY,0,0,21.1,57,16.6,1021.5,Fair
8/2/2023 22:00,187,331,343470,326070,518,669540,WEDNESDAY,0,0,21.1,57,16.6,1021.5,Fair
8/2/2023 23:00,137,170,260272,195239,307,455511,WEDNESDAY,0,0,20,59,13,1021.5,Fair
8/3/2023 0:00,52,66,105431,53697,118,159128,THURSDAY,0,0,18.9,68,13,1021.8,Fair
8/3/2023 1:00,21,34,37534,22055,55,59589,THURSDAY,0,0,18.9,61,14.8,1022,Fair
8/3/2023 2:00,7,13,6877,11309,20,18186,THURSDAY,0,0,18.3,63,14.8,1021.9,Fair
8/3/2023 3:00,2,12,2364,10081,14,12445,THURSDAY,0,0,18.3,63,14.8,1021.9,Fair
8/3/2023 4:00,2,21,1462,23719,23,25181,THURSDAY,0,0,18.3,70,18.4,1021.4,Fair
8/3/2023 5:00,21,76,24525,58003,97,82528,THURSDAY,0,0,17.8,73,16.6,1021.2,Fair
8/3/2023 6:00,60,301,51324,238900,361,290224,THURSDAY,0,0,17.8,73,16.6,1021.2,Clear
8/3/2023 7:00,143,740,200174,601924,883,802098,THURSDAY,0,0,17.8,70,16.6,1020.7,Clear
8/3/2023 8:00,226,1357,271969,1157244,1583,1429213,THURSDAY,0,0,17.2,72,13,1020.4,Fair
8/3/2023 9:00,147,746,234972,591997,893,826969,THURSDAY,0,0,16.7,75,0,1020.8,Fair
8/3/2023 10:00,189,374,459530,292381,563,751911,THURSDAY,0,0,17.8,75,13,1020.5,Rain
8/3/2023 11:00,201,413,370969,309740,614,680709,THURSDAY,0,0,19.4,71,13,1020.9,Fair
8/3/2023 12:00,231,508,1663109,441781,739,2104890,THURSDAY,0,0,19.4,71,13,1020.9,Fair
8/3/2023 13:00,232,415,450885,370507,647,821392,THURSDAY,0,0,23.3,56,18.4,1020.3,Fair
8/3/2023 14:00,234,491,399332,409234,725,808566,THURSDAY,0,0,24.4,52,22.3,1019.8,Fair
8/3/2023 15:00,322,620,2318627,520593,942,2839220,THURSDAY,0,0,24.4,52,22.3,1019.8,Rain
8/3/2023 16:00,411,989,1856303,1834847,1400,3691150,THURSDAY,0,0,25.6,45,20.5,1018.5,Cloudy
8/3/2023 17:00,517,1453,3596848,3136702,1970,6733550,THURSDAY,0,0,25.6,45,20.5,1018.5,Cloudy
8/3/2023 18:00,465,1211,1268925,2646371,1676,3915296,THURSDAY,0,0,26.7,49,25.9,1017.2,Cloudy
8/3/2023 19:00,370,809,8224426,693652,1179,8918078,THURSDAY,0,0,26.7,49,25.9,1017.2,Rain
8/3/2023 20:00,262,588,5144594,823326,850,5967920,THURSDAY,0,0,25,54,29.5,1016.8,Cloudy
8/3/2023 21:00,186,377,4397759,320607,563,4718366,THURSDAY,0,0,23.3,56,29.5,1016.6,Cloudy
8/3/2023 22:00,173,256,2019380,325254,429,2344634,THURSDAY,0,0,23.3,56,33.5,1016.6,Cloudy
8/3/2023 23:00,77,126,87647,128979,203,216626,THURSDAY,0,0,21.7,59,25.9,1016.7,Cloudy
8/4/2023 0:00,55,62,97543,44522,117,142065,FRIDAY,0,0,21.1,59,24.1,1017.3,Cloudy
8/4/2023 1:00,45,37,128187,38594,82,166781,FRIDAY,0,0,20.6,61,16.6,1017.1,Cloudy
8/4/2023 2:00,17,28,24493,23740,45,48233,FRIDAY,0,0,20,65,20.5,1017.1,Cloudy
8/4/2023 3:00,9,11,19336,9156,20,28492,FRIDAY,0,0,20,65,20.5,1017.1,Cloudy
8/4/2023 4:00,9,21,26825,19129,30,45954,FRIDAY,0,0,19.4,73,16.6,1016.5,Cloudy
8/4/2023 5:00,18,67,424079,53750,85,477829,FRIDAY,0,0,18.9,78,16.6,1015.7,Cloudy
8/4/2023 6:00,56,228,75941,209891,284,285832,FRIDAY,0,0,18.9,78,16.6,1015.4,Cloudy
8/4/2023 7:00,93,494,134457,610296,587,744753,FRIDAY,0,0,18.9,78,16.6,1015.4,Cloudy
8/4/2023 8:00,158,948,155707,787930,1106,943637,FRIDAY,0,0,19.4,79,16.6,1014.9,Cloudy
8/4/2023 9:00,155,632,335773,477646,787,813419,FRIDAY,0,0,19.4,79,16.6,1015,Cloudy
8/4/2023 10:00,177,399,364955,1011794,576,1376749,FRIDAY,0,0,19.4,81,16.6,1014.8,Cloudy
8/4/2023 11:00,218,415,2681712,344615,633,3026327,FRIDAY,0,0,20,78,14.8,1014.8,Cloudy
8/4/2023 12:00,220,481,474333,374932,701,849265,FRIDAY,0,0,20,78,14.8,1014.8,Cloudy
8/4/2023 13:00,237,517,2816093,388908,754,3205001,FRIDAY,0,0,21.7,79,20.5,1014.4,Cloudy
8/4/2023 14:00,316,548,2072422,453950,864,2526372,FRIDAY,0,0,23.3,71,25.9,1014.2,Rain
8/4/2023 15:00,347,615,1417967,581707,962,1999674,FRIDAY,0,0,24.4,69,20.5,1013.9,Rain
8/4/2023 16:00,354,846,14468834,707233,1200,15176067,FRIDAY,0,0,24.4,69,20.5,1013.9,Rain
8/4/2023 17:00,412,1085,4045553,2106358,1497,6151911,FRIDAY,0,0,26.7,58,22.3,1013.5,Rain
8/4/2023 18:00,406,937,1128133,1282977,1343,2411110,FRIDAY,0,0,25,66,22.3,1012.9,Rain
8/4/2023 19:00,267,721,1166374,621390,988,1787764,FRIDAY,0,0,26.1,60,18.4,1012.4,Rain
8/4/2023 20:00,214,442,4485725,447080,656,4932805,FRIDAY,0,0,25,66,18.4,1012.5,Rain
8/4/2023 21:00,237,352,577505,327125,589,904630,FRIDAY,0,0,25,69,25.9,1012.5,Rain
8/4/2023 22:00,283,273,1325857,232639,556,1558496,FRIDAY,0,0,25,69,25.9,1012.5,Rain
8/4/2023 23:00,164,224,437970,202268,388,640238,FRIDAY,0,0,23.9,69,24.1,1012.7,Rain
8/5/2023 0:00,121,155,202744,134272,276,337016,SATURDAY,1,0,22.8,73,20.5,1012.4,Rain
8/5/2023 1:00,166,96,5539803,73563,262,5613366,SATURDAY,1,0,22.8,73,18.4,1013.1,Rain
8/5/2023 2:00,82,65,1483825,57732,147,1541557,SATURDAY,1,0,22.8,73,18.4,1013.1,Rain
8/5/2023 3:00,26,28,3379865,26669,54,3406534,SATURDAY,1,0,22.2,76,16.6,1013.2,Rain
8/5/2023 4:00,8,13,651353,8871,21,660224,SATURDAY,1,0,21.7,81,18.4,1013,Rain
8/5/2023 5:00,18,21,45324,30039,39,75363,SATURDAY,1,0,20.6,87,14.8,1013,Cloudy
8/5/2023 6:00,27,87,83938,73668,114,157606,SATURDAY,1,0,21.1,84,13,1012.6,Cloudy
8/5/2023 7:00,60,159,95636,146998,219,242634,SATURDAY,1,0,21.1,84,13,1012.6,Cloudy
8/5/2023 8:00,109,254,247659,228163,363,475822,SATURDAY,1,0,21.1,87,14.8,1012.3,Cloudy
8/5/2023 9:00,218,442,446876,359838,660,806714,SATURDAY,1,0,21.1,87,11.2,1012.6,Cloudy
8/5/2023 10:00,374,465,793213,1201118,839,1994331,SATURDAY,1,0,21.7,84,13,1013,Rain
8/5/2023 11:00,451,598,6732337,556247,1049,7288584,SATURDAY,1,0,21.7,84,9.4,1013.2,Cloudy
8/5/2023 12:00,535,607,1449125,590475,1142,2039600,SATURDAY,1,0,21.7,84,9.4,1013.2,Cloudy
8/5/2023 13:00,497,581,1121687,553148,1078,1674835,SATURDAY,1,0,23.3,74,13,1014,Cloudy
8/5/2023 14:00,594,610,3920002,4047521,1204,7967523,SATURDAY,1,0,23.3,74,9.4,1014.3,Cloudy
8/5/2023 15:00,586,583,1592850,573464,1169,2166314,SATURDAY,1,0,23.3,79,14.8,1014.2,Cloudy
8/5/2023 16:00,557,587,3072836,566268,1144,3639104,SATURDAY,1,0,23.3,79,14.8,1014.2,Cloudy
8/5/2023 17:00,480,608,6647813,6148574,1088,12796387,SATURDAY,1,0,23.3,76,16.6,1013.9,Cloudy
8/5/2023 18:00,469,583,5863665,701358,1052,6565023,SATURDAY,1,0,22.8,76,13,1014,Cloudy
8/5/2023 19:00,563,623,1432483,1453552,1186,2886035,SATURDAY,1,0,22.2,76,14.8,1013.7,Cloudy
8/5/2023 20:00,321,428,6346468,657431,749,7003899,SATURDAY,1,0,21.1,82,14.8,1013.6,Cloudy
8/5/2023 21:00,245,352,982489,490117,597,1472606,SATURDAY,1,0,21.1,82,14.8,1013.6,Cloudy
8/5/2023 22:00,234,275,448363,363413,509,811776,SATURDAY,1,0,21.1,76,9.4,1013.7,Cloudy
8/5/2023 23:00,215,207,1104089,182555,422,1286644,SATURDAY,1,0,21.1,78,7.6,1013.8,Cloudy
8/6/2023 0:00,147,128,906515,102594,275,1009109,SUNDAY,1,0,20.6,81,7.6,1014.5,Cloudy
8/6/2023 1:00,235,122,2814003,154734,357,2968737,SUNDAY,1,0,19.4,87,7.6,1015,Cloudy
8/6/2023 2:00,116,61,833283,71871,177,905154,SUNDAY,1,0,19.4,87,7.6,1015,Cloudy
8/6/2023 3:00,19,14,35856,10286,33,46142,SUNDAY,1,0,22.2,57,11.2,1015.3,Cloudy
8/6/2023 4:00,7,18,6578,239940,25,246518,SUNDAY,1,0,21.7,55,16.6,1015.2,Fair
8/6/2023 5:00,10,20,14949,19097,30,34046,SUNDAY,1,0,20.6,59,13,1015.2,Cloudy
8/6/2023 6:00,14,68,20189,58882,82,79071,SUNDAY,1,0,20,61,14.8,1015.4,Fair
8/6/2023 7:00,41,123,340375,99330,164,439705,SUNDAY,1,0,20,61,14.8,1015.4,Fair
8/6/2023 8:00,109,225,239306,230471,334,469777,SUNDAY,1,0,18.9,68,11.2,1015.7,Fair
8/6/2023 9:00,196,336,753908,333055,532,1086963,SUNDAY,1,0,18.3,70,9.4,1015.8,Fair
8/6/2023 10:00,339,452,3409081,493392,791,3902473,SUNDAY,1,0,18.9,68,13,1016.2,Rain
8/6/2023 11:00,445,500,1109944,622776,945,1732720,SUNDAY,1,0,18.9,68,13,1016.2,Fair
8/6/2023 12:00,497,576,1955910,620597,1073,2576507,SUNDAY,1,0,22.8,55,5.4,1016.1,Fair
8/6/2023 13:00,492,584,1364891,561224,1076,1926115,SUNDAY,1,0,24.4,48,0,1016.1,Fair
8/6/2023 14:00,549,554,1791420,547294,1103,2338714,SUNDAY,1,0,25,47,13,1015.7,Fair
8/6/2023 15:00,606,563,5290664,541517,1169,5832181,SUNDAY,1,0,25,47,11.2,1015.4,Fair
8/6/2023 16:00,627,596,8353058,986758,1223,9339816,SUNDAY,1,0,25,47,11.2,1015.4,Fair
8/6/2023 17:00,586,648,2797192,585897,1234,3383089,SUNDAY,1,0,27.2,39,5.4,1014.8,Fair
8/6/2023 18:00,482,598,1570843,972240,1080,2543083,SUNDAY,1,0,28.9,35,14.8,1014.6,Fair
8/6/2023 19:00,365,493,4911513,534444,858,5445957,SUNDAY,1,0,28.9,35,14.8,1014.6,Rain
8/6/2023 20:00,250,396,914708,338607,646,1253315,SUNDAY,1,0,27.8,37,11.2,1014.3,Cloudy
8/6/2023 21:00,176,301,2951165,517062,477,3468227,SUNDAY,1,0,27.8,37,11.2,1014.3,Cloudy
8/6/2023 22:00,111,195,894453,175684,306,1070137,SUNDAY,1,0,27.8,35,9.4,1014.1,Cloudy
8/6/2023 23:00,93,109,459877,563916,202,1023793,SUNDAY,1,0,27.2,37,13,1014.3,Cloudy
8/7/2023 0:00,35,54,106748,49951,89,156699,MONDAY,0,0,23.9,60,14.8,1015,Cloudy
8/7/2023 1:00,21,29,30178,21099,50,51277,MONDAY,0,0,23.3,62,13,1015.4,Cloudy
8/7/2023 2:00,14,8,841108,4553,22,845661,MONDAY,0,0,23.3,62,13,1015.4,Cloudy
8/7/2023 3:00,10,11,18723,11718,21,30441,MONDAY,0,0,22.2,66,22.3,1015.5,Fair
8/7/2023 4:00,3,10,3033,8974,13,12007,MONDAY,0,0,22.2,64,18.4,1015.3,Fair
8/7/2023 5:00,15,81,14518,69660,96,84178,MONDAY,0,0,21.1,68,9.4,1015.2,Fair
8/7/2023 6:00,53,289,48965,208639,342,257604,MONDAY,0,0,21.1,68,9.4,1015.2,Fair
8/7/2023 7:00,125,607,7737764,905996,732,8643760,MONDAY,0,0,20,76,7.6,1015.3,Fair
8/7/2023 8:00,191,913,2873459,678989,1104,3552448,MONDAY,0,0,19.4,79,9.4,1015.2,Cloudy
8/7/2023 9:00,134,539,201074,420234,673,621308,MONDAY,0,0,18.9,84,9.4,1015.3,Cloudy
8/7/2023 10:00,132,268,306500,193367,400,499867,MONDAY,0,0,20.6,78,9.4,1015.4,Cloudy
8/7/2023 11:00,92,224,148239,167751,316,315990,MONDAY,0,0,20.6,78,9.4,1015.4,Cloudy
8/7/2023 12:00,172,348,377357,270411,520,647768,MONDAY,0,0,22.2,76,9.4,1015.9,Cloudy
8/7/2023 13:00,155,288,6601904,459611,443,7061515,MONDAY,0,0,21.7,81,9.4,1015.8,Cloudy
8/7/2023 14:00,229,346,4325571,257250,575,4582821,MONDAY,0,0,21.7,81,11.2,1016,Cloudy
8/7/2023 15:00,247,473,3873387,1687739,720,5561126,MONDAY,0,0,20.6,87,11.2,1015.8,Cloudy
8/7/2023 16:00,316,686,868016,579596,1002,1447612,MONDAY,0,0,20.6,87,11.2,1015.8,Cloudy
8/7/2023 17:00,444,1169,6279804,898843,1613,7178647,MONDAY,0,0,22.8,71,20.5,1014.6,Cloudy
8/7/2023 18:00,511,1029,3964213,818280,1540,4782493,MONDAY,0,0,22.8,71,24.1,1014.1,Cloudy
8/7/2023 19:00,357,801,10756130,625367,1158,11381497,MONDAY,0,0,21.1,76,18.4,1013.8,Cloudy
8/7/2023 20:00,304,568,474190,540549,872,1014739,MONDAY,0,0,20,87,16.6,1013.2,Cloudy
8/7/2023 21:00,213,356,339559,310528,569,650087,MONDAY,0,0,20,87,16.6,1013.2,Cloudy
8/7/2023 22:00,180,247,401535,248296,427,649831,MONDAY,0,0,20,81,13,1012,Cloudy
8/7/2023 23:00,74,91,3582627,290473,165,3873100,MONDAY,0,0,20,81,13,1012,Cloudy
8/8/2023 0:00,30,53,25294,41944,83,67238,TUESDAY,0,0,20,84,9.4,1011.9,Cloudy
8/8/2023 1:00,18,22,38044,13723,40,51767,TUESDAY,0,0,19.4,84,14.8,1011.8,Cloudy
8/8/2023 2:00,16,4,331997,200278,20,532275,TUESDAY,0,0,19.4,87,7.6,1011.8,Cloudy
8/8/2023 3:00,4,7,5026,4009,11,9035,TUESDAY,0,0,20,93,14.8,1010,Cloudy
8/8/2023 4:00,3,9,2703,6056,12,8759,TUESDAY,0,0,20,93,11.2,1008.7,Rain
8/8/2023 5:00,12,69,8807,58494,81,67301,TUESDAY,0,0,19.4,100,5.4,1008.1,Rain
8/8/2023 6:00,31,217,23734,148083,248,171817,TUESDAY,0,0,19.4,100,5.4,1008.1,Rain
8/8/2023 7:00,87,488,78713,365456,575,444169,TUESDAY,0,0,18.9,96,9.4,1007.5,Rain
8/8/2023 8:00,120,983,109356,765294,1103,874650,TUESDAY,0,0,20,96,14.8,1006.8,Rain
8/8/2023 9:00,109,546,144333,385343,655,529676,TUESDAY,0,0,20,96,16.6,1006.2,Rain
8/8/2023 10:00,8,50,10268,28748,58,39016,TUESDAY,0,0,20,96,13,1005.7,Rain
8/8/2023 11:00,3,34,1857,25895,37,27752,TUESDAY,0,0,20,96,13,1005.7,Rain
8/8/2023 12:00,62,273,72044,238694,335,310738,TUESDAY,0,0,22.2,94,14.8,1005,Rain
8/8/2023 13:00,155,326,266349,239312,481,505661,TUESDAY,0,0,23.9,84,22.3,1003,Rain
8/8/2023 14:00,216,420,6188932,315908,636,6504840,TUESDAY,0,0,23.9,84,22.3,1003,Rain
8/8/2023 15:00,203,499,1612655,377967,702,1990622,TUESDAY,0,0,22.8,96,24.1,1001.9,Rain
8/8/2023 16:00,372,887,611686,758004,1259,1369690,TUESDAY,0,0,22.8,96,9.4,1002,Rain
8/8/2023 17:00,515,1378,1372059,1300319,1893,2672378,TUESDAY,0,0,25.6,82,13,1000.1,Rain
8/8/2023 18:00,434,1119,7856102,912620,1553,8768722,TUESDAY,0,0,25.6,79,14.8,999.6,Rain
8/8/2023 19:00,331,821,664033,740777,1152,1404810,TUESDAY,0,0,28.3,70,7.6,998.9,Rain
8/8/2023 20:00,214,542,3828970,454014,756,4282984,TUESDAY,0,0,28.3,68,18.4,998.8,Rain
8/8/2023 21:00,202,395,4569577,394904,597,4964481,TUESDAY,0,0,28.3,68,18.4,998.8,Rain
8/8/2023 22:00,186,270,853520,209819,456,1063339,TUESDAY,0,0,25.6,76,25.9,998.1,Rain
8/8/2023 23:00,101,143,389577,122708,244,512285,TUESDAY,0,0,25.6,71,25.9,998.4,Rain
8/9/2023 0:00,40,67,2305653,56940,107,2362593,WEDNESDAY,0,0,24.4,71,20.5,999.1,Rain
8/9/2023 1:00,18,27,612697,28039,45,640736,WEDNESDAY,0,0,24.4,71,20.5,999.1,Cloudy
8/9/2023 2:00,6,10,9406,8352,16,17758,WEDNESDAY,0,0,23.3,74,22.3,998.7,Cloudy
8/9/2023 3:00,2,7,12747,5703,9,18450,WEDNESDAY,0,0,22.8,73,22.3,998.8,Cloudy
8/9/2023 4:00,3,14,2855,8293,17,11148,WEDNESDAY,0,0,22.2,73,24.1,998.7,Cloudy
8/9/2023 5:00,15,84,15851,74732,99,90583,WEDNESDAY,0,0,22.2,73,22.3,998.9,Cloudy
8/9/2023 6:00,48,311,32234,239679,359,271913,WEDNESDAY,0,0,22.2,73,22.3,998.9,Cloudy
8/9/2023 7:00,145,764,178807,605703,909,784510,WEDNESDAY,0,0,21.7,76,25.9,999.3,Cloudy
8/9/2023 8:00,238,1307,241312,1169117,1545,1410429,WEDNESDAY,0,0,21.7,76,25.9,999.6,Cloudy
8/9/2023 9:00,181,711,483406,596861,892,1080267,WEDNESDAY,0,0,21.7,76,24.1,1000.3,Cloudy
8/9/2023 10:00,163,378,334974,355460,541,690434,WEDNESDAY,0,0,22.2,73,29.5,1000.1,Cloudy
8/9/2023 11:00,170,421,295809,344017,591,639826,WEDNESDAY,0,0,22.2,73,25.9,1000.1,Cloudy
8/9/2023 12:00,175,489,1210663,468346,664,1679009,WEDNESDAY,0,0,24.4,56,24.1,1001.7,Cloudy
8/9/2023 13:00,216,465,2543689,378013,681,2921702,WEDNESDAY,0,0,25,52,29.5,1002.3,Cloudy
8/9/2023 14:00,204,442,744259,356272,646,1100531,WEDNESDAY,0,0,25,52,29.5,1002.4,Cloudy
8/9/2023 15:00,255,578,4375372,614415,833,4989787,WEDNESDAY,0,0,26.7,45,27.7,1002.3,Cloudy
8/9/2023 16:00,371,966,1501622,1016980,1337,2518602,WEDNESDAY,0,0,26.7,45,38.9,1002.3,Cloudy
8/9/2023 17:00,556,1526,3851375,6455041,2082,10306416,WEDNESDAY,0,0,27.2,44,27.7,1001.9,Cloudy
8/9/2023 18:00,503,1142,6571800,1460139,1645,8031939,WEDNESDAY,0,0,28.9,41,29.5,1002,Cloudy
8/9/2023 19:00,352,786,2403598,765710,1138,3169308,WEDNESDAY,0,0,28.3,41,27.7,1002.1,Cloudy
8/9/2023 20:00,274,608,11702659,598166,882,12300825,WEDNESDAY,0,0,28.3,41,24.1,1002.1,Cloudy
8/9/2023 21:00,260,412,1182645,445186,672,1627831,WEDNESDAY,0,0,28.3,41,24.1,1003.1,Cloudy
8/9/2023 22:00,177,284,2558345,262685,461,2821030,WEDNESDAY,0,0,27.8,44,22.3,1003.6,Cloudy
8/9/2023 23:00,70,123,149398,100850,193,250248,WEDNESDAY,0,0,26.7,51,16.6,1003.9,Fair
8/10/2023 0:00,35,55,240763,47702,90,288465,THURSDAY,0,0,26.7,51,16.6,1003.9,Fair
8/10/2023 1:00,26,40,98444,38726,66,137170,THURSDAY,0,0,25.6,56,14.8,1004.8,Fair
8/10/2023 2:00,10,16,16372,20304,26,36676,THURSDAY,0,0,25,58,20.5,1005.4,Fair
8/10/2023 3:00,3,14,7456,14787,17,22243,THURSDAY,0,0,24.4,58,25.9,1005.9,Fair
8/10/2023 4:00,10,18,11696,16500,28,28196,THURSDAY,0,0,23.9,58,18.4,1005.9,Fair
8/10/2023 5:00,15,84,30269,81255,99,111524,THURSDAY,0,0,23.9,58,18.4,1005.9,Fair
8/10/2023 6:00,63,304,50886,213673,367,264559,THURSDAY,0,0,23.3,57,18.4,1005.8,Fair
8/10/2023 7:00,121,680,128176,527059,801,655235,THURSDAY,0,0,22.8,59,14.8,1005.3,Clear
8/10/2023 8:00,222,1315,292309,1080649,1537,1372958,THURSDAY,0,0,22.2,59,13,1005.6,Fair
8/10/2023 9:00,162,725,253813,1563490,887,1817303,THURSDAY,0,0,21.7,61,11.2,1006,Fair
8/10/2023 10:00,155,413,267494,2515825,568,2783319,THURSDAY,0,0,21.7,61,11.2,1006,Rain
8/10/2023 11:00,192,415,399770,425654,607,825424,THURSDAY,0,0,23.3,60,11.2,1006,Fair
8/10/2023 12:00,205,505,2609183,385119,710,2994302,THURSDAY,0,0,24.4,56,16.6,1006.2,Cloudy
8/10/2023 13:00,226,436,563187,320318,662,883505,THURSDAY,0,0,25.6,54,11.2,1006.3,Cloudy
8/10/2023 14:00,214,476,680923,373561,690,1054484,THURSDAY,0,0,26.7,56,14.8,1006.7,Cloudy
8/10/2023 15:00,273,623,1118719,904717,896,2023436,THURSDAY,0,0,26.7,56,14.8,1006.7,Cloudy
8/10/2023 16:00,317,842,2586498,837196,1159,3423694,THURSDAY,0,0,29.4,46,18.4,1005.7,Cloudy
8/10/2023 17:00,319,1098,1390523,2622181,1417,4012704,THURSDAY,0,0,28.9,48,18.4,1005.3,Cloudy
8/10/2023 18:00,308,895,1923414,1548180,1203,3471594,THURSDAY,0,0,26.7,58,18.4,1004.9,Cloudy
8/10/2023 19:00,103,411,172242,529673,514,701915,THURSDAY,0,0,26.1,56,25.9,1004.5,Cloudy
8/10/2023 20:00,66,276,74130,859812,342,933942,THURSDAY,0,0,26.1,56,25.9,1004.5,Rain
8/10/2023 21:00,72,209,124681,213205,281,337886,THURSDAY,0,0,23.9,76,13,1003.7,Rain
8/10/2023 22:00,120,209,166974,201444,329,368418,THURSDAY,0,0,23.9,76,16.6,1003.5,Rain
8/10/2023 23:00,80,150,713753,418522,230,1132275,THURSDAY,0,0,23.3,85,16.6,1003.3,Rain
8/11/2023 0:00,35,64,41293,48104,99,89397,FRIDAY,0,0,22.2,91,13,1002.8,Rain
8/11/2023 1:00,10,21,34811,13466,31,48277,FRIDAY,0,0,22.2,91,13,1002.8,Rain
8/11/2023 2:00,8,9,2310424,8562,17,2318986,FRIDAY,0,0,22.2,87,20.5,1001.9,Rain
8/11/2023 3:00,3,14,1400,14888,17,16288,FRIDAY,0,0,22.2,84,16.6,1001.4,Rain
8/11/2023 4:00,6,11,3629571,13242,17,3642813,FRIDAY,0,0,22.2,84,16.6,1001.4,Rain
8/11/2023 5:00,28,69,310826,65016,97,375842,FRIDAY,0,0,21.1,90,16.6,1001.1,Rain
8/11/2023 6:00,48,224,44584,484896,272,529480,FRIDAY,0,0,21.1,90,16.6,1000.9,Rain
8/11/2023 7:00,103,507,111490,541419,610,652909,FRIDAY,0,0,20.6,87,16.6,1001.1,Cloudy
8/11/2023 8:00,178,889,220264,970513,1067,1190777,FRIDAY,0,0,20.6,84,18.4,1001.5,Cloudy
8/11/2023 9:00,147,590,795756,451777,737,1247533,FRIDAY,0,0,20.6,81,16.6,1002.4,Fair
8/11/2023 10:00,198,442,440871,361456,640,802327,FRIDAY,0,0,20.6,81,16.6,1002.4,Rain
8/11/2023 11:00,191,424,401344,570980,615,972324,FRIDAY,0,0,20.6,73,25.9,1004,Fair
8/11/2023 12:00,240,506,521638,406837,746,928475,FRIDAY,0,0,22.8,64,24.1,1004.5,Fair
8/11/2023 13:00,280,521,671652,428060,801,1099712,FRIDAY,0,0,24.4,56,20.5,1004.5,Fair
8/11/2023 14:00,299,510,1060511,688782,809,1749293,FRIDAY,0,0,24.4,56,20.5,1004.5,Fair
8/11/2023 15:00,339,611,1799587,718724,950,2518311,FRIDAY,0,0,25.6,50,27.7,1004.8,Fair
8/11/2023 16:00,392,878,2155288,1252202,1270,3407490,FRIDAY,0,0,26.7,45,24.1,1005.1,Rain
8/11/2023 17:00,541,1056,6688593,1353799,1597,8042392,FRIDAY,0,0,26.7,45,24.1,1005.1,Fair
8/11/2023 18:00,505,1012,7954926,970024,1517,8924950,FRIDAY,0,0,27.2,39,20.5,1005.9,Fair
8/11/2023 19:00,429,730,1620541,2008724,1159,3629265,FRIDAY,0,0,27.2,38,31.7,1006.1,Fair
8/11/2023 20:00,242,518,555870,415401,760,971271,FRIDAY,0,0,27.2,38,31.7,1006.1,Fair
8/11/2023 21:00,270,380,986429,311548,650,1297977,FRIDAY,0,0,27.8,37,27.7,1007.2,Fair
8/11/2023 22:00,300,315,746102,260472,615,1006574,FRIDAY,0,0,26.7,39,22.3,1007.9,Fair
8/11/2023 23:00,273,241,830895,237145,514,1068040,FRIDAY,0,0,25.6,43,18.4,1008.2,Fair
8/12/2023 0:00,192,170,2260518,143636,362,2404154,SATURDAY,1,0,25.6,43,18.4,1008.2,Fair
8/12/2023 1:00,145,129,297597,127342,274,424939,SATURDAY,1,0,24.4,48,18.4,1010.1,Fair
8/12/2023 2:00,114,64,536877,50963,178,587840,SATURDAY,1,0,23.9,50,16.6,1010.9,Fair
8/12/2023 3:00,18,19,2257459,45199,37,2302658,SATURDAY,1,0,23.3,52,18.4,1011.3,Fair
8/12/2023 4:00,10,9,36241,10430,19,46671,SATURDAY,1,0,21.7,59,18.4,1011.7,Fair
8/12/2023 5:00,13,25,16824,27548,38,44372,SATURDAY,1,0,21.7,59,18.4,1011.7,Fair
8/12/2023 6:00,18,60,27087,89837,78,116924,SATURDAY,1,0,20,65,13,1011.8,Clear
8/12/2023 7:00,46,141,61401,121494,187,182895,SATURDAY,1,0,19.4,68,7.6,1012.4,Clear
8/12/2023 8:00,103,250,167112,240583,353,407695,SATURDAY,1,0,17.2,78,7.6,1012.7,Fair
8/12/2023 9:00,208,395,699044,317582,603,1016626,SATURDAY,1,0,17.8,78,0,1013.1,Fair
8/12/2023 10:00,322,480,892889,421173,802,1314062,SATURDAY,1,0,17.8,78,0,1013.1,Rain
8/12/2023 11:00,428,550,3637103,864723,978,4501826,SATURDAY,1,0,21.7,63,5.4,1013.9,Fair
8/12/2023 12:00,478,595,1551431,533441,1073,2084872,SATURDAY,1,0,22.8,59,5.4,1013.7,Fair
8/12/2023 13:00,436,566,9090561,489116,1002,9579677,SATURDAY,1,0,22.8,57,7.6,1013.8,Fair
8/12/2023 14:00,485,586,2182886,536364,1071,2719250,SATURDAY,1,0,22.8,57,7.6,1013.8,Fair
8/12/2023 15:00,634,596,5491669,1658814,1230,7150483,SATURDAY,1,0,23.9,58,16.6,1013.4,Cloudy
8/12/2023 16:00,506,594,4342127,566939,1100,4909066,SATURDAY,1,0,23.9,62,18.4,1012.9,Cloudy
8/12/2023 17:00,489,614,1691169,604645,1103,2295814,SATURDAY,1,0,23.9,62,18.4,1012.9,Cloudy
8/12/2023 18:00,489,606,2288858,760217,1095,3049075,SATURDAY,1,0,24.4,60,24.1,1012.5,Cloudy
8/12/2023 19:00,469,557,1399891,551639,1026,1951530,SATURDAY,1,0,23.9,66,24.1,1012.3,Cloudy
8/12/2023 20:00,322,450,1004966,845617,772,1850583,SATURDAY,1,0,24.4,69,7.6,1011.3,Cloudy
8/12/2023 21:00,213,363,1101462,320304,576,1421766,SATURDAY,1,0,27.8,51,18.4,1010.8,Cloudy
8/12/2023 22:00,219,245,4911045,263024,464,5174069,SATURDAY,1,0,26.1,65,20.5,1011.3,Cloudy
8/12/2023 23:00,219,197,468179,1179443,416,1647622,SATURDAY,1,0,25,69,18.4,1011.4,Cloudy
8/13/2023 0:00,162,131,3601990,123151,293,3725141,SUNDAY,1,0,25,69,18.4,1011.4,Cloudy
8/13/2023 1:00,177,106,3352009,127503,283,3479512,SUNDAY,1,0,22.8,76,14.8,1011.7,Cloudy
8/13/2023 2:00,122,61,388374,67831,183,456205,SUNDAY,1,0,22.8,79,14.8,1011.3,Cloudy
8/13/2023 3:00,20,23,29211,28281,43,57492,SUNDAY,1,0,22.8,81,14.8,1010.9,Cloudy
8/13/2023 4:00,6,10,7507,10187,16,17694,SUNDAY,1,0,23.3,82,11.2,1010.6,Cloudy
8/13/2023 5:00,7,12,7735,9552,19,17287,SUNDAY,1,0,23.3,82,11.2,1010.6,Cloudy
8/13/2023 6:00,5,22,3219,12581,27,15800,SUNDAY,1,0,22.8,84,14.8,1010.7,Cloudy
8/13/2023 7:00,25,81,37147,141836,106,178983,SUNDAY,1,0,22.8,84,13,1010.2,Rain
8/13/2023 8:00,64,187,97309,149170,251,246479,SUNDAY,1,0,22.8,84,16.6,1009.8,Rain
8/13/2023 9:00,161,299,279746,260484,460,540230,SUNDAY,1,0,22.8,87,20.5,1010.9,Rain
8/13/2023 10:00,284,407,1444645,333675,691,1778320,SUNDAY,1,0,22.8,87,20.5,1010.9,Rain
8/13/2023 11:00,391,483,1185346,468468,874,1653814,SUNDAY,1,0,21.7,87,22.3,1010.7,Rain
8/13/2023 12:00,360,508,3409996,541889,868,3951885,SUNDAY,1,0,23.3,85,9.4,1010.7,Rain
8/13/2023 13:00,393,576,4064528,554228,969,4618756,SUNDAY,1,0,25,79,13,1010.6,Rain
8/13/2023 14:00,473,575,3415008,3972220,1048,7387228,SUNDAY,1,0,25,79,13,1010.6,Cloudy
8/13/2023 15:00,429,578,3920005,540575,1007,4460580,SUNDAY,1,0,28.3,63,18.4,1009.8,Cloudy
8/13/2023 16:00,488,591,1335919,591164,1079,1927083,SUNDAY,1,0,27.8,67,18.4,1009.2,Cloudy
8/13/2023 17:00,393,544,770758,574865,937,1345623,SUNDAY,1,0,30,59,18.4,1008.6,Cloudy
8/13/2023 18:00,353,582,5303085,561262,935,5864347,SUNDAY,1,0,30.6,57,22.3,1008.3,Cloudy
8/13/2023 19:00,335,516,1649209,438767,851,2087976,SUNDAY,1,0,30.6,57,22.3,1008.3,Cloudy
8/13/2023 20:00,219,371,504145,316470,590,820615,SUNDAY,1,0,30,59,18.4,1008.5,Cloudy
8/13/2023 21:00,142,295,295022,242951,437,537973,SUNDAY,1,0,30,59,9.4,1008.5,Cloudy
8/13/2023 22:00,91,176,128924,129214,267,258138,SUNDAY,1,0,27.8,56,18.4,1009.8,Cloudy
8/13/2023 23:00,57,93,116216,104074,150,220290,SUNDAY,1,0,26.7,58,18.4,1010.7,Cloudy
8/14/2023 0:00,36,45,1339734,34974,81,1374708,MONDAY,0,0,26.7,58,18.4,1010.7,Cloudy
8/14/2023 1:00,13,33,748659,33398,46,782057,MONDAY,0,0,26.1,52,22.3,1011.4,Cloudy
8/14/2023 2:00,11,14,13555,9704,25,23259,MONDAY,0,0,25,54,13,1011.9,Fair
8/14/2023 3:00,6,7,71331,9290,13,80621,MONDAY,0,0,24.4,54,16.6,1012.2,Fair
8/14/2023 4:00,8,14,11025,15184,22,26209,MONDAY,0,0,24.4,54,16.6,1012.2,Fair
8/14/2023 5:00,19,77,18286,58522,96,76808,MONDAY,0,0,22.8,59,18.4,1012.2,Fair
8/14/2023 6:00,34,243,23894,172284,277,196178,MONDAY,0,0,22.2,61,18.4,1012.2,Fair
8/14/2023 7:00,123,611,132538,457928,734,590466,MONDAY,0,0,21.7,63,14.8,1012.4,Fair
8/14/2023 8:00,197,1021,578885,822738,1218,1401623,MONDAY,0,0,21.7,63,14.8,1012.5,Fair
8/14/2023 9:00,132,652,216988,901757,784,1118745,MONDAY,0,0,21.7,63,14.8,1012.5,Fair
8/14/2023 10:00,184,348,425401,339300,532,764701,MONDAY,0,0,21.1,66,14.8,1013.3,Rain
8/14/2023 11:00,208,336,519452,249482,544,768934,MONDAY,0,0,21.7,66,14.8,1013.6,Cloudy
8/14/2023 12:00,271,444,867743,337962,715,1205705,MONDAY,0,0,23.3,62,16.6,1014,Cloudy
8/14/2023 13:00,308,399,664090,317006,707,981096,MONDAY,0,0,24.4,56,18.4,1014.2,Cloudy
8/14/2023 14:00,340,392,8250017,349055,732,8599072,MONDAY,0,0,24.4,56,18.4,1014.2,Cloudy
8/14/2023 15:00,345,496,4845913,404698,841,5250611,MONDAY,0,0,26.7,52,16.6,1013.7,Cloudy
8/14/2023 16:00,452,867,14382563,1033136,1319,15415699,MONDAY,0,0,28.3,48,16.6,1013.5,Cloudy
8/14/2023 17:00,626,1248,7451958,1121118,1874,8573076,MONDAY,0,0,28.3,48,24.1,1013.2,Cloudy
8/14/2023 18:00,652,1150,10054340,1058037,1802,11112377,MONDAY,0,0,29.4,42,22.3,1012.7,Cloudy
8/14/2023 19:00,519,853,4326788,956948,1372,5283736,MONDAY,0,0,29.4,42,22.3,1012.7,Cloudy
8/14/2023 20:00,334,511,1231794,492157,845,1723951,MONDAY,0,0,28.3,44,22.3,1012.4,Cloudy
8/14/2023 21:00,217,356,6395529,263386,573,6658915,MONDAY,0,0,27.8,47,18.4,1012.1,Cloudy
8/14/2023 22:00,170,229,5166150,177834,399,5343984,MONDAY,0,0,27.8,47,14.8,1012.1,Cloudy
8/14/2023 23:00,62,123,84959,150224,185,235183,MONDAY,0,0,27.2,49,13,1012.7,Cloudy
8/15/2023 0:00,21,40,1889157,17692,61,1906849,TUESDAY,0,0,27.2,49,13,1012.7,Cloudy
8/15/2023 1:00,21,16,3862252,9558,37,3871810,TUESDAY,0,0,24.4,71,9.4,1013.1,Cloudy
8/15/2023 2:00,7,3,136493,2316,10,138809,TUESDAY,0,0,25,66,14.8,1013.2,Cloudy
8/15/2023 3:00,2,7,3513,11629,9,15142,TUESDAY,0,0,25,66,13,1013.1,Cloudy
8/15/2023 4:00,2,13,2393,8943,15,11336,TUESDAY,0,0,23.9,74,0,1012.7,Rain
8/15/2023 5:00,3,32,2609,27515,35,30124,TUESDAY,0,0,23.9,74,0,1012.7,Rain
8/15/2023 6:00,12,96,5728,62630,108,68358,TUESDAY,0,0,21.7,90,0,1011.9,Rain
8/15/2023 7:00,28,146,19230,144276,174,163506,TUESDAY,0,0,20.6,90,11.2,1010.5,Rain
8/15/2023 8:00,47,437,42629,294382,484,337011,TUESDAY,0,0,20.6,93,0,1010.9,Rain
8/15/2023 9:00,55,412,62807,249141,467,311948,TUESDAY,0,0,20.6,93,0,1010.9,Rain
8/15/2023 10:00,13,73,10677,49543,86,60220,TUESDAY,0,0,20,93,11.2,1010.5,Rain
8/15/2023 11:00,21,128,22858,81169,149,104027,TUESDAY,0,0,20,93,11.2,1010.5,Rain
8/15/2023 12:00,63,234,113279,184918,297,298197,TUESDAY,0,0,19.4,97,16.6,1010.3,Rain
8/15/2023 13:00,100,286,189632,222552,386,412184,TUESDAY,0,0,19.4,97,20.5,1009.7,Rain
8/15/2023 14:00,132,342,3994173,290865,474,4285038,TUESDAY,0,0,20,93,24.1,1009.8,Rain
8/15/2023 15:00,212,456,2279947,372080,668,2652027,TUESDAY,0,0,20,96,22.3,1010.1,Rain
8/15/2023 16:00,288,805,2536765,659853,1093,3196618,TUESDAY,0,0,20,96,22.3,1010.1,Rain
8/15/2023 17:00,405,1256,1299896,1268782,1661,2568678,TUESDAY,0,0,20,93,18.4,1009.8,Cloudy
8/15/2023 18:00,271,943,668126,4774864,1214,5442990,TUESDAY,0,0,20,90,20.5,1009.8,Rain
8/15/2023 19:00,215,634,300749,637496,849,938245,TUESDAY,0,0,20,90,20.5,1009.8,Rain
8/15/2023 20:00,166,446,312531,334145,612,646676,TUESDAY,0,0,20.6,87,14.8,1010.5,Cloudy
8/15/2023 21:00,131,339,780399,2449659,470,3230058,TUESDAY,0,0,20.6,87,14.8,1010.5,Cloudy
8/15/2023 22:00,89,237,109686,189927,326,299613,TUESDAY,0,0,20.6,87,11.2,1010.5,Cloudy
8/15/2023 23:00,71,139,147328,232853,210,380181,TUESDAY,0,0,20,90,9.4,1010.8,Cloudy
8/16/2023 0:00,29,53,70351,61014,82,131365,WEDNESDAY,0,0,20,90,9.4,1011.7,Cloudy
8/16/2023 1:00,13,26,28539,21012,39,49551,WEDNESDAY,0,0,20,90,0,1012.7,Cloudy
8/16/2023 2:00,11,14,22866,11943,25,34809,WEDNESDAY,0,0,19.4,91,9.4,1012.1,Cloudy
8/16/2023 3:00,8,15,25554,12837,23,38391,WEDNESDAY,0,0,19.4,91,9.4,1012.1,Cloudy
8/16/2023 4:00,8,11,10864,6826,19,17690,WEDNESDAY,0,0,19.4,93,7.6,1013.1,Cloudy
8/16/2023 5:00,16,116,15296,188697,132,203993,WEDNESDAY,0,0,18.9,96,5.4,1012,Cloudy
8/16/2023 6:00,55,295,53831,206202,350,260033,WEDNESDAY,0,0,18.9,96,7.6,1012.1,Cloudy
8/16/2023 7:00,95,688,167280,515508,783,682788,WEDNESDAY,0,0,18.9,96,7.6,1012.1,Cloudy
8/16/2023 8:00,181,1250,242395,934037,1431,1176432,WEDNESDAY,0,0,19.4,93,7.6,1012.1,Cloudy
8/16/2023 9:00,122,673,189179,543331,795,732510,WEDNESDAY,0,0,19.4,93,9.4,1012.6,Cloudy
8/16/2023 10:00,132,389,282663,350040,521,632703,WEDNESDAY,0,0,19.4,93,7.6,1013.8,Cloudy
8/16/2023 11:00,158,431,1022163,342119,589,1364282,WEDNESDAY,0,0,20,90,11.2,1014.2,Cloudy
8/16/2023 12:00,166,476,350210,332333,642,682543,WEDNESDAY,0,0,20.6,90,13,1013.9,Cloudy
8/16/2023 13:00,198,414,744070,305853,612,1049923,WEDNESDAY,0,0,20,87,13,1014.7,Cloudy
8/16/2023 14:00,202,413,433262,352076,615,785338,WEDNESDAY,0,0,20,87,13,1014.7,Cloudy
8/16/2023 15:00,257,586,4560123,496118,843,5056241,WEDNESDAY,0,0,20,87,11.2,1015,Cloudy
8/16/2023 16:00,322,985,488952,843049,1307,1332001,WEDNESDAY,0,0,20,87,11.2,1014.9,Cloudy
8/16/2023 17:00,504,1362,934322,1965926,1866,2900248,WEDNESDAY,0,0,21.1,84,14.8,1014.7,Cloudy
8/16/2023 18:00,361,1100,484733,997982,1461,1482715,WEDNESDAY,0,0,21.1,84,14.8,1014.7,Cloudy
8/16/2023 19:00,283,758,492235,3314577,1041,3806812,WEDNESDAY,0,0,20.6,87,14.8,1014.9,Cloudy
8/16/2023 20:00,179,508,2798303,995245,687,3793548,WEDNESDAY,0,0,20.6,87,13,1014.9,Cloudy
8/16/2023 21:00,142,376,183578,323905,518,507483,WEDNESDAY,0,0,20,90,13,1015,Cloudy
8/16/2023 22:00,149,262,404605,217244,411,621849,WEDNESDAY,0,0,19.4,93,13,1015,Cloudy
8/16/2023 23:00,105,130,346857,169229,235,516086,WEDNESDAY,0,0,19.4,93,13,1016,Cloudy
8/17/2023 0:00,39,67,46162,54163,106,100325,THURSDAY,0,0,19.4,93,9.4,1016.3,Cloudy
8/17/2023 1:00,36,30,200083,20763,66,220846,THURSDAY,0,0,18.9,93,14.8,1016.5,Cloudy
8/17/2023 2:00,11,11,8739,11189,22,19928,THURSDAY,0,0,18.9,96,5.4,1016.5,Cloudy
8/17/2023 3:00,3,8,4189,6554,11,10743,THURSDAY,0,0,19.4,93,0,1016.6,Cloudy
8/17/2023 4:00,4,20,4380,16849,24,21229,THURSDAY,0,0,19.4,93,0,1016.6,Cloudy
8/17/2023 5:00,18,85,14730,58912,103,73642,THURSDAY,0,0,18.9,93,0,1016.4,Cloudy
8/17/2023 6:00,52,234,62708,178151,286,240859,THURSDAY,0,0,19.4,93,0,1016.3,Cloudy
8/17/2023 7:00,98,645,124940,479009,743,603949,THURSDAY,0,0,19.4,93,0,1016.3,Cloudy
8/17/2023 8:00,191,1129,380910,878539,1320,1259449,THURSDAY,0,0,18.9,90,0,1016.4,Cloudy
8/17/2023 9:00,143,709,341612,546359,852,887971,THURSDAY,0,0,18.3,93,7.6,1016.8,Cloudy
8/17/2023 10:00,155,402,339931,344725,557,684656,THURSDAY,0,0,18.9,93,5.4,1017.1,Cloudy
8/17/2023 11:00,204,394,408730,290413,598,699143,THURSDAY,0,0,20,87,5.4,1017.4,Cloudy
8/17/2023 12:00,195,434,440270,317214,629,757484,THURSDAY,0,0,20,87,5.4,1017.4,Cloudy
8/17/2023 13:00,215,440,417235,343333,655,760568,THURSDAY,0,0,21.1,78,11.2,1016.8,Cloudy
8/17/2023 14:00,269,414,528393,414447,683,942840,THURSDAY,0,0,20.6,84,13,1017.3,Cloudy
8/17/2023 15:00,297,570,8533025,673404,867,9206429,THURSDAY,0,0,20.6,84,13,1016.8,Cloudy
8/17/2023 16:00,318,860,3842120,863622,1178,4705742,THURSDAY,0,0,21.1,84,14.8,1016.3,Cloudy
8/17/2023 17:00,437,1379,718559,1837741,1816,2556300,THURSDAY,0,0,21.1,84,14.8,1016.3,Cloudy
8/17/2023 18:00,395,1038,638806,1449642,1433,2088448,THURSDAY,0,0,20.6,87,16.6,1015.9,Cloudy
8/17/2023 19:00,298,805,403455,625283,1103,1028738,THURSDAY,0,0,20.6,87,16.6,1015.9,Cloudy
8/17/2023 20:00,195,520,365167,421274,715,786441,THURSDAY,0,0,20,87,16.6,1015.3,Cloudy
8/17/2023 21:00,161,354,203121,367924,515,571045,THURSDAY,0,0,20,93,7.6,1014.6,Cloudy
8/17/2023 22:00,152,250,2627478,218692,402,2846170,THURSDAY,0,0,19.4,97,11.2,1014,Cloudy
8/17/2023 23:00,134,151,6799294,135652,285,6934946,THURSDAY,0,0,19.4,97,11.2,1014,Cloudy
8/18/2023 0:00,56,82,110461,465731,138,576192,FRIDAY,0,0,19.4,97,9.4,1014,Cloudy
8/18/2023 1:00,34,32,3980168,58047,66,4038215,FRIDAY,0,0,19.4,97,11.2,1013.4,Cloudy
8/18/2023 2:00,19,21,41400,15535,40,56935,FRIDAY,0,0,19.4,97,9.4,1012.9,Cloudy
8/18/2023 3:00,6,11,6983,9439,17,16422,FRIDAY,0,0,19.4,97,9.4,1012.9,Cloudy
8/18/2023 4:00,9,15,10630,11300,24,21930,FRIDAY,0,0,19.4,100,5.4,1011.4,Cloudy
8/18/2023 5:00,21,67,32119,49170,88,81289,FRIDAY,0,0,19.4,100,7.6,1010.9,Cloudy
8/18/2023 6:00,41,189,29065,418684,230,447749,FRIDAY,0,0,20,96,11.2,1010.2,Cloudy
8/18/2023 7:00,70,413,82221,337948,483,420169,FRIDAY,0,0,19.4,100,5.4,1010.2,Cloudy
8/18/2023 8:00,116,744,3482796,6591145,860,10073941,FRIDAY,0,0,19.4,100,5.4,1009,Cloudy
8/18/2023 9:00,15,128,10982,515360,143,526342,FRIDAY,0,0,19.4,100,7.6,1008.3,Cloudy
8/18/2023 10:00,29,163,484901,108921,192,593822,FRIDAY,0,0,19.4,100,7.6,1008.3,Cloudy
8/18/2023 11:00,91,276,132499,264703,367,397202,FRIDAY,0,0,19.4,100,13,1006.8,Cloudy
8/18/2023 12:00,141,452,249559,2695432,593,2944991,FRIDAY,0,0,19.4,100,11.2,1006.8,Cloudy
8/18/2023 13:00,207,474,339679,3657211,681,3996890,FRIDAY,0,0,19.4,100,24.1,1005.6,Rain
8/18/2023 14:00,260,494,4806322,389496,754,5195818,FRIDAY,0,0,22.8,87,20.5,1003.8,Rain
8/18/2023 15:00,285,504,5596631,412661,789,6009292,FRIDAY,0,0,22.8,87,20.5,1003.8,Rain
8/18/2023 16:00,186,527,393198,465173,713,858371,FRIDAY,0,0,24.4,82,9.4,1003.4,Rain
8/18/2023 17:00,367,870,583480,745546,1237,1329026,FRIDAY,0,0,23.9,84,14.8,1003.4,Rain
8/18/2023 18:00,376,807,7024474,696992,1183,7721466,FRIDAY,0,0,23.9,84,14.8,1003.4,Rain
8/18/2023 19:00,389,671,7089276,1032738,1060,8122014,FRIDAY,0,0,26.1,74,20.5,1003.1,Rain
8/18/2023 20:00,280,505,1946988,412867,785,2359855,FRIDAY,0,0,22.8,87,13,1003,Rain
8/18/2023 21:00,219,359,699033,293733,578,992766,FRIDAY,0,0,25,79,14.8,1003.2,Cloudy
8/18/2023 22:00,198,259,4653008,228650,457,4881658,FRIDAY,0,0,25,79,14.8,1003.2,Cloudy
8/18/2023 23:00,283,184,7051709,213588,467,7265297,FRIDAY,0,0,25.6,69,18.4,1004.7,Cloudy
8/19/2023 0:00,167,142,1881777,155969,309,2037746,SATURDAY,1,0,23.3,60,20.5,1006.3,Fair
8/19/2023 1:00,227,98,3555007,93070,325,3648077,SATURDAY,1,0,22.2,59,16.6,1007.2,Fair
8/19/2023 2:00,96,58,1172520,74212,154,1246732,SATURDAY,1,0,21.7,57,16.6,1007.9,Fair
8/19/2023 3:00,17,20,150630,28575,37,179205,SATURDAY,1,0,21.7,57,24.1,1007.9,Fair
8/19/2023 4:00,8,13,17209,12673,21,29882,SATURDAY,1,0,20,55,22.3,1009.3,Fair
8/19/2023 5:00,7,21,10103,18430,28,28533,SATURDAY,1,0,18.9,59,20.5,1009.5,Fair
8/19/2023 6:00,22,70,40088,61747,92,101835,SATURDAY,1,0,17.8,65,20.5,1009.4,Fair
8/19/2023 7:00,57,125,117560,99116,182,216676,SATURDAY,1,0,17.2,67,16.6,1009.2,Clear
8/19/2023 8:00,120,259,192720,219983,379,412703,SATURDAY,1,0,17.2,67,16.6,1009.2,Clear
8/19/2023 9:00,211,369,5033311,366830,580,5400141,SATURDAY,1,0,16.1,72,14.8,1010.1,Fair
8/19/2023 10:00,332,494,2617537,439350,826,3056887,SATURDAY,1,0,16.7,75,11.2,1010.8,Fair
8/19/2023 11:00,451,555,1154500,506034,1006,1660534,SATURDAY,1,0,18.3,70,16.6,1011.7,Fair
8/19/2023 12:00,488,575,1211624,532209,1063,1743833,SATURDAY,1,0,20,65,18.4,1011.7,Fair
8/19/2023 13:00,522,637,7062354,602923,1159,7665277,SATURDAY,1,0,20,65,18.4,1011.7,Fair
8/19/2023 14:00,580,627,9461917,1689770,1207,11151687,SATURDAY,1,0,22.2,55,16.6,1012.6,Cloudy
8/19/2023 15:00,532,543,1728989,489638,1075,2218627,SATURDAY,1,0,22.2,53,18.4,1012.8,Cloudy
8/19/2023 16:00,545,542,2403038,508282,1087,2911320,SATURDAY,1,0,22.8,55,24.1,1012.1,Cloudy
8/19/2023 17:00,458,579,5293786,579434,1037,5873220,SATURDAY,1,0,22.8,55,24.1,1012.1,Cloudy
8/19/2023 18:00,468,599,6532904,876932,1067,7409836,SATURDAY,1,0,22.2,53,22.3,1012.4,Cloudy
8/19/2023 19:00,342,444,3798351,838223,786,4636574,SATURDAY,1,0,22.2,53,16.6,1012.5,Cloudy
8/19/2023 20:00,236,362,7130989,296283,598,7427272,SATURDAY,1,0,21.7,57,22.3,1012.4,Cloudy
8/19/2023 21:00,219,281,2578915,225512,500,2804427,SATURDAY,1,0,21.7,57,22.3,1012.4,Cloudy
8/19/2023 22:00,263,240,4294210,248600,503,4542810,SATURDAY,1,0,22.2,57,14.8,1012.4,Cloudy
8/19/2023 23:00,175,187,580473,190032,362,770505,SATURDAY,1,0,22.8,59,9.4,1013.1,Cloudy
8/20/2023 0:00,126,132,271161,105181,258,376342,SUNDAY,1,0,22.2,59,20.5,1013.8,Cloudy
8/20/2023 1:00,326,121,2657580,3205792,447,5863372,SUNDAY,1,0,22.2,59,11.2,1014.1,Cloudy
8/20/2023 2:00,188,64,2581317,74984,252,2656301,SUNDAY,1,0,21.1,61,18.4,1014.3,Cloudy
8/20/2023 3:00,23,24,1984168,18492,47,2002660,SUNDAY,1,0,21.1,61,18.4,1014.3,Cloudy
8/20/2023 4:00,13,14,535420,14829,27,550249,SUNDAY,1,0,18.9,73,18.4,1014.9,Fair
8/20/2023 5:00,12,26,24669,21466,38,46135,SUNDAY,1,0,19.4,68,20.5,1014.8,Fair
8/20/2023 6:00,15,64,28045,52807,79,80852,SUNDAY,1,0,19.4,66,18.4,1014.8,Fair
8/20/2023 7:00,43,98,198422,1698002,141,1896424,SUNDAY,1,0,20,61,22.3,1015.2,Fair
8/20/2023 8:00,80,195,626705,623119,275,1249824,SUNDAY,1,0,20,61,22.3,1015.2,Fair
8/20/2023 9:00,174,325,302566,295251,499,597817,SUNDAY,1,0,18.9,65,24.1,1016,Fair
8/20/2023 10:00,283,402,1988457,418057,685,2406514,SUNDAY,1,0,19.4,63,24.1,1016.4,Rain
8/20/2023 11:00,348,496,765610,2517346,844,3282956,SUNDAY,1,0,20,61,20.5,1017,Fair
8/20/2023 12:00,403,549,5712242,567299,952,6279541,SUNDAY,1,0,21.7,59,16.6,1017.1,Fair
8/20/2023 13:00,458,590,976631,543087,1048,1519718,SUNDAY,1,0,21.7,59,16.6,1017.1,Fair
8/20/2023 14:00,451,564,7090325,727919,1015,7818244,SUNDAY,1,0,24.4,52,14.8,1017.4,Fair
8/20/2023 15:00,462,576,1847456,557533,1038,2404989,SUNDAY,1,0,26.1,49,11.2,1017.4,Fair
8/20/2023 16:00,463,593,4304548,541581,1056,4846129,SUNDAY,1,0,26.7,49,16.6,1016.9,Fair
8/20/2023 17:00,485,621,18528492,801958,1106,19330450,SUNDAY,1,0,26.7,49,16.6,1016.9,Fair
8/20/2023 18:00,420,539,2900294,3533286,959,6433580,SUNDAY,1,0,28.3,40,16.6,1016.6,Fair
8/20/2023 19:00,327,481,4382837,422665,808,4805502,SUNDAY,1,0,28.3,41,13,1016.3,Rain
8/20/2023 20:00,187,376,7515493,395990,563,7911483,SUNDAY,1,0,28.3,43,18.4,1016.4,Fair
8/20/2023 21:00,152,263,224103,240233,415,464336,SUNDAY,1,0,27.2,47,22.3,1016.5,Fair
8/20/2023 22:00,121,181,192061,155631,302,347692,SUNDAY,1,0,27.2,47,22.3,1016.5,Fair
8/20/2023 23:00,49,78,105074,70813,127,175887,SUNDAY,1,0,26.1,52,14.8,1016.2,Cloudy
8/21/2023 0:00,41,47,97570,35449,88,133019,MONDAY,0,0,26.1,50,18.4,1016.5,Cloudy
8/21/2023 1:00,19,20,40311,21177,39,61488,MONDAY,0,0,23.9,62,13,1016.5,Cloudy
8/21/2023 2:00,7,5,17638,2313,12,19951,MONDAY,0,0,23.9,60,13,1017.2,Cloudy
8/21/2023 3:00,3,7,25842,7617,10,33459,MONDAY,0,0,23.9,60,13,1017.2,Fair
8/21/2023 4:00,3,14,3440,9069,17,12509,MONDAY,0,0,21.7,68,14.8,1016.4,Fair
8/21/2023 5:00,21,85,82380,66834,106,149214,MONDAY,0,0,21.1,71,13,1016.2,Fair
8/21/2023 6:00,44,253,5513306,184329,297,5697635,MONDAY,0,0,20.6,73,14.8,1015.8,Fair
8/21/2023 7:00,114,564,321156,423527,678,744683,MONDAY,0,0,21.1,73,16.6,1015.9,Fair
8/21/2023 8:00,185,985,446199,1540039,1170,1986238,MONDAY,0,0,21.1,73,16.6,1015.9,Fair
8/21/2023 9:00,158,581,216320,440359,739,656679,MONDAY,0,0,21.1,73,13,1016.2,Fair
8/21/2023 10:00,140,350,291853,290297,490,582150,MONDAY,0,0,22.2,68,13,1016.4,Fair
8/21/2023 11:00,221,359,496076,275927,580,772003,MONDAY,0,0,22.8,66,14.8,1016.4,Cloudy
8/21/2023 12:00,237,424,513044,321203,661,834247,MONDAY,0,0,22.8,66,14.8,1016.4,Cloudy
8/21/2023 13:00,238,370,828804,301585,608,1130389,MONDAY,0,0,24.4,62,14.8,1016.4,Cloudy
8/21/2023 14:00,272,384,4908607,298436,656,5207043,MONDAY,0,0,26.1,58,13,1016,Cloudy
8/21/2023 15:00,330,490,833814,758081,820,1591895,MONDAY,0,0,27.2,57,16.6,1016,Cloudy
8/21/2023 16:00,361,796,1281623,709890,1157,1991513,MONDAY,0,0,28.3,57,11.2,1015.3,Cloudy
8/21/2023 17:00,532,1272,5275449,1080017,1804,6355466,MONDAY,0,0,28.3,57,11.2,1015.3,Cloudy
8/21/2023 18:00,502,1017,3192400,1145778,1519,4338178,MONDAY,0,0,29.4,55,18.4,1014.7,Cloudy
8/21/2023 19:00,327,687,693207,564342,1014,1257549,MONDAY,0,0,29.4,53,18.4,1014.4,Cloudy
8/21/2023 20:00,47,155,138366,172706,202,311072,MONDAY,0,0,29.4,53,13,1014.5,Cloudy
8/21/2023 21:00,73,231,77180,237964,304,315144,MONDAY,0,0,28.9,51,11.2,1014.6,Cloudy
8/21/2023 22:00,63,126,1603646,145714,189,1749360,MONDAY,0,0,28.9,51,11.2,1014.6,Cloudy
8/21/2023 23:00,63,85,114051,74842,148,188893,MONDAY,0,0,25,71,7.6,1014.5,Cloudy
8/22/2023 0:00,23,32,620545,25144,55,645689,TUESDAY,0,0,23.3,88,7.6,1015.8,Cloudy
8/22/2023 1:00,27,14,108331,7641,41,115972,TUESDAY,0,0,21.7,96,9.4,1015.8,Cloudy
8/22/2023 2:00,6,7,14850,10681,13,25531,TUESDAY,0,0,22.2,87,13,1016,Cloudy
8/22/2023 3:00,5,12,33565,14752,17,48317,TUESDAY,0,0,22.2,87,13,1016,Cloudy
8/22/2023 4:00,5,18,4134,13114,23,17248,TUESDAY,0,0,20.6,68,20.5,1016.5,Cloudy
8/22/2023 5:00,17,86,12377,61577,103,73954,TUESDAY,0,0,20.6,68,20.5,1016.1,Cloudy
8/22/2023 6:00,52,290,50619,199179,342,249798,TUESDAY,0,0,20,65,20.5,1016.1,Rain
8/22/2023 7:00,123,684,111080,535327,807,646407,TUESDAY,0,0,20,65,20.5,1016.1,Cloudy
8/22/2023 8:00,210,1216,334416,1094130,1426,1428546,TUESDAY,0,0,18.3,65,22.3,1016.6,Cloudy
8/22/2023 9:00,133,644,210349,513821,777,724170,TUESDAY,0,0,17.8,68,20.5,1017.1,Cloudy
8/22/2023 10:00,118,356,3478499,318506,474,3797005,TUESDAY,0,0,17.8,68,16.6,1018,Cloudy
8/22/2023 11:00,146,395,239000,323250,541,562250,TUESDAY,0,0,18.3,65,22.3,1018.4,Cloudy
8/22/2023 12:00,175,492,287179,390098,667,677277,TUESDAY,0,0,18.3,65,22.3,1018.4,Cloudy
8/22/2023 13:00,210,424,546592,359570,634,906162,TUESDAY,0,0,21.1,55,14.8,1018.6,Fair
8/22/2023 14:00,257,433,512799,379110,690,891909,TUESDAY,0,0,22.8,46,14.8,1018.9,Fair
8/22/2023 15:00,222,527,3858627,448577,749,4307204,TUESDAY,0,0,23.3,46,18.4,1018.6,Fair
8/22/2023 16:00,317,953,454101,811078,1270,1265179,TUESDAY,0,0,22.8,50,16.6,1018,Rain
8/22/2023 17:00,464,1459,786213,1286167,1923,2072380,TUESDAY,0,0,22.8,50,16.6,1018,Fair
8/22/2023 18:00,442,1208,5154518,1047164,1650,6201682,TUESDAY,0,0,23.3,48,16.6,1017.2,Fair
8/22/2023 19:00,395,830,1312888,706942,1225,2019830,TUESDAY,0,0,22.2,57,14.8,1017.1,Rain
8/22/2023 20:00,213,564,928389,1725557,777,2653946,TUESDAY,0,0,22.2,51,13,1017,Fair
8/22/2023 21:00,204,433,376831,392146,637,768977,TUESDAY,0,0,22.2,51,13,1017,Fair
8/22/2023 22:00,128,246,240958,3619695,374,3860653,TUESDAY,0,0,21.7,55,7.6,1017,Fair
8/22/2023 23:00,57,118,3759306,88458,175,3847764,TUESDAY,0,0,20.6,57,0,1017.5,Fair
8/23/2023 0:00,22,46,18671,40713,68,59384,WEDNESDAY,0,0,20.6,59,9.4,1018.2,Fair
8/23/2023 1:00,26,29,31797,33295,55,65092,WEDNESDAY,0,0,22.2,48,9.4,1018.4,Fair
8/23/2023 2:00,8,11,15754,6715,19,22469,WEDNESDAY,0,0,22.2,48,20.5,1018.4,Fair
8/23/2023 3:00,1,6,1257,5710,7,6967,WEDNESDAY,0,0,20,51,18.4,1019.3,Fair
8/23/2023 4:00,6,18,26891,36057,24,62948,WEDNESDAY,0,0,18.9,54,18.4,1019.4,Fair
8/23/2023 5:00,21,85,32936,93264,106,126200,WEDNESDAY,0,0,17.8,58,13,1019.6,Fair
8/23/2023 6:00,57,261,56078,1555822,318,1611900,WEDNESDAY,0,0,17.2,60,14.8,1019.7,Fair
8/23/2023 7:00,111,666,123138,556710,777,679848,WEDNESDAY,0,0,17.2,60,14.8,1019.7,Fair
8/23/2023 8:00,195,1235,207346,967960,1430,1175306,WEDNESDAY,0,0,16.7,62,13,1020,Fair
8/23/2023 9:00,133,691,232075,556105,824,788180,WEDNESDAY,0,0,16.7,65,13,1020.4,Fair
8/23/2023 10:00,147,388,1735224,334662,535,2069886,WEDNESDAY,0,0,17.2,60,11.2,1020.8,Rain
8/23/2023 11:00,173,381,298560,342164,554,640724,WEDNESDAY,0,0,18.3,58,13,1021.2,Fair
8/23/2023 12:00,218,501,2109860,934314,719,3044174,WEDNESDAY,0,0,18.3,58,13,1021.2,Fair
8/23/2023 13:00,208,439,1369953,335281,647,1705234,WEDNESDAY,0,0,21.1,53,7.6,1021.1,Fair
8/23/2023 14:00,197,404,430468,357277,601,787745,WEDNESDAY,0,0,21.7,53,9.4,1020.8,Fair
8/23/2023 15:00,238,553,1457907,452625,791,1910532,WEDNESDAY,0,0,21.1,53,16.6,1020.4,Fair
8/23/2023 16:00,317,961,487966,1334142,1278,1822108,WEDNESDAY,0,0,20.6,61,16.6,1019.9,Fair
8/23/2023 17:00,474,1483,1029699,1318660,1957,2348359,WEDNESDAY,0,0,21.7,51,13,1019.4,Fair
8/23/2023 18:00,489,1189,724508,5373168,1678,6097676,WEDNESDAY,0,0,21.7,51,13,1019.4,Fair
8/23/2023 19:00,344,810,621556,720480,1154,1342036,WEDNESDAY,0,0,21.7,49,13,1019,Rain
8/23/2023 20:00,258,572,662886,774629,830,1437515,WEDNESDAY,0,0,21.1,61,20.5,1018.5,Fair
8/23/2023 21:00,178,407,454218,342606,585,796824,WEDNESDAY,0,0,21.1,61,20.5,1018.5,Fair
8/23/2023 22:00,125,223,2642060,222551,348,2864611,WEDNESDAY,0,0,20,68,9.4,1018.3,Fair
8/23/2023 23:00,67,137,763541,135738,204,899279,WEDNESDAY,0,0,20,68,9.4,1018.3,Fair
8/24/2023 0:00,38,56,109833,41006,94,150839,THURSDAY,0,0,19.4,66,14.8,1018.8,Fair
8/24/2023 1:00,14,25,15561,15395,39,30956,THURSDAY,0,0,18.9,68,14.8,1018.9,Fair
8/24/2023 2:00,11,13,10741,11019,24,21760,THURSDAY,0,0,18.9,68,14.8,1018.9,Fair
8/24/2023 3:00,3,8,5859,6618,11,12477,THURSDAY,0,0,18.3,70,9.4,1018.9,Fair
8/24/2023 4:00,4,15,5274,11653,19,16927,THURSDAY,0,0,18.3,70,9.4,1018.7,Fair
8/24/2023 5:00,25,82,21634,53117,107,74751,THURSDAY,0,0,17.8,75,11.2,1018.5,Fair
8/24/2023 6:00,52,259,93756,206595,311,300351,THURSDAY,0,0,16.7,80,16.6,1018.1,Clear
8/24/2023 7:00,106,628,89509,2224040,734,2313549,THURSDAY,0,0,16.7,80,16.6,1018.1,Clear
8/24/2023 8:00,188,1172,173094,1509798,1360,1682892,THURSDAY,0,0,16.1,81,11.2,1018.5,Clear
8/24/2023 9:00,147,670,2494175,503664,817,2997839,THURSDAY,0,0,15.6,83,9.4,1018.8,Clear
8/24/2023 10:00,158,345,310478,269685,503,580163,THURSDAY,0,0,15.6,83,9.4,1018.8,Rain
8/24/2023 11:00,179,393,379180,1015343,572,1394523,THURSDAY,0,0,18.3,78,7.6,1019.1,Fair
8/24/2023 12:00,220,516,2611211,376292,736,2987503,THURSDAY,0,0,18.3,78,7.6,1019.1,Fair
8/24/2023 13:00,229,432,493378,654237,661,1147615,THURSDAY,0,0,22.8,59,9.4,1019.8,Fair
8/24/2023 14:00,261,442,1102184,351432,703,1453616,THURSDAY,0,0,22.8,61,11.2,1019.5,Fair
8/24/2023 15:00,286,607,455469,1143185,893,1598654,THURSDAY,0,0,23.9,55,11.2,1019.2,Fair
8/24/2023 16:00,328,914,467167,3310274,1242,3777441,THURSDAY,0,0,23.9,55,11.2,1019.2,Fair
8/24/2023 17:00,509,1331,973241,1136595,1840,2109836,THURSDAY,0,0,23.3,62,18.4,1019,Fair
8/24/2023 18:00,416,1141,2387033,925288,1557,3312321,THURSDAY,0,0,23.9,60,22.3,1018.2,Cloudy
8/24/2023 19:00,267,808,2380639,864586,1075,3245225,THURSDAY,0,0,25,45,18.4,1017.6,Cloudy
8/24/2023 20:00,183,515,2632929,471929,698,3104858,THURSDAY,0,0,25,45,18.4,1017.6,Cloudy
8/24/2023 21:00,125,327,167308,257703,452,425011,THURSDAY,0,0,23.9,54,24.1,1017.8,Cloudy
8/24/2023 22:00,90,191,229138,192162,281,421300,THURSDAY,0,0,21.1,61,22.3,1018.3,Cloudy
8/24/2023 23:00,29,109,25970,122235,138,148205,THURSDAY,0,0,20.6,66,14.8,1018.5,Cloudy
8/25/2023 0:00,21,43,67259,26717,64,93976,FRIDAY,0,0,20,68,18.4,1018.7,Cloudy
8/25/2023 1:00,20,13,21655,12173,33,33828,FRIDAY,0,0,19.4,68,22.3,1018.5,Cloudy
8/25/2023 2:00,2,6,1622,3392,8,5014,FRIDAY,0,0,19.4,68,22.3,1018.5,Cloudy
8/25/2023 3:00,3,1,6629,397,4,7026,FRIDAY,0,0,18.9,78,13,1017.4,Cloudy
8/25/2023 4:00,3,3,3439,3326,6,6765,FRIDAY,0,0,18.9,78,13,1017.4,Rain
8/25/2023 5:00,4,22,1990,13120,26,15110,FRIDAY,0,0,17.2,90,13,1017.3,Rain
8/25/2023 6:00,13,55,14677,82560,68,97237,FRIDAY,0,0,17.2,90,13,1017.3,Rain
8/25/2023 7:00,8,97,6546,64413,105,70959,FRIDAY,0,0,16.7,86,27.7,1016.7,Rain
8/25/2023 8:00,13,132,9364,86379,145,95743,FRIDAY,0,0,16.7,93,24.1,1015.3,Rain
8/25/2023 9:00,7,80,36880,60679,87,97559,FRIDAY,0,0,16.7,93,22.3,1015,Rain
8/25/2023 10:00,23,86,37280,53926,109,91206,FRIDAY,0,0,17.2,97,25.9,1014.7,Rain
8/25/2023 11:00,32,168,311191,113735,200,424926,FRIDAY,0,0,17.2,97,25.9,1014.7,Rain
8/25/2023 12:00,86,294,138400,211506,380,349906,FRIDAY,0,0,18.9,93,24.1,1013.9,Rain
8/25/2023 13:00,125,336,228577,223071,461,451648,FRIDAY,0,0,18.9,93,22.3,1013.6,Rain
8/25/2023 14:00,85,239,295640,175574,324,471214,FRIDAY,0,0,19.4,93,22.3,1013.2,Rain
8/25/2023 15:00,78,284,98208,188930,362,287138,FRIDAY,0,0,20.6,90,20.5,1013,Rain
8/25/2023 16:00,146,446,3820421,326805,592,4147226,FRIDAY,0,0,20.6,90,20.5,1013,Rain
8/25/2023 17:00,228,740,1449446,922853,968,2372299,FRIDAY,0,0,21.7,87,22.3,1012.1,Rain
8/25/2023 18:00,248,625,680661,658637,873,1339298,FRIDAY,0,0,21.7,87,33.5,1011.7,Rain
8/25/2023 19:00,175,494,418656,967311,669,1385967,FRIDAY,0,0,21.1,93,24.1,1011.2,Rain
8/25/2023 20:00,142,376,6188401,355018,518,6543419,FRIDAY,0,0,21.7,90,22.3,1011,Rain
8/25/2023 21:00,120,240,385944,240759,360,626703,FRIDAY,0,0,21.7,90,22.3,1011,Rain
8/25/2023 22:00,201,201,1242583,184864,402,1427447,FRIDAY,0,0,22.2,87,20.5,1010.8,Rain
8/25/2023 23:00,135,187,369385,160973,322,530358,FRIDAY,0,0,21.7,90,22.3,1011.1,Cloudy
8/26/2023 0:00,120,147,176457,130135,267,306592,SATURDAY,1,0,21.7,90,22.3,1011.1,Rain
8/26/2023 1:00,125,98,337501,96001,223,433502,SATURDAY,1,0,21.7,90,20.5,1011.2,Rain
8/26/2023 2:00,94,67,530902,74761,161,605663,SATURDAY,1,0,21.7,90,16.6,1011,Cloudy
8/26/2023 3:00,20,13,18007,15601,33,33608,SATURDAY,1,0,21.7,90,18.4,1010.4,Cloudy
8/26/2023 4:00,7,10,31101,8725,17,39826,SATURDAY,1,0,21.7,94,14.8,1010.1,Cloudy
8/26/2023 5:00,19,23,18457,19849,42,38306,SATURDAY,1,0,21.7,94,14.8,1010.1,Cloudy
8/26/2023 6:00,17,49,52053,41770,66,93823,SATURDAY,1,0,21.7,94,14.8,1009.6,Cloudy
8/26/2023 7:00,61,105,1309242,79905,166,1389147,SATURDAY,1,0,21.7,94,11.2,1008.7,Cloudy
8/26/2023 8:00,69,210,222791,184687,279,407478,SATURDAY,1,0,21.7,94,11.2,1008.7,Cloudy
8/26/2023 9:00,178,411,358129,324866,589,682995,SATURDAY,1,0,21.7,96,5.4,1008.7,Cloudy
8/26/2023 10:00,265,465,1573218,439057,730,2012275,SATURDAY,1,0,21.7,96,5.4,1008.7,Cloudy
8/26/2023 11:00,413,588,2594090,496224,1001,3090314,SATURDAY,1,0,22.2,94,16.6,1008.9,Cloudy
8/26/2023 12:00,445,659,1243941,620139,1104,1864080,SATURDAY,1,0,23.9,82,14.8,1009.3,Cloudy
8/26/2023 13:00,473,631,2674808,637967,1104,3312775,SATURDAY,1,0,24.4,74,16.6,1009.9,Cloudy
8/26/2023 14:00,537,595,4571157,583672,1132,5154829,SATURDAY,1,0,23.9,74,13,1010.1,Cloudy
8/26/2023 15:00,535,627,3143203,622092,1162,3765295,SATURDAY,1,0,26.1,62,9.4,1009.8,Cloudy
8/26/2023 16:00,531,641,2018856,4557196,1172,6576052,SATURDAY,1,0,26.1,62,9.4,1009.8,Cloudy
8/26/2023 17:00,450,573,6850975,729668,1023,7580643,SATURDAY,1,0,27.8,55,14.8,1009.2,Cloudy
8/26/2023 18:00,523,683,2361585,738796,1206,3100381,SATURDAY,1,0,28.3,53,13,1008.7,Cloudy
8/26/2023 19:00,535,594,7566639,541694,1129,8108333,SATURDAY,1,0,28.3,48,16.6,1008.5,Cloudy
8/26/2023 20:00,309,435,1052194,385299,744,1437493,SATURDAY,1,0,25.6,64,13,1008.6,Cloudy
8/26/2023 21:00,239,317,3057531,302947,556,3360478,SATURDAY,1,0,25.6,64,13,1008.6,Cloudy
8/26/2023 22:00,232,253,9487719,213834,485,9701553,SATURDAY,1,0,24.4,71,9.4,1009.5,Cloudy
8/26/2023 23:00,194,194,349459,193027,388,542486,SATURDAY,1,0,24.4,71,9.4,1010,Cloudy
8/27/2023 0:00,174,153,1920016,187393,327,2107409,SUNDAY,1,0,21.7,81,9.4,1010.3,Cloudy
8/27/2023 1:00,158,100,943384,98567,258,1041951,SUNDAY,1,0,21.7,81,9.4,1010.3,Fair
8/27/2023 2:00,79,61,129277,56490,140,185767,SUNDAY,1,0,21.1,84,0,1010.4,Fair
8/27/2023 3:00,13,13,3098309,12135,26,3110444,SUNDAY,1,0,21.7,84,11.2,1010.5,Fair
8/27/2023 4:00,5,24,6352,19886,29,26238,SUNDAY,1,0,22.2,82,7.6,1010.5,Fair
8/27/2023 5:00,18,34,48170,36943,52,85113,SUNDAY,1,0,21.7,79,9.4,1010.4,Fair
8/27/2023 6:00,14,50,38564,38856,64,77420,SUNDAY,1,0,21.7,79,9.4,1010.4,Fair
8/27/2023 7:00,33,99,1727982,87227,132,1815209,SUNDAY,1,0,21.1,82,13,1010.4,Fair
8/27/2023 8:00,93,200,177816,169473,293,347289,SUNDAY,1,0,20,87,7.6,1011.3,Fair
8/27/2023 9:00,146,364,267151,362995,510,630146,SUNDAY,1,0,19.4,87,14.8,1011.6,Fair
8/27/2023 10:00,310,456,4886318,403512,766,5289830,SUNDAY,1,0,20,84,9.4,1012.5,Fair
8/27/2023 11:00,344,531,726946,499036,875,1225982,SUNDAY,1,0,20,84,9.4,1012.5,Fair
8/27/2023 12:00,422,563,2827771,839233,985,3667004,SUNDAY,1,0,20.6,78,14.8,1013.5,Fair
8/27/2023 13:00,442,605,1260413,558283,1047,1818696,SUNDAY,1,0,21.7,76,16.6,1013.9,Cloudy
8/27/2023 14:00,425,611,1041449,593576,1036,1635025,SUNDAY,1,0,21.7,76,11.2,1014,Cloudy
8/27/2023 15:00,473,595,1452974,588256,1068,2041230,SUNDAY,1,0,21.7,76,18.4,1014.3,Cloudy
8/27/2023 16:00,497,646,7841357,625358,1143,8466715,SUNDAY,1,0,21.7,76,18.4,1014.3,Cloudy
8/27/2023 17:00,522,713,7223626,2023400,1235,9247026,SUNDAY,1,0,21.7,76,18.4,1014.3,Cloudy
8/27/2023 18:00,448,657,6002853,2103718,1105,8106571,SUNDAY,1,0,20.6,81,22.3,1014.1,Cloudy
8/27/2023 19:00,407,550,6973161,547632,957,7520793,SUNDAY,1,0,21.1,78,22.3,1014,Cloudy
8/27/2023 20:00,193,367,2288888,358201,560,2647089,SUNDAY,1,0,21.1,78,22.3,1014,Cloudy
8/27/2023 21:00,164,299,276819,230355,463,507174,SUNDAY,1,0,19.4,81,11.2,1014.6,Cloudy
8/27/2023 22:00,104,157,783508,127523,261,911031,SUNDAY,1,0,18.9,84,11.2,1014.8,Cloudy
8/27/2023 23:00,61,107,89215,88545,168,177760,SUNDAY,1,0,18.3,90,9.4,1015.3,Cloudy
8/28/2023 0:00,34,63,4376728,45131,97,4421859,MONDAY,0,0,18.3,87,5.4,1015.8,Cloudy
8/28/2023 1:00,21,28,3855153,19374,49,3874527,MONDAY,0,0,18.3,87,5.4,1015.8,Fair
8/28/2023 2:00,18,28,525120,16727,46,541847,MONDAY,0,0,18.3,90,0,1016.5,Fair
8/28/2023 3:00,2,8,597664,7495,10,605159,MONDAY,0,0,18.3,90,0,1016.8,Fair
8/28/2023 4:00,2,18,1657,17896,20,19553,MONDAY,0,0,17.8,93,0,1016.9,Fair
8/28/2023 5:00,21,84,31430,70393,105,101823,MONDAY,0,0,17.8,93,0,1016.9,Fair
8/28/2023 6:00,44,255,45525,212887,299,258412,MONDAY,0,0,17.8,93,5.4,1016.9,Fair
8/28/2023 7:00,99,598,116924,500570,697,617494,MONDAY,0,0,17.8,90,0,1017.1,Cloudy
8/28/2023 8:00,209,1027,233343,795936,1236,1029279,MONDAY,0,0,17.2,90,5.4,1017.4,Cloudy
8/28/2023 9:00,152,609,245080,450429,761,695509,MONDAY,0,0,17.2,90,5.4,1017.4,Cloudy
8/28/2023 10:00,164,349,344573,2089211,513,2433784,MONDAY,0,0,17.2,90,11.2,1017.9,Rain
8/28/2023 11:00,194,347,368067,272176,541,640243,MONDAY,0,0,17.2,93,0,1018.9,Cloudy
8/28/2023 12:00,222,460,593860,377714,682,971574,MONDAY,0,0,17.2,93,9.4,1019.1,Cloudy
8/28/2023 13:00,264,455,2060345,333544,719,2393889,MONDAY,0,0,18.3,84,13,1019.4,Cloudy
8/28/2023 14:00,251,430,1104482,342779,681,1447261,MONDAY,0,0,18.9,84,11.2,1019.3,Cloudy
8/28/2023 15:00,353,567,645671,474927,920,1120598,MONDAY,0,0,18.9,84,11.2,1019.3,Cloudy
8/28/2023 16:00,412,932,2177517,770662,1344,2948179,MONDAY,0,0,21.1,78,20.5,1019,Cloudy
8/28/2023 17:00,546,1358,2959906,1191168,1904,4151074,MONDAY,0,0,21.1,78,14.8,1018.7,Cloudy
8/28/2023 18:00,505,1152,5961424,3606055,1657,9567479,MONDAY,0,0,21.1,78,20.5,1018.5,Cloudy
8/28/2023 19:00,456,796,6940853,765095,1252,7705948,MONDAY,0,0,21.1,82,16.6,1018.3,Cloudy
8/28/2023 20:00,243,471,369116,381477,714,750593,MONDAY,0,0,21.1,82,16.6,1018.3,Cloudy
8/28/2023 21:00,189,346,385832,328253,535,714085,MONDAY,0,0,20,84,24.1,1018,Cloudy
8/28/2023 22:00,211,268,1582585,255919,479,1838504,MONDAY,0,0,20,84,14.8,1017.9,Cloudy
8/28/2023 23:00,70,111,203784,91203,181,294987,MONDAY,0,0,19.4,84,16.6,1017.9,Cloudy
8/29/2023 0:00,39,49,111905,37334,88,149239,TUESDAY,0,0,18.9,87,9.4,1018.4,Cloudy
8/29/2023 1:00,13,28,12277,26034,41,38311,TUESDAY,0,0,18.9,87,9.4,1018.4,Cloudy
8/29/2023 2:00,7,9,6187,8580,16,14767,TUESDAY,0,0,18.9,87,11.2,1018.4,Cloudy
8/29/2023 3:00,3,9,6549,3157,12,9706,TUESDAY,0,0,19.4,84,0,1018.5,Cloudy
8/29/2023 4:00,8,13,6925,11505,21,18430,TUESDAY,0,0,18.9,87,7.6,1018.4,Cloudy
8/29/2023 5:00,18,102,9062,79746,120,88808,TUESDAY,0,0,18.3,90,9.4,1018.1,Cloudy
8/29/2023 6:00,51,290,47286,210768,341,258054,TUESDAY,0,0,18.3,90,9.4,1018.1,Cloudy
8/29/2023 7:00,111,777,103300,604326,888,707626,TUESDAY,0,0,18.3,93,5.4,1016.9,Cloudy
8/29/2023 8:00,167,1180,309606,1074518,1347,1384124,TUESDAY,0,0,17.8,93,5.4,1016.6,Cloudy
8/29/2023 9:00,124,633,211800,645255,757,857055,TUESDAY,0,0,17.8,93,5.4,1016.6,Cloudy
8/29/2023 10:00,145,385,620991,345157,530,966148,TUESDAY,0,0,17.8,96,9.4,1016.4,Cloudy
8/29/2023 11:00,155,419,1362485,353182,574,1715667,TUESDAY,0,0,18.3,97,9.4,1016.6,Cloudy
8/29/2023 12:00,162,525,614153,506547,687,1120700,TUESDAY,0,0,20,90,7.6,1017,Cloudy
8/29/2023 13:00,203,444,399123,340283,647,739406,TUESDAY,0,0,20,90,7.6,1017,Cloudy
8/29/2023 14:00,219,537,425890,412200,756,838090,TUESDAY,0,0,20,90,9.4,1016.7,Cloudy
8/29/2023 15:00,251,652,445607,783017,903,1228624,TUESDAY,0,0,20,90,9.4,1016.7,Cloudy
8/29/2023 16:00,319,970,937191,896985,1289,1834176,TUESDAY,0,0,20,93,11.2,1015.8,Cloudy
8/29/2023 17:00,444,1403,614297,1789546,1847,2403843,TUESDAY,0,0,20,93,11.2,1015.8,Cloudy
8/29/2023 18:00,365,1121,5584890,1345382,1486,6930272,TUESDAY,0,0,21.7,90,13,1015.3,Cloudy
8/29/2023 19:00,231,770,405663,636098,1001,1041761,TUESDAY,0,0,21.7,87,20.5,1014.3,Cloudy
8/29/2023 20:00,153,460,244412,529380,613,773792,TUESDAY,0,0,21.1,90,22.3,1013.9,Cloudy
8/29/2023 21:00,136,354,174508,698993,490,873501,TUESDAY,0,0,19.4,97,13,1013,Cloudy
8/29/2023 22:00,103,166,174849,167945,269,342794,TUESDAY,0,0,19.4,97,13,1012.6,Cloudy
8/29/2023 23:00,18,76,14588,51091,94,65679,TUESDAY,0,0,19.4,97,13,1012.6,Cloudy
8/30/2023 0:00,27,39,265889,32935,66,298824,WEDNESDAY,0,0,19.4,100,11.2,1012.4,Cloudy
8/30/2023 1:00,2,6,2069,7326,8,9395,WEDNESDAY,0,0,19.4,100,5.4,1011.7,Cloudy
8/30/2023 2:00,0,4,0,2429,4,2429,WEDNESDAY,0,0,19.4,100,5.4,1011.3,Rain
8/30/2023 3:00,1,3,300,1581,4,1881,WEDNESDAY,0,0,20,100,0,1010.6,Rain
8/30/2023 4:00,1,12,349,9194,13,9543,WEDNESDAY,0,0,20,100,0,1010.6,Rain
8/30/2023 5:00,6,72,3158,61231,78,64389,WEDNESDAY,0,0,20,96,7.6,1009.9,Rain
8/30/2023 6:00,35,222,43781,157586,257,201367,WEDNESDAY,0,0,20,100,5.4,1008.4,Rain
8/30/2023 7:00,54,435,44784,331908,489,376692,WEDNESDAY,0,0,20,100,0,1007.7,Cloudy
8/30/2023 8:00,70,532,55423,401458,602,456881,WEDNESDAY,0,0,20,100,5.4,1007.2,Rain
8/30/2023 9:00,26,265,24269,205100,291,229369,WEDNESDAY,0,0,19.4,100,5.4,1006.7,Cloudy
8/30/2023 10:00,60,333,55043,241923,393,296966,WEDNESDAY,0,0,19.4,100,5.4,1006.7,Cloudy
8/30/2023 11:00,91,355,1009800,274271,446,1284071,WEDNESDAY,0,0,20,96,5.4,1006,Rain
8/30/2023 12:00,98,391,167089,296445,489,463534,WEDNESDAY,0,0,19.4,100,9.4,1005.3,Rain
8/30/2023 13:00,98,314,4317279,196691,412,4513970,WEDNESDAY,0,0,19.4,100,9.4,1005.3,Rain
8/30/2023 14:00,118,424,952022,332228,542,1284250,WEDNESDAY,0,0,21.7,100,0,1004.8,Cloudy
8/30/2023 15:00,234,631,1821377,560922,865,2382299,WEDNESDAY,0,0,25,85,20.5,1004.3,Rain
8/30/2023 16:00,265,906,1231786,755626,1171,1987412,WEDNESDAY,0,0,25,85,16.6,1003,Rain
8/30/2023 17:00,426,1320,1634824,3875668,1746,5510492,WEDNESDAY,0,0,25,85,16.6,1003,Rain
8/30/2023 18:00,355,1075,935905,1354966,1430,2290871,WEDNESDAY,0,0,25.6,85,14.8,1002.8,Cloudy
8/30/2023 19:00,335,782,2129438,724818,1117,2854256,WEDNESDAY,0,0,26.1,74,14.8,1002.5,Cloudy
8/30/2023 20:00,163,507,236953,3933190,670,4170143,WEDNESDAY,0,0,27.2,69,9.4,1001.9,Cloudy
8/30/2023 21:00,153,410,225714,389665,563,615379,WEDNESDAY,0,0,27.2,69,9.4,1002.3,Cloudy
8/30/2023 22:00,90,198,104500,159603,288,264103,WEDNESDAY,0,0,25.6,52,16.6,1003,Cloudy
8/30/2023 23:00,63,131,131258,136323,194,267581,WEDNESDAY,0,0,23.9,58,20.5,1003.7,Cloudy
8/31/2023 0:00,43,65,554166,45921,108,600087,THURSDAY,0,0,23.9,58,20.5,1003.7,Cloudy
8/31/2023 1:00,19,32,51727,21983,51,73710,THURSDAY,0,0,22.2,61,18.4,1005,Cloudy
8/31/2023 2:00,5,9,5868,7196,14,13064,THURSDAY,0,0,21.1,66,22.3,1005.4,Cloudy
8/31/2023 3:00,7,7,45802,4979,14,50781,THURSDAY,0,0,20.6,70,16.6,1005.7,Fair
8/31/2023 4:00,8,18,88267,15839,26,104106,THURSDAY,0,0,20,73,22.3,1006.4,Fair
8/31/2023 5:00,24,66,33447,48909,90,82356,THURSDAY,0,0,20,73,22.3,1006.4,Fair
8/31/2023 6:00,41,273,35237,188570,314,223807,THURSDAY,0,0,18.9,75,14.8,1007.3,Fair
8/31/2023 7:00,133,644,188956,514035,777,702991,THURSDAY,0,0,18.9,73,16.6,1007.9,Fair
8/31/2023 8:00,215,1083,378745,1254665,1298,1633410,THURSDAY,0,0,18.3,73,24.1,1008.3,Fair
8/31/2023 9:00,169,664,257312,621869,833,879181,THURSDAY,0,0,18.3,73,24.1,1008.3,Fair
8/31/2023 10:00,138,426,250969,370710,564,621679,THURSDAY,0,0,17.8,65,24.1,1010.5,Rain
8/31/2023 11:00,174,429,418934,355755,603,774689,THURSDAY,0,0,17.8,60,22.3,1011.4,Fair
8/31/2023 12:00,200,487,338874,372090,687,710964,THURSDAY,0,0,18.3,56,22.3,1012.1,Fair
8/31/2023 13:00,238,525,6484732,407238,763,6891970,THURSDAY,0,0,19.4,51,22.3,1012.7,Fair
8/31/2023 14:00,251,490,1191896,1260533,741,2452429,THURSDAY,0,0,19.4,51,22.3,1012.7,Fair
8/31/2023 15:00,306,651,659923,618774,957,1278697,THURSDAY,0,0,21.1,42,16.6,1013.8,Fair
8/31/2023 16:00,384,1050,625315,964072,1434,1589387,THURSDAY,0,0,22.8,41,18.4,1013.7,Rain
8/31/2023 17:00,506,1350,2738342,1204131,1856,3942473,THURSDAY,0,0,22.8,38,14.8,1014,Fair
8/31/2023 18:00,426,1016,1301542,888034,1442,2189576,THURSDAY,0,0,20,61,14.8,1013.9,Fair
8/31/2023 19:00,281,830,789947,735195,1111,1525142,THURSDAY,0,0,20,61,22.3,1013.9,Rain
8/31/2023 20:00,198,478,1392921,428897,676,1821818,THURSDAY,0,0,19.4,59,18.4,1014.7,Cloudy
8/31/2023 21:00,153,355,815633,493128,508,1308761,THURSDAY,0,0,18.9,59,14.8,1015.2,Cloudy
8/31/2023 22:00,107,216,1276645,219241,323,1495886,THURSDAY,0,0,18.3,61,5.4,1015.7,Fair
8/31/2023 23:00,55,132,60169,106451,187,166620,THURSDAY,0,0,17.8,58,5.4,1016.7,Fair
9/1/2023 0:00,44,87,82450,67541,131,149991,FRIDAY,0,0,17.8,58,5.4,1016.7,Fair
9/1/2023 1:00,24,33,27630,31089,57,58719,FRIDAY,0,0,18.3,52,13,1018.6,Fair
9/1/2023 2:00,8,21,25105,15009,29,40114,FRIDAY,0,0,17.8,54,20.5,1019.4,Fair
9/1/2023 3:00,7,8,9673,4277,15,13950,FRIDAY,0,0,16.7,60,20.5,1020.4,Fair
9/1/2023 4:00,10,15,14400,11858,25,26258,FRIDAY,0,0,16.1,62,14.8,1021,Fair
9/1/2023 5:00,18,65,12127,45513,83,57640,FRIDAY,0,0,16.1,62,14.8,1021,Fair
9/1/2023 6:00,44,185,52629,147151,229,199780,FRIDAY,0,0,15,64,16.6,1021.7,Clear
9/1/2023 7:00,69,424,87458,338178,493,425636,FRIDAY,0,0,14.4,67,13,1022.1,Clear
9/1/2023 8:00,144,760,3685186,639372,904,4324558,FRIDAY,0,0,14.4,67,16.6,1022.4,Clear
9/1/2023 9:00,144,596,211192,2839674,740,3050866,FRIDAY,0,0,14.4,67,18.4,1023.1,Clear
9/1/2023 10:00,187,457,1212593,374204,644,1586797,FRIDAY,0,0,14.4,67,18.4,1023.1,Rain
9/1/2023 11:00,263,461,1385675,378711,724,1764386,FRIDAY,0,0,16.7,60,16.6,1023.9,Fair
9/1/2023 12:00,317,626,544318,487673,943,1031991,FRIDAY,0,0,18.3,56,16.6,1024.6,Fair
9/1/2023 13:00,294,587,993709,508046,881,1501755,FRIDAY,0,0,19.4,52,14.8,1025.3,Fair
9/1/2023 14:00,308,616,2785033,518146,924,3303179,FRIDAY,0,0,19.4,52,14.8,1025.3,Fair
9/1/2023 15:00,386,667,3757150,539808,1053,4296958,FRIDAY,0,0,20.6,51,11.2,1025.8,Fair
9/1/2023 16:00,428,820,2174732,1053531,1248,3228263,FRIDAY,0,0,20,59,13,1025.7,Fair
9/1/2023 17:00,414,919,1168468,888107,1333,2056575,FRIDAY,0,0,20,61,14.8,1025.5,Fair
9/1/2023 18:00,400,853,966580,784316,1253,1750896,FRIDAY,0,0,20.6,55,18.4,1025,Fair
9/1/2023 19:00,336,609,2374524,527850,945,2902374,FRIDAY,0,0,20.6,55,18.4,1025,Fair
9/1/2023 20:00,242,466,420743,493081,708,913824,FRIDAY,0,0,20.6,53,14.8,1024.2,Fair
9/1/2023 21:00,203,371,4382175,365236,574,4747411,FRIDAY,0,0,20,53,11.2,1023.8,Fair
9/1/2023 22:00,131,248,244263,1172851,379,1417114,FRIDAY,0,0,19.4,52,11.2,1024,Fair
9/1/2023 23:00,137,180,350677,139489,317,490166,FRIDAY,0,0,18.3,61,11.2,1024.1,Fair
9/2/2023 0:00,80,129,265517,128843,209,394360,SATURDAY,1,0,18.3,61,11.2,1024.1,Fair
9/2/2023 1:00,83,68,215615,58095,151,273710,SATURDAY,1,0,16.7,62,13,1024.4,Fair
9/2/2023 2:00,46,37,4216200,27512,83,4243712,SATURDAY,1,0,17.8,65,18.4,1024.3,Fair
9/2/2023 3:00,17,18,513570,16764,35,530334,SATURDAY,1,0,17.2,67,18.4,1024.1,Clear
9/2/2023 4:00,16,10,74915,30143,26,105058,SATURDAY,1,0,17.2,67,14.8,1024,Clear
9/2/2023 5:00,12,27,12668,26251,39,38919,SATURDAY,1,0,16.7,70,16.6,1023.5,Clear
9/2/2023 6:00,21,75,46155,53639,96,99794,SATURDAY,1,0,16.7,70,16.6,1023.5,Clear
9/2/2023 7:00,51,138,69170,127023,189,196193,SATURDAY,1,0,15.6,78,14.8,1022.9,Clear
9/2/2023 8:00,94,268,146252,204545,362,350797,SATURDAY,1,0,15.6,78,11.2,1022.8,Clear
9/2/2023 9:00,219,392,1239865,336531,611,1576396,SATURDAY,1,0,15.6,78,11.2,1022.8,Clear
9/2/2023 10:00,300,450,563353,397216,750,960569,SATURDAY,1,0,15,83,14.8,1023.1,Rain
9/2/2023 11:00,368,526,733221,464568,894,1197789,SATURDAY,1,0,15,83,14.8,1023.1,Fair
9/2/2023 12:00,445,579,951921,522008,1024,1473929,SATURDAY,1,0,19.4,68,13,1022.2,Fair
9/2/2023 13:00,467,529,3984046,545228,996,4529274,SATURDAY,1,0,22.2,57,14.8,1022,Fair
9/2/2023 14:00,515,593,2309150,535135,1108,2844285,SATURDAY,1,0,22.2,57,14.8,1022,Fair
9/2/2023 15:00,518,574,1300900,1105550,1092,2406450,SATURDAY,1,0,24.4,54,22.3,1020.4,Fair
9/2/2023 16:00,497,565,1898640,888272,1062,2786912,SATURDAY,1,0,25.6,50,18.4,1019.5,Fair
9/2/2023 17:00,463,657,3038022,623449,1120,3661471,SATURDAY,1,0,25.6,52,20.5,1018.6,Cloudy
9/2/2023 18:00,435,619,5164740,638383,1054,5803123,SATURDAY,1,0,26.1,49,20.5,1017.8,Cloudy
9/2/2023 19:00,347,527,1875035,529104,874,2404139,SATURDAY,1,0,26.1,50,20.5,1017.2,Rain
9/2/2023 20:00,239,372,434883,791606,611,1226489,SATURDAY,1,0,26.1,50,20.5,1017.2,Cloudy
9/2/2023 21:00,193,308,503728,220124,501,723852,SATURDAY,1,0,23.9,62,22.3,1016.7,Cloudy
9/2/2023 22:00,180,234,2852188,210963,414,3063151,SATURDAY,1,0,21.7,68,24.1,1016.1,Cloudy
9/2/2023 23:00,177,164,598909,193281,341,792190,SATURDAY,1,0,20,73,20.5,1016.5,Cloudy
9/3/2023 0:00,150,174,258521,199283,324,457804,SUNDAY,1,0,20,73,20.5,1016.5,Cloudy
9/3/2023 1:00,147,98,737553,96509,245,834062,SUNDAY,1,0,19.4,76,18.4,1016.4,Cloudy
9/3/2023 2:00,75,36,2364280,32890,111,2397170,SUNDAY,1,0,20,73,18.4,1016.4,Cloudy
9/3/2023 3:00,9,10,13438,8286,19,21724,SUNDAY,1,0,19.4,76,20.5,1015.6,Cloudy
9/3/2023 4:00,4,3,6797,2217,7,9014,SUNDAY,1,0,19.4,76,20.5,1015.6,Cloudy
9/3/2023 5:00,11,19,18250,24992,30,43242,SUNDAY,1,0,19.4,79,16.6,1014.7,Cloudy
9/3/2023 6:00,17,75,25426,61285,92,86711,SUNDAY,1,0,18.9,81,9.4,1013.9,Cloudy
9/3/2023 7:00,47,110,2007884,91341,157,2099225,SUNDAY,1,0,18.3,87,14.8,1014,Cloudy
9/3/2023 8:00,78,215,131347,184117,293,315464,SUNDAY,1,0,17.8,90,13,1013.8,Cloudy
9/3/2023 9:00,178,361,370471,317033,539,687504,SUNDAY,1,0,17.8,90,13,1013.8,Cloudy
9/3/2023 10:00,331,422,3472712,351490,753,3824202,SUNDAY,1,0,18.3,87,18.4,1014.4,Rain
9/3/2023 11:00,424,545,3577604,579766,969,4157370,SUNDAY,1,0,18.3,87,18.4,1014.4,Fair
9/3/2023 12:00,481,504,2115559,477315,985,2592874,SUNDAY,1,0,22.2,71,9.4,1014.1,Fair
9/3/2023 13:00,553,506,2069133,442580,1059,2511713,SUNDAY,1,0,24.4,64,11.2,1013.7,Fair
9/3/2023 14:00,532,542,2104968,521800,1074,2626768,SUNDAY,1,0,24.4,64,11.2,1013.7,Fair
9/3/2023 15:00,554,593,4925109,636417,1147,5561526,SUNDAY,1,0,27.2,57,13,1012.6,Fair
9/3/2023 16:00,540,604,2611349,676906,1144,3288255,SUNDAY,1,0,28.3,49,16.6,1012,Fair
9/3/2023 17:00,483,648,4330930,643392,1131,4974322,SUNDAY,1,0,28.9,46,18.4,1011.4,Fair
9/3/2023 18:00,508,636,2451572,601914,1144,3053486,SUNDAY,1,0,28.9,46,18.4,1011.4,Fair
9/3/2023 19:00,384,550,955362,510658,934,1466020,SUNDAY,1,0,30,48,13,1010.1,Rain
9/3/2023 20:00,254,383,423999,336138,637,760137,SUNDAY,1,0,26.1,62,7.6,1009.9,Fair
9/3/2023 21:00,192,337,454155,376564,529,830719,SUNDAY,1,0,26.1,62,9.4,1010,Fair
9/3/2023 22:00,222,221,386068,260495,443,646563,SUNDAY,1,0,25,64,9.4,1010,Fair
9/3/2023 23:00,168,169,896661,197257,337,1093918,SUNDAY,1,0,22.8,69,9.4,1010,Fair
9/4/2023 0:00,135,122,274402,95552,257,369954,MONDAY,0,1,22.8,69,7.6,1011,Fair
9/4/2023 1:00,96,56,495720,40480,152,536200,MONDAY,0,1,21.7,79,0,1011.2,Fair
9/4/2023 2:00,55,38,69338,37004,93,106342,MONDAY,0,1,21.7,79,0,1011,Fair
9/4/2023 3:00,11,15,7834,11408,26,19242,MONDAY,0,1,21.7,79,0,1010.9,Fair
9/4/2023 4:00,12,17,18421,15353,29,33774,MONDAY,0,1,21.7,79,0,1010.9,Fair
9/4/2023 5:00,18,28,97757,19854,46,117611,MONDAY,0,1,22.8,81,14.8,1010.5,Fair
9/4/2023 6:00,31,77,52987,68430,108,121417,MONDAY,0,1,22.2,82,11.2,1010.4,Fair
9/4/2023 7:00,43,144,101922,140850,187,242772,MONDAY,0,1,22.2,79,0,1010.4,Fair
9/4/2023 8:00,120,227,294591,188738,347,483329,MONDAY,0,1,22.2,79,0,1010.4,Fair
9/4/2023 9:00,173,366,667977,308996,539,976973,MONDAY,0,1,22.2,76,0,1010.5,Fair
9/4/2023 10:00,335,464,708218,466654,799,1174872,MONDAY,0,1,22.2,76,0,1010.5,Rain
9/4/2023 11:00,380,542,901160,548120,922,1449280,MONDAY,0,1,22.8,81,0,1011.1,Fair
9/4/2023 12:00,444,558,933686,482787,1002,1416473,MONDAY,0,1,23.9,76,0,1011.2,Fair
9/4/2023 13:00,530,644,1086256,638325,1174,1724581,MONDAY,0,1,23.9,76,0,1011.2,Cloudy
9/4/2023 14:00,506,605,2312072,553112,1111,2865184,MONDAY,0,1,25,74,11.2,1011.5,Cloudy
9/4/2023 15:00,523,619,4783083,614756,1142,5397839,MONDAY,0,1,25,74,11.2,1011.3,Fair
9/4/2023 16:00,512,682,2615632,636069,1194,3251701,MONDAY,0,1,25,71,13,1010.9,Fair
9/4/2023 17:00,486,721,2318881,2055423,1207,4374304,MONDAY,0,1,26.1,67,9.4,1010.4,Fair
9/4/2023 18:00,494,769,4048695,699989,1263,4748684,MONDAY,0,1,25,64,18.4,1010.2,Fair
9/4/2023 19:00,387,608,697327,502395,995,1199722,MONDAY,0,1,25,64,18.4,1010.2,Rain
9/4/2023 20:00,246,451,411280,1244879,697,1656159,MONDAY,0,1,22.2,79,14.8,1010.9,Fair
9/4/2023 21:00,192,309,1255318,239210,501,1494528,MONDAY,0,1,22.2,76,14.8,1010.9,Fair
9/4/2023 22:00,115,219,516814,176540,334,693354,MONDAY,0,1,21.1,82,13,1011.1,Fair
9/4/2023 23:00,83,142,1604065,118675,225,1722740,MONDAY,0,1,21.1,82,13,1011.1,Fair
9/5/2023 0:00,58,81,132184,50581,139,182765,TUESDAY,0,0,21.7,81,0,1011.3,Fair
9/5/2023 1:00,28,30,37599,22669,58,60268,TUESDAY,0,0,20.6,84,0,1011.5,Fair
9/5/2023 2:00,16,8,19430,8261,24,27691,TUESDAY,0,0,21.1,82,0,1011.6,Cloudy
9/5/2023 3:00,2,8,5250,4817,10,10067,TUESDAY,0,0,20.6,84,0,1011.8,Cloudy
9/5/2023 4:00,5,8,361907,5479,13,367386,TUESDAY,0,0,20.6,84,0,1011.8,Cloudy
9/5/2023 5:00,17,103,14631,76329,120,90960,TUESDAY,0,0,20,90,0,1011.5,Cloudy
9/5/2023 6:00,57,317,52293,244950,374,297243,TUESDAY,0,0,19.4,91,0,1011.5,Cloudy
9/5/2023 7:00,136,720,764737,573009,856,1337746,TUESDAY,0,0,20.6,90,0,1011.7,Cloudy
9/5/2023 8:00,186,1232,279442,1388456,1418,1667898,TUESDAY,0,0,20.6,90,0,1012,Cloudy
9/5/2023 9:00,154,668,262637,537958,822,800595,TUESDAY,0,0,20.6,90,0,1012,Cloudy
9/5/2023 10:00,145,457,217769,349693,602,567462,TUESDAY,0,0,22.8,81,14.8,1012.5,Cloudy
9/5/2023 11:00,182,473,513898,401295,655,915193,TUESDAY,0,0,22.8,81,14.8,1012.5,Cloudy
9/5/2023 12:00,192,591,1053990,964538,783,2018528,TUESDAY,0,0,23.9,79,11.2,1012.9,Cloudy
9/5/2023 13:00,177,522,785507,1735928,699,2521435,TUESDAY,0,0,26.1,72,11.2,1013,Cloudy
9/5/2023 14:00,175,576,294899,449051,751,743950,TUESDAY,0,0,28.9,65,9.4,1013.2,Cloudy
9/5/2023 15:00,248,711,3107665,551820,959,3659485,TUESDAY,0,0,28.3,68,13,1013.1,Cloudy
9/5/2023 16:00,309,1113,963635,892580,1422,1856215,TUESDAY,0,0,28.3,65,14.8,1013,Cloudy
9/5/2023 17:00,453,1544,1350551,2970525,1997,4321076,TUESDAY,0,0,27.8,70,16.6,1012.9,Cloudy
9/5/2023 18:00,396,1239,4482563,1058131,1635,5540694,TUESDAY,0,0,27.8,70,16.6,1012.9,Cloudy
9/5/2023 19:00,276,870,4456232,858598,1146,5314830,TUESDAY,0,0,24.4,79,14.8,1012.3,Cloudy
9/5/2023 20:00,217,580,298944,471695,797,770639,TUESDAY,0,0,23.9,79,9.4,1012.1,Fair
9/5/2023 21:00,130,419,280193,389288,549,669481,TUESDAY,0,0,23.3,82,11.2,1012.1,Fair
9/5/2023 22:00,90,259,425666,412146,349,837812,TUESDAY,0,0,23.3,82,11.2,1012.1,Fair
9/5/2023 23:00,68,135,185867,98345,203,284212,TUESDAY,0,0,24.4,74,0,1012.1,Fair
9/6/2023 0:00,33,62,56012,45899,95,101911,WEDNESDAY,0,0,25,71,5.4,1012.2,Fair
9/6/2023 1:00,13,23,25106,18768,36,43874,WEDNESDAY,0,0,25,71,9.4,1012.1,Fair
9/6/2023 2:00,4,12,29540,9142,16,38682,WEDNESDAY,0,0,25.6,69,11.2,1011.8,Fair
9/6/2023 3:00,3,8,12637,3373,11,16010,WEDNESDAY,0,0,25.6,69,11.2,1011.8,Fair
9/6/2023 4:00,4,17,66457,16000,21,82457,WEDNESDAY,0,0,25.6,69,11.2,1011.5,Fair
9/6/2023 5:00,25,112,20692,105537,137,126229,WEDNESDAY,0,0,25,82,0,1010.7,Fair
9/6/2023 6:00,71,317,74962,246307,388,321269,WEDNESDAY,0,0,25,82,14.8,1010.4,Fair
9/6/2023 7:00,122,857,139900,692460,979,832360,WEDNESDAY,0,0,24.4,85,16.6,1010.2,Fair
9/6/2023 8:00,219,1390,281578,1210597,1609,1492175,WEDNESDAY,0,0,24.4,85,16.6,1010.2,Fair
9/6/2023 9:00,171,669,264914,594838,840,859752,WEDNESDAY,0,0,24.4,82,11.2,1010.4,Fair
9/6/2023 10:00,136,474,192643,374732,610,567375,WEDNESDAY,0,0,24.4,82,11.2,1010.5,Cloudy
9/6/2023 11:00,162,480,268903,348189,642,617092,WEDNESDAY,0,0,25,79,13,1010.8,Cloudy
9/6/2023 12:00,158,600,573257,454415,758,1027672,WEDNESDAY,0,0,25.6,74,9.4,1010.8,Fair
9/6/2023 13:00,175,509,280227,500836,684,781063,WEDNESDAY,0,0,25.6,74,9.4,1010.8,Fair
9/6/2023 14:00,193,600,346699,409289,793,755988,WEDNESDAY,0,0,25,69,14.8,1010.6,Fair
9/6/2023 15:00,223,705,415948,531010,928,946958,WEDNESDAY,0,0,25,66,11.2,1010.2,Fair
9/6/2023 16:00,281,1126,1259122,2122889,1407,3382011,WEDNESDAY,0,0,26.7,62,11.2,1009.6,Fair
9/6/2023 17:00,489,1527,763036,1335497,2016,2098533,WEDNESDAY,0,0,26.1,62,18.4,1009,Fair
9/6/2023 18:00,404,1229,837666,1307190,1633,2144856,WEDNESDAY,0,0,26.1,62,18.4,1009,Fair
9/6/2023 19:00,295,867,2113628,713260,1162,2826888,WEDNESDAY,0,0,27.2,62,14.8,1007.7,Fair
9/6/2023 20:00,208,550,375199,1111967,758,1487166,WEDNESDAY,0,0,27.2,62,14.8,1007.7,Fair
9/6/2023 21:00,124,373,697959,323029,497,1020988,WEDNESDAY,0,0,27.8,70,13,1007.1,Fair
9/6/2023 22:00,102,266,184178,214525,368,398703,WEDNESDAY,0,0,28.9,63,7.6,1006.9,Fair
9/6/2023 23:00,56,161,2605022,141764,217,2746786,WEDNESDAY,0,0,28.9,63,7.6,1006.9,Fair
9/7/2023 0:00,35,61,35152,41692,96,76844,THURSDAY,0,0,26.7,71,18.4,1007.2,Fair
9/7/2023 1:00,15,35,11821,28141,50,39962,THURSDAY,0,0,26.1,74,11.2,1007.2,Fair
9/7/2023 2:00,6,14,10168,8972,20,19140,THURSDAY,0,0,26.1,77,14.8,1007.1,Fair
9/7/2023 3:00,5,8,16909,7014,13,23923,THURSDAY,0,0,26.1,77,14.8,1007.1,Fair
9/7/2023 4:00,0,14,0,11192,14,11192,THURSDAY,0,0,26.1,74,14.8,1006.9,Fair
9/7/2023 5:00,24,92,21716,77515,116,99231,THURSDAY,0,0,26.1,74,11.2,1006.7,Fair
9/7/2023 6:00,62,308,57212,251349,370,308561,THURSDAY,0,0,26.1,74,14.8,1006.7,Fair
9/7/2023 7:00,150,789,258189,635229,939,893418,THURSDAY,0,0,25.6,76,13,1006.9,Fair
9/7/2023 8:00,218,1366,257036,1081097,1584,1338133,THURSDAY,0,0,25.6,76,13,1006.9,Fair
9/7/2023 9:00,149,695,368362,575304,844,943666,THURSDAY,0,0,25.6,74,7.6,1007.3,Fair
9/7/2023 10:00,139,485,222958,1387139,624,1610097,THURSDAY,0,0,25.6,76,7.6,1008.2,Fair
9/7/2023 11:00,131,454,669291,325255,585,994546,THURSDAY,0,0,26.7,71,7.6,1008.7,Fair
9/7/2023 12:00,163,563,674250,377224,726,1051474,THURSDAY,0,0,28.3,68,5.4,1008.7,Fair
9/7/2023 13:00,176,494,426013,382029,670,808042,THURSDAY,0,0,28.3,68,5.4,1008.7,Fair
9/7/2023 14:00,186,511,1897843,354589,697,2252432,THURSDAY,0,0,31.1,55,0,1009,Fair
9/7/2023 15:00,236,642,2936988,478646,878,3415634,THURSDAY,0,0,31.1,57,9.4,1009,Fair
9/7/2023 16:00,307,985,571008,800757,1292,1371765,THURSDAY,0,0,31.7,56,11.2,1008.7,Fair
9/7/2023 17:00,420,1465,658535,1231371,1885,1889906,THURSDAY,0,0,31.7,56,11.2,1008.7,Fair
9/7/2023 18:00,372,1196,1930783,1433550,1568,3364333,THURSDAY,0,0,31.1,57,16.6,1008.3,Fair
9/7/2023 19:00,276,879,1302347,713790,1155,2016137,THURSDAY,0,0,28.9,65,20.5,1007.9,Fair
9/7/2023 20:00,202,594,1917889,607298,796,2525187,THURSDAY,0,0,28.9,67,16.6,1007.7,Fair
9/7/2023 21:00,213,425,500502,480557,638,981059,THURSDAY,0,0,28.9,67,9.4,1008.2,Fair
9/7/2023 22:00,122,278,282747,315021,400,597768,THURSDAY,0,0,28.3,70,9.4,1008.2,Fair
9/7/2023 23:00,69,167,88379,180870,236,269249,THURSDAY,0,0,28.9,65,18.4,1009.4,Fair
9/8/2023 0:00,53,81,2794625,71090,134,2865715,FRIDAY,0,0,27.8,72,14.8,1009.9,Fair
9/8/2023 1:00,33,29,787191,21832,62,809023,FRIDAY,0,0,26.7,76,13,1010.4,Fair
9/8/2023 2:00,25,17,693008,18117,42,711125,FRIDAY,0,0,26.1,77,11.2,1011,Fair
9/8/2023 3:00,2,13,3116,9122,15,12238,FRIDAY,0,0,26.1,77,11.2,1011,Fair
9/8/2023 4:00,10,12,16967,29021,22,45988,FRIDAY,0,0,26.1,77,9.4,1011.3,Fair
9/8/2023 5:00,17,79,1819633,53593,96,1873226,FRIDAY,0,0,25,82,9.4,1011.9,Fair
9/8/2023 6:00,48,253,46090,205172,301,251262,FRIDAY,0,0,23.3,88,13,1011.9,Fair
9/8/2023 7:00,124,626,159032,511028,750,670060,FRIDAY,0,0,24.4,85,13,1012.8,Fair
9/8/2023 8:00,191,1024,198215,805910,1215,1004125,FRIDAY,0,0,24.4,85,13,1012.8,Fair
9/8/2023 9:00,139,655,221921,587137,794,809058,FRIDAY,0,0,22.2,91,11.2,1012.7,Fair
9/8/2023 10:00,164,433,276410,344495,597,620905,FRIDAY,0,0,22.2,94,9.4,1013,Cloudy
9/8/2023 11:00,170,479,267450,398884,649,666334,FRIDAY,0,0,22.2,94,9.4,1013,Cloudy
9/8/2023 12:00,194,546,2015034,397850,740,2412884,FRIDAY,0,0,23.9,90,16.6,1013.7,Cloudy
9/8/2023 13:00,234,593,978001,425595,827,1403596,FRIDAY,0,0,25.6,87,18.4,1014,Cloudy
9/8/2023 14:00,261,625,978804,455775,886,1434579,FRIDAY,0,0,27.8,77,18.4,1014.6,Cloudy
9/8/2023 15:00,346,787,1345183,550218,1133,1895401,FRIDAY,0,0,29.4,72,18.4,1014.5,Cloudy
9/8/2023 16:00,376,966,1979189,760085,1342,2739274,FRIDAY,0,0,30,67,20.5,1014.2,Cloudy
9/8/2023 17:00,445,1202,3423311,1139099,1647,4562410,FRIDAY,0,0,30,67,20.5,1014.2,Cloudy
9/8/2023 18:00,444,1040,4757911,921416,1484,5679327,FRIDAY,0,0,29.4,68,25.9,1013.8,Cloudy
9/8/2023 19:00,340,783,732274,735820,1123,1468094,FRIDAY,0,0,26.7,62,9.4,1014.6,Cloudy
9/8/2023 20:00,273,541,399175,920760,814,1319935,FRIDAY,0,0,25.6,69,9.4,1014.1,Cloudy
9/8/2023 21:00,269,433,1912286,992500,702,2904786,FRIDAY,0,0,27.8,74,9.4,1014.6,Cloudy
9/8/2023 22:00,295,389,666613,337280,684,1003893,FRIDAY,0,0,27.8,74,20.5,1014.6,Cloudy
9/8/2023 23:00,254,244,1091802,231521,498,1323323,FRIDAY,0,0,26.7,82,22.3,1016.2,Cloudy
9/9/2023 0:00,189,196,789435,201557,385,990992,SATURDAY,1,0,26.1,77,11.2,1017,Cloudy
9/9/2023 1:00,187,123,957158,133397,310,1090555,SATURDAY,1,0,26.1,65,7.6,1016.8,Cloudy
9/9/2023 2:00,99,72,424494,63457,171,487951,SATURDAY,1,0,24.4,71,7.6,1017.5,Cloudy
9/9/2023 3:00,25,27,242177,15950,52,258127,SATURDAY,1,0,24.4,71,7.6,1017.5,Cloudy
9/9/2023 4:00,13,20,32540,18502,33,51042,SATURDAY,1,0,23.9,69,5.4,1017.1,Cloudy
9/9/2023 5:00,16,36,17417,49316,52,66733,SATURDAY,1,0,23.9,90,13,1016.9,Cloudy
9/9/2023 6:00,26,79,56656,74062,105,130718,SATURDAY,1,0,23.9,90,13,1016.9,Cloudy
9/9/2023 7:00,55,153,114921,458769,208,573690,SATURDAY,1,0,23.9,90,13,1016.9,Cloudy
9/9/2023 8:00,139,299,725381,255425,438,980806,SATURDAY,1,0,23.3,94,9.4,1017.2,Cloudy
9/9/2023 9:00,284,431,5419191,566150,715,5985341,SATURDAY,1,0,23.3,85,0,1017.9,Cloudy
9/9/2023 10:00,297,554,858939,843247,851,1702186,SATURDAY,1,0,22.8,90,7.6,1018.3,Cloudy
9/9/2023 11:00,411,698,1759192,831465,1109,2590657,SATURDAY,1,0,23.3,91,5.4,1018.8,Cloudy
9/9/2023 12:00,426,649,1984383,665722,1075,2650105,SATURDAY,1,0,23.3,91,5.4,1018.8,Cloudy
9/9/2023 13:00,442,681,1349210,666094,1123,2015304,SATURDAY,1,0,26.7,76,11.2,1019.2,Cloudy
9/9/2023 14:00,452,704,2300513,1829700,1156,4130213,SATURDAY,1,0,27.8,70,13,1019.4,Cloudy
9/9/2023 15:00,403,676,4431708,628794,1079,5060502,SATURDAY,1,0,27.8,70,13,1019.4,Cloudy
9/9/2023 16:00,101,207,311917,157396,308,469313,SATURDAY,1,0,27.2,77,13,1019.1,Cloudy
9/9/2023 17:00,181,503,923061,545967,684,1469028,SATURDAY,1,0,27.2,77,14.8,1018.8,Cloudy
9/9/2023 18:00,189,467,3275192,436080,656,3711272,SATURDAY,1,0,27.2,77,14.8,1018.8,Cloudy
9/9/2023 19:00,184,409,2528300,320837,593,2849137,SATURDAY,1,0,23.9,76,18.4,1018.4,Cloudy
9/9/2023 20:00,201,377,376518,874733,578,1251251,SATURDAY,1,0,23.9,76,20.5,1019,Cloudy
9/9/2023 21:00,203,347,2947437,289797,550,3237234,SATURDAY,1,0,22.8,84,13,1018.8,Cloudy
9/9/2023 22:00,169,280,964727,240706,449,1205433,SATURDAY,1,0,22.8,84,13,1018.8,Cloudy
9/9/2023 23:00,189,246,374568,365719,435,740287,SATURDAY,1,0,22.2,87,13,1019.3,Cloudy
9/10/2023 0:00,171,175,935075,142229,346,1077304,SUNDAY,1,0,23.3,82,0,1019.8,Cloudy
9/10/2023 1:00,254,167,6530996,185719,421,6716715,SUNDAY,1,0,21.1,90,0,1020.2,Cloudy
9/10/2023 2:00,98,77,995711,63218,175,1058929,SUNDAY,1,0,21.1,90,11.2,1020.1,Cloudy
9/10/2023 3:00,28,27,1506430,17329,55,1523759,SUNDAY,1,0,21.1,90,11.2,1020.1,Cloudy
9/10/2023 4:00,16,14,16775,12606,30,29381,SUNDAY,1,0,21.7,94,0,1020.1,Cloudy
9/10/2023 5:00,20,30,26957,21387,50,48344,SUNDAY,1,0,21.7,94,7.6,1019.9,Cloudy
9/10/2023 6:00,20,57,33775,59295,77,93070,SUNDAY,1,0,21.7,94,7.6,1019.9,Cloudy
9/10/2023 7:00,68,110,429378,92895,178,522273,SUNDAY,1,0,21.1,97,5.4,1019.9,Cloudy
9/10/2023 8:00,110,265,186894,215077,375,401971,SUNDAY,1,0,22.8,90,7.6,1019.6,Cloudy
9/10/2023 9:00,179,418,314107,326626,597,640733,SUNDAY,1,0,21.7,96,5.4,1019.6,Cloudy
9/10/2023 10:00,297,542,552223,478960,839,1031183,SUNDAY,1,0,21.7,96,5.4,1019.6,Cloudy
9/10/2023 11:00,324,647,947840,510227,971,1458067,SUNDAY,1,0,22.2,100,0,1020.2,Cloudy
9/10/2023 12:00,200,439,295793,401328,639,697121,SUNDAY,1,0,22.2,100,0,1020.2,Cloudy
9/10/2023 13:00,133,323,379468,333372,456,712840,SUNDAY,1,0,22.8,94,11.2,1020.6,Cloudy
9/10/2023 14:00,85,271,93171,353730,356,446901,SUNDAY,1,0,22.2,94,14.8,1020.7,Cloudy
9/10/2023 15:00,123,369,504195,290505,492,794700,SUNDAY,1,0,22.2,94,14.8,1020.4,Cloudy
9/10/2023 16:00,93,259,98807,171317,352,270124,SUNDAY,1,0,21.7,96,13,1019.6,Cloudy
9/10/2023 17:00,64,246,104597,182983,310,287580,SUNDAY,1,0,21.7,96,13,1019.6,Rain
9/10/2023 18:00,142,489,1486828,407480,631,1894308,SUNDAY,1,0,21.1,97,18.4,1019.7,Cloudy
9/10/2023 19:00,123,466,182434,354870,589,537304,SUNDAY,1,0,21.1,97,18.4,1019.7,Rain
9/10/2023 20:00,106,312,635151,318742,418,953893,SUNDAY,1,0,21.1,97,9.4,1019.7,Rain
9/10/2023 21:00,153,267,245574,260255,420,505829,SUNDAY,1,0,21.7,90,9.4,1019.3,Rain
9/10/2023 22:00,96,176,186660,498750,272,685410,SUNDAY,1,0,21.7,90,9.4,1019.3,Rain
9/10/2023 23:00,40,101,43358,122456,141,165814,SUNDAY,1,0,21.1,90,5.4,1018.9,Rain
9/11/2023 0:00,39,57,903770,47233,96,951003,MONDAY,0,0,20.6,93,9.4,1019.1,Cloudy
9/11/2023 1:00,28,23,35508,14925,51,50433,MONDAY,0,0,20,100,5.4,1019.3,Cloudy
9/11/2023 2:00,9,10,29389,5926,19,35315,MONDAY,0,0,20,100,5.4,1019.3,Cloudy
9/11/2023 3:00,5,10,21454,9806,15,31260,MONDAY,0,0,20,100,5.4,1018.6,Cloudy
9/11/2023 4:00,10,22,111086,40559,32,151645,MONDAY,0,0,20,100,5.4,1018.2,Cloudy
9/11/2023 5:00,18,79,24570,56006,97,80576,MONDAY,0,0,20,100,5.4,1018.2,Cloudy
9/11/2023 6:00,48,283,63022,212887,331,275909,MONDAY,0,0,20.6,96,0,1018.1,Cloudy
9/11/2023 7:00,104,707,119943,723965,811,843908,MONDAY,0,0,20.6,96,5.4,1017.9,Cloudy
9/11/2023 8:00,171,1233,1332910,1063616,1404,2396526,MONDAY,0,0,20.6,96,7.6,1017.1,Cloudy
9/11/2023 9:00,136,627,974456,592020,763,1566476,MONDAY,0,0,20.6,96,7.6,1017.1,Cloudy
9/11/2023 10:00,107,401,445421,320191,508,765612,MONDAY,0,0,20,100,7.6,1017.1,Cloudy
9/11/2023 11:00,115,422,663553,287361,537,950914,MONDAY,0,0,20,100,0,1017.3,Cloudy
9/11/2023 12:00,155,569,214966,403354,724,618320,MONDAY,0,0,20.6,96,5.4,1017.3,Cloudy
9/11/2023 13:00,160,533,262681,460879,693,723560,MONDAY,0,0,20.6,96,9.4,1017.6,Cloudy
9/11/2023 14:00,165,564,205526,407888,729,613414,MONDAY,0,0,21.1,93,11.2,1017.5,Cloudy
9/11/2023 15:00,233,642,3733316,471088,875,4204404,MONDAY,0,0,21.7,94,9.4,1017.2,Cloudy
9/11/2023 16:00,214,917,2497295,734637,1131,3231932,MONDAY,0,0,21.7,94,9.4,1017.2,Cloudy
9/11/2023 17:00,219,1136,682743,1279007,1355,1961750,MONDAY,0,0,22.2,91,11.2,1016.5,Cloudy
9/11/2023 18:00,107,629,922023,2321155,736,3243178,MONDAY,0,0,21.7,94,13,1016.1,Cloudy
9/11/2023 19:00,69,422,92752,287050,491,379802,MONDAY,0,0,21.7,94,11.2,1015.7,Cloudy
9/11/2023 20:00,39,189,36692,149856,228,186548,MONDAY,0,0,21.7,94,11.2,1015.7,Cloudy
9/11/2023 21:00,13,105,14433,69429,118,83862,MONDAY,0,0,21.7,96,9.4,1015.9,Rain
9/11/2023 22:00,45,128,41374,97356,173,138730,MONDAY,0,0,21.1,100,5.4,1016.1,Rain
9/11/2023 23:00,53,94,161740,98223,147,259963,MONDAY,0,0,21.1,100,5.4,1016.6,Rain
9/12/2023 0:00,16,39,25100,23848,55,48948,TUESDAY,0,0,21.1,100,5.4,1016.6,Rain
9/12/2023 1:00,10,16,15314,49797,26,65111,TUESDAY,0,0,21.7,96,11.2,1016.4,Cloudy
9/12/2023 2:00,7,12,5280,15029,19,20309,TUESDAY,0,0,21.7,96,7.6,1016.1,Cloudy
9/12/2023 3:00,4,5,4745,3721,9,8466,TUESDAY,0,0,20.6,96,13,1015.6,Cloudy
9/12/2023 4:00,7,9,11502,7974,16,19476,TUESDAY,0,0,20.6,96,16.6,1015.3,Cloudy
9/12/2023 5:00,20,83,25268,57559,103,82827,TUESDAY,0,0,20,96,9.4,1015,Cloudy
9/12/2023 6:00,50,291,81332,265784,341,347116,TUESDAY,0,0,20.6,93,0,1015,Cloudy
9/12/2023 7:00,109,660,367959,613937,769,981896,TUESDAY,0,0,20.6,93,0,1014.7,Cloudy
9/12/2023 8:00,170,1157,255497,3438047,1327,3693544,TUESDAY,0,0,20.6,96,5.4,1014.7,Cloudy
9/12/2023 9:00,100,692,160611,622347,792,782958,TUESDAY,0,0,20.6,96,7.6,1015,Cloudy
9/12/2023 10:00,72,381,116463,1317988,453,1434451,TUESDAY,0,0,20.6,96,7.6,1015,Cloudy
9/12/2023 11:00,100,415,143172,338842,515,482014,TUESDAY,0,0,21.1,97,0,1015.2,Cloudy
9/12/2023 12:00,128,494,2548112,643506,622,3191618,TUESDAY,0,0,21.7,94,5.4,1015.5,Cloudy
9/12/2023 13:00,118,469,202509,370937,587,573446,TUESDAY,0,0,21.7,96,7.6,1015.7,Cloudy
9/12/2023 14:00,153,555,724953,442522,708,1167475,TUESDAY,0,0,21.7,96,7.6,1015.7,Cloudy
9/12/2023 15:00,228,719,585140,554089,947,1139229,TUESDAY,0,0,22.2,97,9.4,1015.7,Cloudy
9/12/2023 16:00,289,1136,446547,997388,1425,1443935,TUESDAY,0,0,22.2,97,9.4,1015.7,Cloudy
9/12/2023 17:00,453,1629,605394,1494637,2082,2100031,TUESDAY,0,0,23.9,82,9.4,1014.9,Cloudy
9/12/2023 18:00,426,1371,1866791,1502011,1797,3368802,TUESDAY,0,0,24.4,79,13,1014.3,Cloudy
9/12/2023 19:00,262,969,631729,861936,1231,1493665,TUESDAY,0,0,24.4,77,11.2,1014.1,Cloudy
9/12/2023 20:00,144,607,198400,593936,751,792336,TUESDAY,0,0,23.9,82,14.8,1014.2,Cloudy
9/12/2023 21:00,112,428,150195,343034,540,493229,TUESDAY,0,0,23.9,82,14.8,1014.2,Cloudy
9/12/2023 22:00,138,313,1233652,266761,451,1500413,TUESDAY,0,0,22.2,87,9.4,1014.4,Cloudy
9/12/2023 23:00,86,159,118322,128195,245,246517,TUESDAY,0,0,22.2,87,14.8,1014.3,Cloudy
9/13/2023 0:00,27,66,48861,49849,93,98710,WEDNESDAY,0,0,21.7,90,5.4,1014.8,Cloudy
9/13/2023 1:00,22,30,229438,27318,52,256756,WEDNESDAY,0,0,21.1,93,7.6,1014.7,Cloudy
9/13/2023 2:00,13,4,15624,3325,17,18949,WEDNESDAY,0,0,21.1,93,7.6,1014.7,Cloudy
9/13/2023 3:00,1,10,314,6545,11,6859,WEDNESDAY,0,0,21.7,94,9.4,1014.7,Cloudy
9/13/2023 4:00,4,12,2502,8434,16,10936,WEDNESDAY,0,0,21.1,93,7.6,1014.8,Cloudy
9/13/2023 5:00,29,106,39354,69815,135,109169,WEDNESDAY,0,0,20.6,96,9.4,1014.2,Cloudy
9/13/2023 6:00,51,315,51293,234120,366,285413,WEDNESDAY,0,0,20.6,96,9.4,1014.2,Cloudy
9/13/2023 7:00,164,835,345835,733395,999,1079230,WEDNESDAY,0,0,20.6,93,11.2,1014,Cloudy
9/13/2023 8:00,236,1459,286311,1185154,1695,1471465,WEDNESDAY,0,0,20.6,93,0,1013.7,Cloudy
9/13/2023 9:00,142,775,209139,596748,917,805887,WEDNESDAY,0,0,20.6,93,9.4,1014.3,Cloudy
9/13/2023 10:00,129,548,662820,420013,677,1082833,WEDNESDAY,0,0,20,96,7.6,1014.5,Cloudy
9/13/2023 11:00,161,584,2557361,451657,745,3009018,WEDNESDAY,0,0,20,96,7.6,1014.5,Cloudy
9/13/2023 12:00,131,530,339102,368925,661,708027,WEDNESDAY,0,0,21.7,90,11.2,1014.7,Cloudy
9/13/2023 13:00,23,138,33075,98283,161,131358,WEDNESDAY,0,0,22.2,87,9.4,1014.5,Cloudy
9/13/2023 14:00,46,301,44690,207592,347,252282,WEDNESDAY,0,0,23.3,82,11.2,1014.2,Cloudy
9/13/2023 15:00,143,649,193975,474137,792,668112,WEDNESDAY,0,0,23.9,82,13,1014.1,Cloudy
9/13/2023 16:00,272,1131,737204,942386,1403,1679590,WEDNESDAY,0,0,23.9,82,13,1014.1,Rain
9/13/2023 17:00,209,867,806336,1191666,1076,1998002,WEDNESDAY,0,0,22.8,87,11.2,1013.7,Rain
9/13/2023 18:00,74,425,198655,321039,499,519694,WEDNESDAY,0,0,22.2,93,11.2,1012.9,Rain
9/13/2023 19:00,37,189,51700,139782,226,191482,WEDNESDAY,0,0,23.3,79,18.4,1012.6,Rain
9/13/2023 20:00,23,178,23223,118051,201,141274,WEDNESDAY,0,0,22.8,79,18.4,1012.7,Rain
9/13/2023 21:00,49,188,90050,153408,237,243458,WEDNESDAY,0,0,22.8,79,18.4,1012.7,Rain
9/13/2023 22:00,69,203,85300,164972,272,250272,WEDNESDAY,0,0,21.7,87,18.4,1012.6,Rain
9/13/2023 23:00,73,122,125768,99728,195,225496,WEDNESDAY,0,0,21.1,93,22.3,1012.8,Rain
9/14/2023 0:00,23,56,86675,38099,79,124774,THURSDAY,0,0,21.1,93,22.3,1012.8,Rain
9/14/2023 1:00,15,32,10862,27957,47,38819,THURSDAY,0,0,20,93,16.6,1013.4,Rain
9/14/2023 2:00,13,7,28390,8193,20,36583,THURSDAY,0,0,20.6,90,9.4,1013.6,Rain
9/14/2023 3:00,5,13,5637,9778,18,15415,THURSDAY,0,0,20.6,90,5.4,1013.7,Cloudy
9/14/2023 4:00,3,18,6719,15479,21,22198,THURSDAY,0,0,19.4,97,5.4,1013.6,Cloudy
9/14/2023 5:00,19,95,12229,66260,114,78489,THURSDAY,0,0,20,93,9.4,1013.6,Cloudy
9/14/2023 6:00,43,287,42166,588234,330,630400,THURSDAY,0,0,20,93,9.4,1013.6,Cloudy
9/14/2023 7:00,149,849,146704,787857,998,934561,THURSDAY,0,0,20,93,11.2,1013.5,Cloudy
9/14/2023 8:00,236,1460,336419,1233368,1696,1569787,THURSDAY,0,0,20,93,11.2,1013.5,Cloudy
9/14/2023 9:00,155,815,284073,872334,970,1156407,THURSDAY,0,0,19.4,91,16.6,1014,Cloudy
9/14/2023 10:00,161,545,241774,467900,706,709674,THURSDAY,0,0,18.9,87,13,1015.1,Cloudy
9/14/2023 11:00,161,557,242216,1096873,718,1339089,THURSDAY,0,0,18.9,87,13,1015.1,Fair
9/14/2023 12:00,222,673,317800,565830,895,883630,THURSDAY,0,0,20.6,70,13,1015.8,Fair
9/14/2023 13:00,200,562,345986,498281,762,844267,THURSDAY,0,0,21.7,63,13,1016.2,Fair
9/14/2023 14:00,239,699,421389,713663,938,1135052,THURSDAY,0,0,22.2,55,13,1016.6,Fair
9/14/2023 15:00,301,797,521349,2902425,1098,3423774,THURSDAY,0,0,22.8,51,13,1016.4,Fair
9/14/2023 16:00,433,1183,2605848,1618116,1616,4223964,THURSDAY,0,0,22.8,51,20.5,1016.4,Fair
9/14/2023 17:00,693,1780,5937657,2210828,2473,8148485,THURSDAY,0,0,25,45,7.6,1016,Fair
9/14/2023 18:00,651,1352,1197044,1718601,2003,2915645,THURSDAY,0,0,24.4,43,13,1015.5,Fair
9/14/2023 19:00,361,976,430715,902675,1337,1333390,THURSDAY,0,0,25.6,42,13,1015.1,Fair
9/14/2023 20:00,181,670,278822,539250,851,818072,THURSDAY,0,0,25.6,42,13,1015.1,Fair
9/14/2023 21:00,167,508,285197,441478,675,726675,THURSDAY,0,0,24.4,42,18.4,1015.6,Fair
9/14/2023 22:00,190,333,2020600,308916,523,2329516,THURSDAY,0,0,23.3,45,16.6,1015.8,Fair
9/14/2023 23:00,184,207,316383,190235,391,506618,THURSDAY,0,0,22.2,51,18.4,1016.6,Fair
9/15/2023 0:00,80,102,1215831,71681,182,1287512,FRIDAY,0,0,20.6,53,14.8,1017.5,Fair
9/15/2023 1:00,37,71,103957,74328,108,178285,FRIDAY,0,0,20.6,53,14.8,1017.5,Fair
9/15/2023 2:00,13,27,540494,20657,40,561151,FRIDAY,0,0,19.4,57,14.8,1017.9,Fair
9/15/2023 3:00,12,11,18156,7420,23,25576,FRIDAY,0,0,18.3,63,16.6,1018.3,Fair
9/15/2023 4:00,8,13,9242,14069,21,23311,FRIDAY,0,0,17.2,67,18.4,1018.3,Fair
9/15/2023 5:00,18,93,371757,59276,111,431033,FRIDAY,0,0,16.7,70,22.3,1018.1,Cloudy
9/15/2023 6:00,38,215,83579,168188,253,251767,FRIDAY,0,0,16.7,70,22.3,1018.1,Cloudy
9/15/2023 7:00,101,588,97122,484341,689,581463,FRIDAY,0,0,15,72,18.4,1018.9,Fair
9/15/2023 8:00,158,1057,147748,820487,1215,968235,FRIDAY,0,0,14.4,75,14.8,1018.9,Fair
9/15/2023 9:00,134,705,657371,931407,839,1588778,FRIDAY,0,0,14.4,72,20.5,1018.5,Fair
9/15/2023 10:00,133,459,267956,406830,592,674786,FRIDAY,0,0,13.9,74,13,1019.4,Cloudy
9/15/2023 11:00,205,617,360478,452139,822,812617,FRIDAY,0,0,13.9,74,13,1019.4,Cloudy
9/15/2023 12:00,243,677,557670,475156,920,1032826,FRIDAY,0,0,16.1,67,25.9,1019.2,Cloudy
9/15/2023 13:00,300,660,541344,586226,960,1127570,FRIDAY,0,0,17.8,65,25.9,1018.9,Cloudy
9/15/2023 14:00,301,724,2187268,519162,1025,2706430,FRIDAY,0,0,18.9,61,25.9,1018.7,Cloudy
9/15/2023 15:00,333,897,1221749,678631,1230,1900380,FRIDAY,0,0,18.9,61,31.7,1018.7,Cloudy
9/15/2023 16:00,463,1122,3674025,954497,1585,4628522,FRIDAY,0,0,20.6,55,29.5,1017.3,Cloudy
9/15/2023 17:00,573,1292,2361068,1076477,1865,3437545,FRIDAY,0,0,21.1,51,31.7,1016.2,Cloudy
9/15/2023 18:00,465,1136,825967,1894288,1601,2720255,FRIDAY,0,0,20,51,27.7,1015.9,Cloudy
9/15/2023 19:00,335,776,1438768,645884,1111,2084652,FRIDAY,0,0,20,61,25.9,1015.1,Cloudy
9/15/2023 20:00,242,539,3285875,428374,781,3714249,FRIDAY,0,0,20,61,25.9,1015.1,Cloudy
9/15/2023 21:00,202,379,2228340,310206,581,2538546,FRIDAY,0,0,20,55,27.7,1014.2,Cloudy
9/15/2023 22:00,154,315,2793635,273267,469,3066902,FRIDAY,0,0,18.9,59,25.9,1013.6,Cloudy
9/15/2023 23:00,228,248,1556734,208984,476,1765718,FRIDAY,0,0,18.3,61,22.3,1013.2,Cloudy
9/16/2023 0:00,180,187,4221194,150176,367,4371370,SATURDAY,1,0,17.8,63,25.9,1013,Cloudy
9/16/2023 1:00,299,159,1692638,179591,458,1872229,SATURDAY,1,0,17.8,63,25.9,1013,Cloudy
9/16/2023 2:00,218,71,3814153,113477,289,3927630,SATURDAY,1,0,17.8,63,25.9,1011.2,Cloudy
9/16/2023 3:00,87,32,1662198,48215,119,1710413,SATURDAY,1,0,17.2,65,29.5,1010.1,Rain
9/16/2023 4:00,12,14,13971,11743,26,25714,SATURDAY,1,0,17.2,63,22.3,1009.4,Rain
9/16/2023 5:00,4,7,3300,6630,11,9930,SATURDAY,1,0,17.8,60,22.3,1009.6,Rain
9/16/2023 6:00,9,23,7873,17239,32,25112,SATURDAY,1,0,17.8,60,25.9,1009.6,Rain
9/16/2023 7:00,11,49,8664,39476,60,48140,SATURDAY,1,0,17.2,65,29.5,1007.3,Rain
9/16/2023 8:00,36,126,38294,78379,162,116673,SATURDAY,1,0,15.6,72,27.7,1006.4,Rain
9/16/2023 9:00,49,219,115398,200630,268,316028,SATURDAY,1,0,15.6,72,29.5,1005.4,Rain
9/16/2023 10:00,117,367,178023,262637,484,440660,SATURDAY,1,0,15.6,72,27.7,1005.4,Rain
9/16/2023 11:00,201,451,280812,322355,652,603167,SATURDAY,1,0,16.1,70,29.5,1004.4,Rain
9/16/2023 12:00,258,556,1769622,399873,814,2169495,SATURDAY,1,0,16.1,70,33.5,1003.6,Rain
9/16/2023 13:00,305,531,481269,416987,836,898256,SATURDAY,1,0,17.2,65,31.7,1003.6,Rain
9/16/2023 14:00,380,615,2180121,495335,995,2675456,SATURDAY,1,0,17.8,60,38.9,1003.4,Rain
9/16/2023 15:00,405,664,813352,551580,1069,1364932,SATURDAY,1,0,17.8,60,37.1,1003.4,Cloudy
9/16/2023 16:00,412,620,1725339,580648,1032,2305987,SATURDAY,1,0,20,49,37.1,1002.8,Cloudy
9/16/2023 17:00,378,633,1285620,531069,1011,1816689,SATURDAY,1,0,21.1,46,38.9,1003.1,Cloudy
9/16/2023 18:00,396,696,796609,2650232,1092,3446841,SATURDAY,1,0,21.1,47,42.5,1003.3,Cloudy
9/16/2023 19:00,283,561,447480,476053,844,923533,SATURDAY,1,0,21.7,46,44.6,1003.8,Cloudy
9/16/2023 20:00,205,440,3410308,334027,645,3744335,SATURDAY,1,0,21.7,46,40.7,1003.8,Cloudy
9/16/2023 21:00,233,332,745295,275359,565,1020654,SATURDAY,1,0,21.1,46,31.7,1005.2,Cloudy
9/16/2023 22:00,192,253,1435123,524834,445,1959957,SATURDAY,1,0,21.7,41,22.3,1005.9,Cloudy
9/16/2023 23:00,177,229,1016828,185317,406,1202145,SATURDAY,1,0,20,44,24.1,1006.6,Cloudy
9/17/2023 0:00,156,172,253456,141793,328,395249,SUNDAY,1,0,19.4,45,24.1,1007.4,Cloudy
9/17/2023 1:00,228,150,957784,472350,378,1430134,SUNDAY,1,0,19.4,45,24.1,1007.4,Cloudy
9/17/2023 2:00,115,69,5392400,115494,184,5507894,SUNDAY,1,0,18.9,47,25.9,1008,Cloudy
9/17/2023 3:00,28,22,31473,16854,50,48327,SUNDAY,1,0,17.8,52,20.5,1008.4,Fair
9/17/2023 4:00,12,14,49949,11659,26,61608,SUNDAY,1,0,17.2,56,20.5,1008.7,Fair
9/17/2023 5:00,9,25,30216,20401,34,50617,SUNDAY,1,0,17.2,58,20.5,1008.9,Fair
9/17/2023 6:00,19,66,34044,51878,85,85922,SUNDAY,1,0,17.2,58,20.5,1008.9,Fair
9/17/2023 7:00,45,122,72346,197468,167,269814,SUNDAY,1,0,16.1,65,22.3,1009.6,Fair
9/17/2023 8:00,78,231,108633,187155,309,295788,SUNDAY,1,0,16.1,65,24.1,1010.1,Clear
9/17/2023 9:00,231,427,590333,359208,658,949541,SUNDAY,1,0,15,69,16.6,1010.7,Clear
9/17/2023 10:00,289,521,529563,471472,810,1001035,SUNDAY,1,0,15,69,16.6,1010.7,Cloudy
9/17/2023 11:00,444,677,1383376,613383,1121,1996759,SUNDAY,1,0,16.7,65,16.6,1012,Fair
9/17/2023 12:00,589,812,2019195,743372,1401,2762567,SUNDAY,1,0,17.8,63,14.8,1012.7,Fair
9/17/2023 13:00,564,792,1382262,1297518,1356,2679780,SUNDAY,1,0,20,57,16.6,1012.7,Fair
9/17/2023 14:00,623,775,1694217,808885,1398,2503102,SUNDAY,1,0,21.7,51,16.6,1012.3,Fair
9/17/2023 15:00,592,793,1512335,751380,1385,2263715,SUNDAY,1,0,21.7,51,16.6,1012.3,Fair
9/17/2023 16:00,582,855,1237304,1668779,1437,2906083,SUNDAY,1,0,23.9,48,18.4,1012,Fair
9/17/2023 17:00,586,900,1476072,1407277,1486,2883349,SUNDAY,1,0,23.9,48,18.4,1012,Fair
9/17/2023 18:00,457,779,4036288,2575762,1236,6612050,SUNDAY,1,0,25,40,18.4,1011.2,Fair
9/17/2023 19:00,346,641,4288412,533591,987,4822003,SUNDAY,1,0,25,40,27.7,1011.2,Fair
9/17/2023 20:00,181,509,414314,398695,690,813009,SUNDAY,1,0,25,42,18.4,1011.1,Fair
9/17/2023 21:00,146,337,2291189,312393,483,2603582,SUNDAY,1,0,23.9,45,16.6,1011.5,Fair
9/17/2023 22:00,100,182,295702,189307,282,485009,SUNDAY,1,0,23.3,50,14.8,1011.7,Cloudy
9/17/2023 23:00,53,129,136049,91269,182,227318,SUNDAY,1,0,21.7,57,14.8,1012.5,Cloudy
9/18/2023 0:00,24,70,71427,53127,94,124554,MONDAY,0,0,20.6,61,13,1012.5,Cloudy
9/18/2023 1:00,39,49,1197825,43465,88,1241290,MONDAY,0,0,20.6,61,13,1012.5,Cloudy
9/18/2023 2:00,12,18,1500013,29261,30,1529274,MONDAY,0,0,20,63,13,1012.9,Cloudy
9/18/2023 3:00,3,6,37615,3105,9,40720,MONDAY,0,0,20,63,13,1012.9,Cloudy
9/18/2023 4:00,13,17,796156,11035,30,807191,MONDAY,0,0,19.4,68,9.4,1012.8,Cloudy
9/18/2023 5:00,13,68,13990,51356,81,65346,MONDAY,0,0,18.9,73,5.4,1012.3,Cloudy
9/18/2023 6:00,27,154,19334,131086,181,150420,MONDAY,0,0,18.9,73,5.4,1012.3,Cloudy
9/18/2023 7:00,31,214,28427,166167,245,194594,MONDAY,0,0,17.8,87,9.4,1011.9,Rain
9/18/2023 8:00,34,320,38553,286853,354,325406,MONDAY,0,0,17.8,87,7.6,1011.5,Rain
9/18/2023 9:00,33,200,27095,127880,233,154975,MONDAY,0,0,17.8,87,7.6,1011.6,Rain
9/18/2023 10:00,45,272,38580,184220,317,222800,MONDAY,0,0,17.8,87,7.6,1011.6,Rain
9/18/2023 11:00,21,200,25220,146664,221,171884,MONDAY,0,0,17.8,96,5.4,1011.8,Rain
9/18/2023 12:00,23,163,31025,112194,186,143219,MONDAY,0,0,17.8,96,5.4,1011.8,Rain
9/18/2023 13:00,19,100,30612,62388,119,93000,MONDAY,0,0,18.3,93,5.4,1011.8,Rain
9/18/2023 14:00,20,115,13160,68446,135,81606,MONDAY,0,0,18.3,93,14.8,1011.8,Rain
9/18/2023 15:00,29,170,81763,118819,199,200582,MONDAY,0,0,18.9,96,16.6,1011.4,Rain
9/18/2023 16:00,33,250,29699,163254,283,192953,MONDAY,0,0,18.3,97,7.6,1010.5,Rain
9/18/2023 17:00,54,403,105237,286679,457,391916,MONDAY,0,0,18.3,97,25.9,1010.5,Rain
9/18/2023 18:00,62,352,114015,398043,414,512058,MONDAY,0,0,18.3,97,14.8,1008.7,Rain
9/18/2023 19:00,27,204,30134,259885,231,290019,MONDAY,0,0,18.9,93,9.4,1007.8,Rain
9/18/2023 20:00,18,94,14419,71908,112,86327,MONDAY,0,0,18.9,93,9.4,1007.8,Rain
9/18/2023 21:00,13,109,12243,77795,122,90038,MONDAY,0,0,18.3,97,5.4,1006.4,Rain
9/18/2023 22:00,17,75,653158,55578,92,708736,MONDAY,0,0,18.3,97,5.4,1006.4,Rain
9/18/2023 23:00,10,49,9208,40115,59,49323,MONDAY,0,0,17.8,96,22.3,1005.2,Cloudy
9/19/2023 0:00,5,26,4026,22243,31,26269,TUESDAY,0,0,18.3,97,18.4,1004.5,Rain
9/19/2023 1:00,9,17,7198,32036,26,39234,TUESDAY,0,0,18.3,100,14.8,1003.2,Rain
9/19/2023 2:00,5,12,4353,10149,17,14502,TUESDAY,0,0,18.3,97,14.8,1002.6,Rain
9/19/2023 3:00,8,5,52836,3947,13,56783,TUESDAY,0,0,18.3,97,14.8,1002.6,Rain
9/19/2023 4:00,7,12,5449,33475,19,38924,TUESDAY,0,0,17.8,93,24.1,1002.7,Rain
9/19/2023 5:00,14,108,13921,97181,122,111102,TUESDAY,0,0,17.8,93,24.1,1002.7,Rain
9/19/2023 6:00,49,308,49585,461466,357,511051,TUESDAY,0,0,17.2,93,20.5,1004,Rain
9/19/2023 7:00,111,845,151131,710592,956,861723,TUESDAY,0,0,17.2,90,14.8,1004,Cloudy
9/19/2023 8:00,235,1466,988853,1251961,1701,2240814,TUESDAY,0,0,16.7,86,24.1,1005.3,Cloudy
9/19/2023 9:00,136,772,163191,626710,908,789901,TUESDAY,0,0,16.7,86,24.1,1005.3,Cloudy
9/19/2023 10:00,134,468,201696,410699,602,612395,TUESDAY,0,0,16.1,87,20.5,1005.9,Fair
9/19/2023 11:00,117,526,185755,394899,643,580654,TUESDAY,0,0,17.2,78,25.9,1007.4,Fair
9/19/2023 12:00,164,587,519920,433594,751,953514,TUESDAY,0,0,18.3,76,20.5,1007.8,Fair
9/19/2023 13:00,160,564,228444,441742,724,670186,TUESDAY,0,0,20,65,24.1,1008.4,Fair
9/19/2023 14:00,199,615,999335,454118,814,1453453,TUESDAY,0,0,21.1,61,27.7,1008.4,Fair
9/19/2023 15:00,266,734,465355,623557,1000,1088912,TUESDAY,0,0,21.1,61,27.7,1008.4,Fair
9/19/2023 16:00,340,1194,463108,976147,1534,1439255,TUESDAY,0,0,21.7,55,20.5,1009.3,Fair
9/19/2023 17:00,280,1060,1060495,961630,1340,2022125,TUESDAY,0,0,22.8,51,31.7,1009.2,Fair
9/19/2023 18:00,272,826,1633267,882671,1098,2515938,TUESDAY,0,0,22.2,49,31.7,1009.3,Fair
9/19/2023 19:00,271,936,2268159,810030,1207,3078189,TUESDAY,0,0,22.2,49,33.5,1009.3,Fair
9/19/2023 20:00,182,579,178939,620365,761,799304,TUESDAY,0,0,22.2,51,33.5,1010,Fair
9/19/2023 21:00,112,456,158302,445386,568,603688,TUESDAY,0,0,21.7,53,22.3,1010.9,Fair
9/19/2023 22:00,89,282,88408,524998,371,613406,TUESDAY,0,0,20.6,57,18.4,1011.7,Fair
9/19/2023 23:00,12,38,18013,28039,50,46052,TUESDAY,0,0,20.6,57,18.4,1011.7,Fair
9/20/2023 0:00,30,54,53596,29550,84,83146,WEDNESDAY,0,0,20,61,22.3,1012.4,Fair
9/20/2023 1:00,16,30,71232,16885,46,88117,WEDNESDAY,0,0,18.3,68,29.5,1013.7,Fair
9/20/2023 2:00,6,12,4276,11087,18,15363,WEDNESDAY,0,0,18.3,68,24.1,1013.7,Fair
9/20/2023 3:00,4,7,46184,6929,11,53113,WEDNESDAY,0,0,17.8,70,20.5,1014.5,Fair
9/20/2023 4:00,4,8,4158,5563,12,9721,WEDNESDAY,0,0,17.2,72,16.6,1015,Fair
9/20/2023 5:00,15,102,28948,103838,117,132786,WEDNESDAY,0,0,17.2,70,18.4,1015.5,Clear
9/20/2023 6:00,56,309,407315,234342,365,641657,WEDNESDAY,0,0,16.1,75,18.4,1016.2,Clear
9/20/2023 7:00,146,818,138642,901994,964,1040636,WEDNESDAY,0,0,15.6,78,13,1016.5,Clear
9/20/2023 8:00,239,1448,820354,1654001,1687,2474355,WEDNESDAY,0,0,15.6,75,16.6,1017.1,Clear
9/20/2023 9:00,129,751,779423,623799,880,1403222,WEDNESDAY,0,0,15.6,75,16.6,1017.1,Clear
9/20/2023 10:00,127,460,204724,1574364,587,1779088,WEDNESDAY,0,0,15,78,14.8,1018.1,Cloudy
9/20/2023 11:00,121,590,195421,456965,711,652386,WEDNESDAY,0,0,15.6,75,18.4,1018.4,Fair
9/20/2023 12:00,165,635,360920,1617440,800,1978360,WEDNESDAY,0,0,17.8,68,18.4,1018.4,Fair
9/20/2023 13:00,184,556,1410845,393003,740,1803848,WEDNESDAY,0,0,17.8,68,18.4,1018.4,Fair
9/20/2023 14:00,198,624,561069,499674,822,1060743,WEDNESDAY,0,0,20.6,55,16.6,1018.8,Fair
9/20/2023 15:00,259,730,937754,554951,989,1492705,WEDNESDAY,0,0,21.1,53,16.6,1018.6,Fair
9/20/2023 16:00,321,1157,975384,1112299,1478,2087683,WEDNESDAY,0,0,22.2,48,11.2,1018.3,Fair
9/20/2023 17:00,518,1648,959441,1481657,2166,2441098,WEDNESDAY,0,0,22.2,48,13,1018.1,Fair
9/20/2023 18:00,471,1251,906157,2475894,1722,3382051,WEDNESDAY,0,0,22.2,48,13,1018.1,Fair
9/20/2023 19:00,254,921,307825,818191,1175,1126016,WEDNESDAY,0,0,23.3,43,16.6,1017.6,Fair
9/20/2023 20:00,194,642,303416,507083,836,810499,WEDNESDAY,0,0,22.8,44,13,1017.7,Fair
9/20/2023 21:00,141,425,198779,353757,566,552536,WEDNESDAY,0,0,21.7,46,18.4,1018.1,Fair
9/20/2023 22:00,102,299,201337,257084,401,458421,WEDNESDAY,0,0,21.7,44,13,1018.3,Fair
9/20/2023 23:00,57,142,65471,103735,199,169206,WEDNESDAY,0,0,21.7,44,13,1018.3,Fair
9/21/2023 0:00,31,57,103190,41655,88,144845,THURSDAY,0,0,19.4,55,11.2,1019.7,Fair
9/21/2023 1:00,21,16,62649,10399,37,73048,THURSDAY,0,0,18.9,59,11.2,1020.1,Fair
9/21/2023 2:00,5,26,6149,24497,31,30646,THURSDAY,0,0,17.8,63,13,1020.8,Fair
9/21/2023 3:00,4,7,5700,6366,11,12066,THURSDAY,0,0,17.2,67,9.4,1021.2,Fair
9/21/2023 4:00,7,14,12224,12674,21,24898,THURSDAY,0,0,17.2,67,9.4,1021.2,Fair
9/21/2023 5:00,16,89,9149,65555,105,74704,THURSDAY,0,0,16.1,72,9.4,1021.5,Fair
9/21/2023 6:00,44,269,34966,204297,313,239263,THURSDAY,0,0,15.6,72,13,1021.3,Fair
9/21/2023 7:00,139,779,148693,595368,918,744061,THURSDAY,0,0,14.4,75,16.6,1021.5,Clear
9/21/2023 8:00,222,1410,270272,1130950,1632,1401222,THURSDAY,0,0,14.4,75,13,1022.1,Clear
9/21/2023 9:00,140,820,171966,671754,960,843720,THURSDAY,0,0,14.4,75,13,1022.1,Clear
9/21/2023 10:00,150,468,253454,396665,618,650119,THURSDAY,0,0,13.9,74,13,1023.4,Cloudy
9/21/2023 11:00,158,511,300866,396902,669,697768,THURSDAY,0,0,14.4,72,11.2,1024,Fair
9/21/2023 12:00,181,578,493319,468255,759,961574,THURSDAY,0,0,16.1,67,11.2,1024.4,Fair
9/21/2023 13:00,194,570,306650,1330584,764,1637234,THURSDAY,0,0,18.3,58,5.4,1024.8,Fair
9/21/2023 14:00,243,621,366945,660821,864,1027766,THURSDAY,0,0,18.3,58,5.4,1024.8,Fair
9/21/2023 15:00,283,815,407021,1790391,1098,2197412,THURSDAY,0,0,19.4,55,11.2,1024.9,Fair
9/21/2023 16:00,380,1123,1246324,1853103,1503,3099427,THURSDAY,0,0,20,57,11.2,1024.5,Fair
9/21/2023 17:00,565,1621,3165655,1439404,2186,4605059,THURSDAY,0,0,20,57,14.8,1024.3,Fair
9/21/2023 18:00,451,1264,3196548,1388674,1715,4585222,THURSDAY,0,0,20,57,14.8,1024.3,Fair
9/21/2023 19:00,252,880,319940,674709,1132,994649,THURSDAY,0,0,20.6,59,13,1024.1,Fair
9/21/2023 20:00,206,699,267574,602001,905,869575,THURSDAY,0,0,20.6,59,13,1024.1,Fair
9/21/2023 21:00,160,509,346241,373745,669,719986,THURSDAY,0,0,18.9,70,9.4,1025.1,Fair
9/21/2023 22:00,118,321,182273,285456,439,467729,THURSDAY,0,0,18.9,68,7.6,1025.3,Fair
9/21/2023 23:00,120,186,261193,143882,306,405075,THURSDAY,0,0,18.9,68,7.6,1025.3,Fair
9/22/2023 0:00,65,98,71129,102565,163,173694,FRIDAY,0,0,18.3,65,7.6,1026.1,Fair
9/22/2023 1:00,25,50,851699,140605,75,992304,FRIDAY,0,0,17.2,70,9.4,1025.8,Fair
9/22/2023 2:00,21,24,20536,23553,45,44089,FRIDAY,0,0,18.3,63,5.4,1026.1,Fair
9/22/2023 3:00,9,13,16167,13008,22,29175,FRIDAY,0,0,18.3,63,5.4,1026.1,Fair
9/22/2023 4:00,16,25,15705,18033,41,33738,FRIDAY,0,0,15,81,5.4,1026.9,Fair
9/22/2023 5:00,15,79,10086,51231,94,61317,FRIDAY,0,0,15.6,80,0,1027.2,Fair
9/22/2023 6:00,46,229,36655,180987,275,217642,FRIDAY,0,0,15.6,80,5.4,1027.3,Fair
9/22/2023 7:00,94,593,97923,986935,687,1084858,FRIDAY,0,0,15.6,80,5.4,1027.3,Fair
9/22/2023 8:00,154,1038,605836,1546259,1192,2152095,FRIDAY,0,0,14.4,87,7.6,1027.7,Fair
9/22/2023 9:00,179,729,240917,597679,908,838596,FRIDAY,0,0,13.9,87,0,1028.7,Fair
9/22/2023 10:00,197,518,1650414,934391,715,2584805,FRIDAY,0,0,14.4,84,7.6,1029.1,Cloudy
9/22/2023 11:00,209,583,393375,483316,792,876691,FRIDAY,0,0,15.6,83,0,1029.5,Cloudy
9/22/2023 12:00,259,576,1458126,413041,835,1871167,FRIDAY,0,0,17.2,87,11.2,1030,Cloudy
9/22/2023 13:00,272,694,3026383,503435,966,3529818,FRIDAY,0,0,17.2,87,11.2,1030,Cloudy
9/22/2023 14:00,292,748,1951089,527474,1040,2478563,FRIDAY,0,0,18.9,70,13,1030.8,Cloudy
9/22/2023 15:00,369,921,620221,689679,1290,1309900,FRIDAY,0,0,19.4,73,16.6,1030.6,Cloudy
9/22/2023 16:00,487,1128,1207862,1596274,1615,2804136,FRIDAY,0,0,18.9,70,16.6,1030.6,Cloudy
9/22/2023 17:00,564,1337,1041718,1194142,1901,2235860,FRIDAY,0,0,18.9,70,16.6,1030.6,Cloudy
9/22/2023 18:00,528,1112,5062870,915608,1640,5978478,FRIDAY,0,0,18.9,50,18.4,1030.1,Cloudy
9/22/2023 19:00,348,740,3059824,613469,1088,3673293,FRIDAY,0,0,18.9,54,20.5,1029.8,Cloudy
9/22/2023 20:00,246,550,2297075,469280,796,2766355,FRIDAY,0,0,17.8,60,18.4,1029.5,Cloudy
9/22/2023 21:00,245,413,461693,323969,658,785662,FRIDAY,0,0,17.2,60,16.6,1029.6,Cloudy
9/22/2023 22:00,331,383,855416,318997,714,1174413,FRIDAY,0,0,17.2,60,16.6,1029.6,Cloudy
9/22/2023 23:00,205,263,1224013,347553,468,1571566,FRIDAY,0,0,16.1,65,22.3,1029.4,Cloudy
9/23/2023 0:00,171,175,566428,130249,346,696677,SATURDAY,1,0,15.6,67,22.3,1029.5,Cloudy
9/23/2023 1:00,235,167,1088984,887588,402,1976572,SATURDAY,1,0,15.6,64,18.4,1029.2,Cloudy
9/23/2023 2:00,131,105,729046,95331,236,824377,SATURDAY,1,0,15,69,18.4,1028.8,Cloudy
9/23/2023 3:00,20,25,22146,31721,45,53867,SATURDAY,1,0,15,69,18.4,1028.8,Cloudy
9/23/2023 4:00,14,17,14795,9617,31,24412,SATURDAY,1,0,15,72,14.8,1028.1,Cloudy
9/23/2023 5:00,10,24,30079,18034,34,48113,SATURDAY,1,0,15.6,75,14.8,1027.9,Cloudy
9/23/2023 6:00,21,72,32921,59153,93,92074,SATURDAY,1,0,15,72,16.6,1027.6,Cloudy
9/23/2023 7:00,67,141,79865,124780,208,204645,SATURDAY,1,0,15,72,16.6,1027.6,Cloudy
9/23/2023 8:00,116,298,188463,230563,414,419026,SATURDAY,1,0,15,72,16.6,1027.2,Cloudy
9/23/2023 9:00,168,422,372012,317789,590,689801,SATURDAY,1,0,15,69,20.5,1027,Cloudy
9/23/2023 10:00,211,493,1173172,380785,704,1553957,SATURDAY,1,0,15,75,18.4,1027.2,Cloudy
9/23/2023 11:00,275,589,473677,472701,864,946378,SATURDAY,1,0,15,75,18.4,1027,Cloudy
9/23/2023 12:00,201,505,355497,365414,706,720911,SATURDAY,1,0,15,75,18.4,1027,Cloudy
9/23/2023 13:00,208,534,1593183,405545,742,1998728,SATURDAY,1,0,15.6,75,22.3,1027,Rain
9/23/2023 14:00,237,482,1181922,339889,719,1521811,SATURDAY,1,0,15.6,75,20.5,1026.7,Rain
9/23/2023 15:00,149,384,839908,362905,533,1202813,SATURDAY,1,0,15.6,78,22.3,1026,Rain
9/23/2023 16:00,129,356,1171286,254026,485,1425312,SATURDAY,1,0,16.1,78,22.3,1025.6,Rain
9/23/2023 17:00,97,307,123033,241627,404,364660,SATURDAY,1,0,16.1,78,22.3,1025.6,Rain
9/23/2023 18:00,77,247,76665,172973,324,249638,SATURDAY,1,0,15.6,80,29.5,1024.4,Rain
9/23/2023 19:00,92,323,153168,364871,415,518039,SATURDAY,1,0,15,90,25.9,1023.5,Rain
9/23/2023 20:00,69,216,77573,144952,285,222525,SATURDAY,1,0,15,90,24.1,1023.7,Rain
9/23/2023 21:00,64,193,91568,137414,257,228982,SATURDAY,1,0,15,93,24.1,1023.5,Rain
9/23/2023 22:00,71,180,62441,728764,251,791205,SATURDAY,1,0,15,93,27.7,1023.5,Rain
9/23/2023 23:00,99,152,241802,139534,251,381336,SATURDAY,1,0,15.6,93,22.3,1023.1,Rain
9/24/2023 0:00,93,137,151421,100023,230,251444,SUNDAY,1,0,15.6,93,24.1,1022.8,Rain
9/24/2023 1:00,152,112,628049,210041,264,838090,SUNDAY,1,0,16.1,90,20.5,1022.7,Rain
9/24/2023 2:00,74,67,131257,86331,141,217588,SUNDAY,1,0,16.1,90,20.5,1022.7,Rain
9/24/2023 3:00,17,28,12230,27876,45,40106,SUNDAY,1,0,16.1,90,13,1022.7,Rain
9/24/2023 4:00,5,17,3576,16554,22,20130,SUNDAY,1,0,15.6,93,25.9,1022.1,Rain
9/24/2023 5:00,7,15,8956,13778,22,22734,SUNDAY,1,0,15.6,93,24.1,1022.1,Rain
9/24/2023 6:00,13,35,25788,26578,48,52366,SUNDAY,1,0,15.6,93,18.4,1021.8,Cloudy
9/24/2023 7:00,29,77,37918,115902,106,153820,SUNDAY,1,0,15.6,93,20.5,1021.5,Cloudy
9/24/2023 8:00,99,204,177301,209115,303,386416,SUNDAY,1,0,15.6,93,20.5,1021.5,Cloudy
9/24/2023 9:00,118,320,189548,292776,438,482324,SUNDAY,1,0,15.6,90,24.1,1021.7,Cloudy
9/24/2023 10:00,212,465,544305,372384,677,916689,SUNDAY,1,0,16.1,90,27.7,1021.6,Cloudy
9/24/2023 11:00,247,608,1101790,490528,855,1592318,SUNDAY,1,0,16.1,90,25.9,1022.2,Cloudy
9/24/2023 12:00,256,624,1207691,496269,880,1703960,SUNDAY,1,0,16.1,90,25.9,1022.2,Cloudy
9/24/2023 13:00,152,416,756168,316081,568,1072249,SUNDAY,1,0,16.7,90,22.3,1022.3,Cloudy
9/24/2023 14:00,160,458,294025,336051,618,630076,SUNDAY,1,0,17.2,87,22.3,1021.7,Cloudy
9/24/2023 15:00,87,219,126257,160137,306,286394,SUNDAY,1,0,17.2,84,27.7,1021.7,Cloudy
9/24/2023 16:00,89,207,100036,156939,296,256975,SUNDAY,1,0,17.2,84,27.7,1021.7,Cloudy
9/24/2023 17:00,119,394,218541,291016,513,509557,SUNDAY,1,0,16.1,93,27.7,1021.6,Cloudy
9/24/2023 18:00,107,445,129763,339579,552,469342,SUNDAY,1,0,16.1,90,29.5,1020.1,Cloudy
9/24/2023 19:00,111,372,133216,267022,483,400238,SUNDAY,1,0,15.6,93,22.3,1020,Cloudy
9/24/2023 20:00,67,281,123966,214426,348,338392,SUNDAY,1,0,15.6,93,22.3,1020,Cloudy
9/24/2023 21:00,53,217,79559,155327,270,234886,SUNDAY,1,0,15.6,96,18.4,1019.5,Cloudy
9/24/2023 22:00,47,146,71466,133305,193,204771,SUNDAY,1,0,15.6,93,25.9,1019.5,Cloudy
9/24/2023 23:00,16,88,21012,56483,104,77495,SUNDAY,1,0,16.1,93,22.3,1019.8,Cloudy
9/25/2023 0:00,17,41,15178,28374,58,43552,MONDAY,0,0,16.1,93,20.5,1019.6,Cloudy
9/25/2023 1:00,22,23,1372971,14423,45,1387394,MONDAY,0,0,16.1,93,20.5,1019.6,Cloudy
9/25/2023 2:00,5,15,5172,13059,20,18231,MONDAY,0,0,15.6,93,22.3,1019.2,Cloudy
9/25/2023 3:00,1,9,439,6717,10,7156,MONDAY,0,0,16.1,90,22.3,1018.8,Cloudy
9/25/2023 4:00,3,18,2386,10520,21,12906,MONDAY,0,0,16.1,90,20.5,1018.3,Cloudy
9/25/2023 5:00,14,81,7633,53633,95,61266,MONDAY,0,0,16.1,90,22.3,1018.4,Rain
9/25/2023 6:00,42,194,32444,134025,236,166469,MONDAY,0,0,16.1,90,16.6,1017.8,Rain
9/25/2023 7:00,51,439,61285,323682,490,384967,MONDAY,0,0,16.1,90,16.6,1017.8,Rain
9/25/2023 8:00,77,712,81204,538273,789,619477,MONDAY,0,0,16.1,84,24.1,1018.2,Rain
9/25/2023 9:00,84,450,141577,314241,534,455818,MONDAY,0,0,16.1,75,24.1,1018.5,Rain
9/25/2023 10:00,81,363,110831,472624,444,583455,MONDAY,0,0,15.6,86,22.3,1019.1,Rain
9/25/2023 11:00,100,375,123263,253090,475,376353,MONDAY,0,0,15.6,90,25.9,1019.6,Rain
9/25/2023 12:00,118,442,564247,273099,560,837346,MONDAY,0,0,15.6,90,25.9,1019.6,Rain
9/25/2023 13:00,105,369,607565,236117,474,843682,MONDAY,0,0,15.6,78,20.5,1021.1,Rain
9/25/2023 14:00,86,359,169106,897915,445,1067021,MONDAY,0,0,16.1,90,22.3,1021.3,Rain
9/25/2023 15:00,77,340,153764,409860,417,563624,MONDAY,0,0,16.7,90,22.3,1021.6,Rain
9/25/2023 16:00,79,485,90786,444771,564,535557,MONDAY,0,0,16.7,84,25.9,1022.1,Rain
9/25/2023 17:00,101,676,168281,555968,777,724249,MONDAY,0,0,16.7,84,25.9,1022.1,Rain
9/25/2023 18:00,65,531,130346,421016,596,551362,MONDAY,0,0,15,90,29.5,1023.3,Rain
9/25/2023 19:00,67,483,147886,332009,550,479895,MONDAY,0,0,15,90,33.5,1023.4,Rain
9/25/2023 20:00,68,386,83704,268405,454,352109,MONDAY,0,0,15,87,29.5,1023.8,Rain
9/25/2023 21:00,70,308,121644,203962,378,325606,MONDAY,0,0,15,87,29.5,1024.4,Rain
9/25/2023 22:00,73,223,236070,153721,296,389791,MONDAY,0,0,15,87,37.1,1024.4,Rain
9/25/2023 23:00,49,107,100704,113264,156,213968,MONDAY,0,0,15.6,80,40.7,1025.1,Rain
9/26/2023 0:00,18,49,21708,61871,67,83579,TUESDAY,0,0,16.1,78,37.1,1025.6,Cloudy
9/26/2023 1:00,8,16,10784,10091,24,20875,TUESDAY,0,0,16.1,78,38.9,1025.6,Cloudy
9/26/2023 2:00,8,9,9955,5709,17,15664,TUESDAY,0,0,16.1,72,38.9,1026.2,Cloudy
9/26/2023 3:00,9,7,1167828,14003,16,1181831,TUESDAY,0,0,16.1,70,40.7,1026.2,Cloudy
9/26/2023 4:00,8,13,5769,10689,21,16458,TUESDAY,0,0,15.6,75,33.5,1026.7,Cloudy
9/26/2023 5:00,13,104,10471,104193,117,114664,TUESDAY,0,0,15.6,78,29.5,1026.9,Cloudy
9/26/2023 6:00,52,282,45150,334025,334,379175,TUESDAY,0,0,15,83,29.5,1026.9,Cloudy
9/26/2023 7:00,96,721,110681,1226354,817,1337035,TUESDAY,0,0,15,83,37.1,1026.9,Cloudy
9/26/2023 8:00,157,1305,213111,1038957,1462,1252068,TUESDAY,0,0,15,81,38.9,1027.1,Cloudy
9/26/2023 9:00,112,688,121956,622436,800,744392,TUESDAY,0,0,15,81,29.5,1027.3,Cloudy
9/26/2023 10:00,105,413,123073,318632,518,441705,TUESDAY,0,0,14.4,87,29.5,1028.3,Cloudy
9/26/2023 11:00,125,487,1360453,364719,612,1725172,TUESDAY,0,0,14.4,84,29.5,1028.8,Cloudy
9/26/2023 12:00,112,504,195830,368986,616,564816,TUESDAY,0,0,14.4,84,35.3,1028.8,Cloudy
9/26/2023 13:00,127,502,764186,361351,629,1125537,TUESDAY,0,0,13.9,77,31.7,1030.1,Cloudy
9/26/2023 14:00,176,517,415618,388778,693,804396,TUESDAY,0,0,13.9,77,35.3,1030.1,Cloudy
9/26/2023 15:00,195,645,2090476,1141089,840,3231565,TUESDAY,0,0,14.4,72,29.5,1030.4,Cloudy
9/26/2023 16:00,252,1109,657529,887228,1361,1544757,TUESDAY,0,0,14.4,72,29.5,1030.4,Cloudy
9/26/2023 17:00,395,1530,482156,2078225,1925,2560381,TUESDAY,0,0,15,67,27.7,1030.2,Cloudy
9/26/2023 18:00,373,1249,543042,1773929,1622,2316971,TUESDAY,0,0,14.4,67,20.5,1029.9,Cloudy
9/26/2023 19:00,169,777,985727,601197,946,1586924,TUESDAY,0,0,14.4,72,18.4,1029.5,Cloudy
9/26/2023 20:00,124,550,132700,454793,674,587493,TUESDAY,0,0,13.9,72,18.4,1029.2,Cloudy
9/26/2023 21:00,111,386,117105,313866,497,430971,TUESDAY,0,0,13.9,72,18.4,1029.2,Cloudy
9/26/2023 22:00,123,331,208512,252382,454,460894,TUESDAY,0,0,12.2,75,13,1029.2,Cloudy
9/26/2023 23:00,63,151,146692,346112,214,492804,TUESDAY,0,0,12.2,75,11.2,1029.2,Cloudy
9/27/2023 0:00,17,71,16259,82241,88,98500,WEDNESDAY,0,0,12.2,77,9.4,1029.2,Cloudy
9/27/2023 1:00,16,19,27927,14807,35,42734,WEDNESDAY,0,0,12.2,75,9.4,1029.2,Cloudy
9/27/2023 2:00,3,12,2860,9705,15,12565,WEDNESDAY,0,0,12.2,75,9.4,1029.2,Cloudy
9/27/2023 3:00,3,8,2465,7198,11,9663,WEDNESDAY,0,0,10.6,77,11.2,1029,Cloudy
9/27/2023 4:00,2,14,999,14622,16,15621,WEDNESDAY,0,0,10.6,80,9.4,1029,Fair
9/27/2023 5:00,12,94,6561,79105,106,85666,WEDNESDAY,0,0,10,83,9.4,1029.1,Fair
9/27/2023 6:00,55,281,46201,308588,336,354789,WEDNESDAY,0,0,10,83,9.4,1029.1,Fair
9/27/2023 7:00,102,754,822144,700825,856,1522969,WEDNESDAY,0,0,10,80,11.2,1028.3,Fair
9/27/2023 8:00,210,1328,220605,1165292,1538,1385897,WEDNESDAY,0,0,9.4,83,11.2,1028,Fair
9/27/2023 9:00,115,761,192259,613316,876,805575,WEDNESDAY,0,0,10,86,13,1028.2,Fair
9/27/2023 10:00,111,505,188055,381460,616,569515,WEDNESDAY,0,0,9.4,86,11.2,1028.5,Cloudy
9/27/2023 11:00,139,524,210657,387325,663,597982,WEDNESDAY,0,0,9.4,86,11.2,1028.5,Cloudy
9/27/2023 12:00,155,584,812086,406344,739,1218430,WEDNESDAY,0,0,13.3,80,16.6,1028.7,Fair
9/27/2023 13:00,159,527,329932,368801,686,698733,WEDNESDAY,0,0,15,78,16.6,1028.8,Fair
9/27/2023 14:00,197,623,254971,454314,820,709285,WEDNESDAY,0,0,16.7,72,13,1029,Fair
9/27/2023 15:00,218,680,395913,540122,898,936035,WEDNESDAY,0,0,17.2,67,16.6,1029.2,Cloudy
9/27/2023 16:00,318,1132,774264,920192,1450,1694456,WEDNESDAY,0,0,17.2,67,16.6,1029.2,Fair
9/27/2023 17:00,494,1613,1920263,1420440,2107,3340703,WEDNESDAY,0,0,17.2,65,18.4,1028.1,Fair
9/27/2023 18:00,305,1172,348665,1024346,1477,1373011,WEDNESDAY,0,0,17.2,60,16.6,1027.7,Fair
9/27/2023 19:00,201,735,218610,557310,936,775920,WEDNESDAY,0,0,16.7,65,16.6,1027.1,Cloudy
9/27/2023 20:00,172,548,185996,430724,720,616720,WEDNESDAY,0,0,16.1,70,16.6,1026.9,Cloudy
9/27/2023 21:00,156,392,1319112,305172,548,1624284,WEDNESDAY,0,0,16.1,70,16.6,1026.9,Cloudy
9/27/2023 22:00,97,266,141715,194852,363,336567,WEDNESDAY,0,0,15,78,13,1027.1,Cloudy
9/27/2023 23:00,48,154,144365,139575,202,283940,WEDNESDAY,0,0,15,78,13,1027.1,Cloudy
9/28/2023 0:00,20,56,36926,35718,76,72644,THURSDAY,0,0,14.4,81,13,1027.6,Cloudy
9/28/2023 1:00,15,27,49767,17074,42,66841,THURSDAY,0,0,14.4,75,13,1027.3,Fair
9/28/2023 2:00,7,18,10836,13595,25,24431,THURSDAY,0,0,14.4,75,13,1027.3,Fair
9/28/2023 3:00,2,6,2068,7271,8,9339,THURSDAY,0,0,14.4,78,13,1027.2,Fair
9/28/2023 4:00,3,16,3756,17118,19,20874,THURSDAY,0,0,13.3,80,11.2,1027.2,Clear
9/28/2023 5:00,14,80,12237,47425,94,59662,THURSDAY,0,0,12.8,87,11.2,1027,Fair
9/28/2023 6:00,46,265,38800,216206,311,255006,THURSDAY,0,0,12.8,87,11.2,1027,Fair
9/28/2023 7:00,115,719,134291,571864,834,706155,THURSDAY,0,0,11.1,89,11.2,1026.9,Fair
9/28/2023 8:00,182,1415,588950,1083542,1597,1672492,THURSDAY,0,0,11.1,93,9.4,1026.8,Fair
9/28/2023 9:00,133,760,190210,1233628,893,1423838,THURSDAY,0,0,11.1,93,11.2,1026.8,Fair
9/28/2023 10:00,118,470,224819,350724,588,575543,THURSDAY,0,0,11.1,93,11.2,1026.9,Cloudy
9/28/2023 11:00,137,519,205139,373058,656,578197,THURSDAY,0,0,11.1,93,11.2,1026.9,Cloudy
9/28/2023 12:00,140,563,311672,395008,703,706680,THURSDAY,0,0,14.4,89,13,1027.6,Cloudy
9/28/2023 13:00,185,532,550373,566681,717,1117054,THURSDAY,0,0,16.1,81,13,1028,Cloudy
9/28/2023 14:00,197,591,802139,432329,788,1234468,THURSDAY,0,0,16.7,78,18.4,1027.8,Cloudy
9/28/2023 15:00,239,722,829595,577641,961,1407236,THURSDAY,0,0,16.7,78,13,1027.9,Cloudy
9/28/2023 16:00,316,1132,433424,928577,1448,1362001,THURSDAY,0,0,16.7,78,13,1027.9,Cloudy
9/28/2023 17:00,462,1519,888930,1373432,1981,2262362,THURSDAY,0,0,17.2,75,16.6,1026.9,Cloudy
9/28/2023 18:00,401,1238,910745,1096014,1639,2006759,THURSDAY,0,0,17.2,72,14.8,1026.5,Cloudy
9/28/2023 19:00,249,789,301855,612986,1038,914841,THURSDAY,0,0,17.2,70,14.8,1026.2,Cloudy
9/28/2023 20:00,180,612,273992,460958,792,734950,THURSDAY,0,0,17.2,70,14.8,1026.2,Cloudy
9/28/2023 21:00,123,431,692087,910948,554,1603035,THURSDAY,0,0,16.7,70,14.8,1026.1,Cloudy
9/28/2023 22:00,128,287,241516,234196,415,475712,THURSDAY,0,0,15,69,14.8,1026.1,Cloudy
9/28/2023 23:00,106,180,145470,123195,286,268665,THURSDAY,0,0,15,72,13,1026.2,Fair
9/29/2023 0:00,62,96,119113,96723,158,215836,FRIDAY,0,0,15,72,14.8,1026.3,Fair
9/29/2023 1:00,39,61,370349,52170,100,422519,FRIDAY,0,0,15,72,14.8,1026.3,Fair
9/29/2023 2:00,18,34,41580,24749,52,66329,FRIDAY,0,0,14.4,72,11.2,1026.3,Fair
9/29/2023 3:00,5,12,5787,9451,17,15238,FRIDAY,0,0,15,72,7.6,1026.3,Fair
9/29/2023 4:00,8,10,9981,4254,18,14235,FRIDAY,0,0,14.4,75,5.4,1025.9,Fair
9/29/2023 5:00,18,62,17571,39133,80,56704,FRIDAY,0,0,13.3,80,9.4,1025.7,Fair
9/29/2023 6:00,35,216,578967,223779,251,802746,FRIDAY,0,0,13.3,80,9.4,1025.7,Fair
9/29/2023 7:00,106,485,102395,360468,591,462863,FRIDAY,0,0,13.3,87,11.2,1025.1,Cloudy
9/29/2023 8:00,147,998,733659,1752719,1145,2486378,FRIDAY,0,0,13.3,87,13,1024.8,Cloudy
9/29/2023 9:00,85,568,81249,394856,653,476105,FRIDAY,0,0,13.3,87,13,1025,Cloudy
9/29/2023 10:00,73,291,96945,188844,364,285789,FRIDAY,0,0,13.3,93,13,1025,Cloudy
9/29/2023 11:00,69,237,873925,199747,306,1073672,FRIDAY,0,0,13.9,87,11.2,1025.6,Cloudy
9/29/2023 12:00,87,415,184508,326195,502,510703,FRIDAY,0,0,13.9,87,11.2,1025.6,Cloudy
9/29/2023 13:00,106,495,560562,358401,601,918963,FRIDAY,0,0,15,87,13,1026.1,Cloudy
9/29/2023 14:00,106,364,460652,276708,470,737360,FRIDAY,0,0,15,87,13,1026.1,Cloudy
9/29/2023 15:00,51,204,246440,190477,255,436917,FRIDAY,0,0,15.6,90,13,1026.2,Cloudy
9/29/2023 16:00,70,354,158594,338552,424,497146,FRIDAY,0,0,15.6,90,13,1025.1,Rain
9/29/2023 17:00,91,558,247671,496184,649,743855,FRIDAY,0,0,15.6,86,18.4,1024.6,Rain
9/29/2023 18:00,135,557,595394,457204,692,1052598,FRIDAY,0,0,15.6,86,18.4,1024.6,Rain
9/29/2023 19:00,100,364,108733,255172,464,363905,FRIDAY,0,0,15,90,20.5,1024.2,Rain
9/29/2023 20:00,87,300,348624,295769,387,644393,FRIDAY,0,0,13.3,87,20.5,1024.6,Rain
9/29/2023 21:00,94,242,611540,222606,336,834146,FRIDAY,0,0,13.3,90,11.2,1024.2,Rain
9/29/2023 22:00,102,213,615648,167825,315,783473,FRIDAY,0,0,13.3,90,13,1023.8,Rain
9/29/2023 23:00,127,209,222242,179886,336,402128,FRIDAY,0,0,13.9,90,9.4,1023.9,Rain
9/30/2023 0:00,67,145,84380,120319,212,204699,SATURDAY,1,0,13.9,90,9.4,1023.9,Rain
9/30/2023 1:00,76,97,1060244,77148,173,1137392,SATURDAY,1,0,13.9,90,13,1024.2,Rain
9/30/2023 2:00,52,64,69092,104051,116,173143,SATURDAY,1,0,14.4,90,11.2,1023.8,Rain
9/30/2023 3:00,17,15,13432,10805,32,24237,SATURDAY,1,0,14.4,90,13,1022.9,Rain
9/30/2023 4:00,5,8,4644,485338,13,489982,SATURDAY,1,0,14.4,87,14.8,1022.8,Rain
9/30/2023 5:00,12,19,20562,16180,31,36742,SATURDAY,1,0,13.9,90,11.2,1022.3,Rain
9/30/2023 6:00,7,72,45728,53514,79,99242,SATURDAY,1,0,13.9,90,11.2,1022.3,Rain
9/30/2023 7:00,45,110,93394,93147,155,186541,SATURDAY,1,0,13.9,90,11.2,1021.5,Rain
9/30/2023 8:00,85,240,1174080,179302,325,1353382,SATURDAY,1,0,13.9,90,11.2,1021.5,Rain
9/30/2023 9:00,159,379,731177,305376,538,1036553,SATURDAY,1,0,14.4,87,13,1021.5,Rain
9/30/2023 10:00,178,509,422166,398991,687,821157,SATURDAY,1,0,14.4,84,13,1021.9,Rain
9/30/2023 11:00,274,598,455710,459111,872,914821,SATURDAY,1,0,14.4,84,13,1021.9,Rain
9/30/2023 12:00,326,663,1014895,523599,989,1538494,SATURDAY,1,0,15,87,11.2,1022.2,Rain
9/30/2023 13:00,327,613,501193,520775,940,1021968,SATURDAY,1,0,15,87,11.2,1022.2,Rain
9/30/2023 14:00,381,692,694429,1306903,1073,2001332,SATURDAY,1,0,15.6,83,14.8,1022.6,Rain
9/30/2023 15:00,378,659,1357280,555052,1037,1912332,SATURDAY,1,0,16.1,78,22.3,1022.8,Rain
9/30/2023 16:00,388,707,1481301,682933,1095,2164234,SATURDAY,1,0,16.1,78,22.3,1022.8,Rain
9/30/2023 17:00,324,706,907418,713247,1030,1620665,SATURDAY,1,0,16.1,70,18.4,1022.2,Rain
9/30/2023 18:00,281,587,1302254,477876,868,1780130,SATURDAY,1,0,16.1,72,16.6,1021.9,Rain
9/30/2023 19:00,221,480,875628,393029,701,1268657,SATURDAY,1,0,16.1,67,18.4,1021.4,Cloudy
9/30/2023 20:00,188,371,319260,352807,559,672067,SATURDAY,1,0,15.6,69,14.8,1021.1,Cloudy
9/30/2023 21:00,191,316,240837,248176,507,489013,SATURDAY,1,0,15.6,69,14.8,1021.1,Cloudy
9/30/2023 22:00,166,268,257667,206173,434,463840,SATURDAY,1,0,15,69,14.8,1021.4,Cloudy
9/30/2023 23:00,216,262,1776365,197741,478,1974106,SATURDAY,1,0,15,69,14.8,1021.4,Cloudy
10/1/2023 0:00,165,170,5016930,130817,335,5147747,SUNDAY,1,0,15,69,13,1022.1,Cloudy
10/1/2023 1:00,132,135,6250802,540719,267,6791521,SUNDAY,1,0,14.4,81,9.4,1021.8,Cloudy
10/1/2023 2:00,94,71,118633,101578,165,220211,SUNDAY,1,0,13.9,83,13,1021.3,Cloudy
10/1/2023 3:00,8,18,9761,13745,26,23506,SUNDAY,1,0,13.9,83,13,1021.3,Cloudy
10/1/2023 4:00,9,12,9687,10972,21,20659,SUNDAY,1,0,13.9,81,14.8,1021.2,Cloudy
10/1/2023 5:00,19,22,20205,17107,41,37312,SUNDAY,1,0,13.3,80,13,1021.2,Cloudy
10/1/2023 6:00,20,54,36904,39101,74,76005,SUNDAY,1,0,12.8,83,11.2,1020.9,Cloudy
10/1/2023 7:00,37,119,51305,104498,156,155803,SUNDAY,1,0,12.8,80,13,1020.9,Cloudy
10/1/2023 8:00,109,265,205907,255604,374,461511,SUNDAY,1,0,12.2,83,5.4,1021.2,Fair
10/1/2023 9:00,190,364,364634,332052,554,696686,SUNDAY,1,0,12.2,93,11.2,1021.4,Fair
10/1/2023 10:00,237,467,417129,418147,704,835276,SUNDAY,1,0,12.2,93,11.2,1021.4,Cloudy
10/1/2023 11:00,370,570,789222,496360,940,1285582,SUNDAY,1,0,13.3,87,11.2,1022,Cloudy
10/1/2023 12:00,454,656,924593,633902,1110,1558495,SUNDAY,1,0,14.4,84,14.8,1022.3,Cloudy
10/1/2023 13:00,462,676,2326970,633058,1138,2960028,SUNDAY,1,0,15.6,80,13,1022.4,Fair
10/1/2023 14:00,450,669,3312440,663493,1119,3975933,SUNDAY,1,0,17.2,75,13,1022.2,Fair
10/1/2023 15:00,494,718,1753774,692723,1212,2446497,SUNDAY,1,0,17.2,75,13,1022.2,Fair
10/1/2023 16:00,555,814,6753021,721305,1369,7474326,SUNDAY,1,0,17.8,78,11.2,1021.5,Cloudy
10/1/2023 17:00,456,811,6661483,896032,1267,7557515,SUNDAY,1,0,19.4,71,13,1020.7,Cloudy
10/1/2023 18:00,391,735,1313157,2062452,1126,3375609,SUNDAY,1,0,20,68,13,1020.4,Cloudy
10/1/2023 19:00,196,488,376484,436863,684,813347,SUNDAY,1,0,18.9,73,14.8,1020.1,Fair
10/1/2023 20:00,174,378,297785,326109,552,623894,SUNDAY,1,0,18.9,73,14.8,1020.1,Fair
10/1/2023 21:00,105,258,882824,222153,363,1104977,SUNDAY,1,0,17.2,75,7.6,1020.2,Cloudy
10/1/2023 22:00,99,195,186233,991811,294,1178044,SUNDAY,1,0,16.7,78,0,1020,Fair
10/1/2023 23:00,49,122,373374,98687,171,472061,SUNDAY,1,0,16.7,78,7.6,1020.3,Fair
10/2/2023 0:00,13,65,9456,47135,78,56591,MONDAY,0,0,16.7,78,7.6,1020.3,Fair
10/2/2023 1:00,17,37,2449485,25056,54,2474541,MONDAY,0,0,16.7,78,0,1020.7,Clear
10/2/2023 2:00,8,13,10409,9943,21,20352,MONDAY,0,0,16.1,84,0,1020.8,Clear
10/2/2023 3:00,3,9,3728,8012,12,11740,MONDAY,0,0,16.1,84,0,1020.4,Clear
10/2/2023 4:00,6,14,5880,11125,20,17005,MONDAY,0,0,16.1,87,9.4,1020.6,Clear
10/2/2023 5:00,16,75,14522,64564,91,79086,MONDAY,0,0,16.1,87,9.4,1020.6,Clear
10/2/2023 6:00,45,218,50390,161198,263,211588,MONDAY,0,0,16.1,87,14.8,1020.7,Clear
10/2/2023 7:00,102,636,1602286,531912,738,2134198,MONDAY,0,0,16.7,86,14.8,1021,Fair
10/2/2023 8:00,162,1233,156358,4212582,1395,4368940,MONDAY,0,0,17.2,81,18.4,1021.4,Fair
10/2/2023 9:00,142,721,248112,547190,863,795302,MONDAY,0,0,17.2,78,14.8,1021.7,Fair
10/2/2023 10:00,137,461,227414,1063386,598,1290800,MONDAY,0,0,16.1,81,16.6,1022.2,Cloudy
10/2/2023 11:00,142,461,416967,690477,603,1107444,MONDAY,0,0,16.1,81,16.6,1022.2,Fair
10/2/2023 12:00,187,555,283235,366617,742,649852,MONDAY,0,0,16.7,72,16.6,1022.2,Fair
10/2/2023 13:00,158,520,228299,417236,678,645535,MONDAY,0,0,18.9,54,25.9,1022.9,Fair
10/2/2023 14:00,197,586,356710,419733,783,776443,MONDAY,0,0,20,51,22.3,1022.9,Fair
10/2/2023 15:00,241,630,1391462,494077,871,1885539,MONDAY,0,0,20,51,22.3,1022.9,Fair
10/2/2023 16:00,273,1009,1411461,820883,1282,2232344,MONDAY,0,0,20,49,22.3,1022.7,Fair
10/2/2023 17:00,435,1434,3678027,1757894,1869,5435921,MONDAY,0,0,20,55,20.5,1022.4,Fair
10/2/2023 18:00,358,1169,728029,1086751,1527,1814780,MONDAY,0,0,20.6,44,16.6,1022.3,Fair
10/2/2023 19:00,207,795,1213445,982828,1002,2196273,MONDAY,0,0,18.3,63,14.8,1022.2,Fair
10/2/2023 20:00,146,559,2463255,558059,705,3021314,MONDAY,0,0,18.3,63,14.8,1022.2,Fair
10/2/2023 21:00,96,343,133467,299631,439,433098,MONDAY,0,0,17.2,72,9.4,1022.4,Fair
10/2/2023 22:00,73,215,78042,140306,288,218348,MONDAY,0,0,15.6,78,7.6,1022.3,Fair
10/2/2023 23:00,59,120,222177,123185,179,345362,MONDAY,0,0,16.1,75,0,1021.9,Fair
10/3/2023 0:00,18,54,30115,38519,72,68634,TUESDAY,0,0,16.1,75,0,1021.9,Fair
10/3/2023 1:00,12,36,496204,34140,48,530344,TUESDAY,0,0,15,75,5.4,1021.7,Clear
10/3/2023 2:00,7,14,23410,15951,21,39361,TUESDAY,0,0,15.6,72,5.4,1021.6,Clear
10/3/2023 3:00,1,11,278,44827,12,45105,TUESDAY,0,0,14.4,72,5.4,1021.3,Clear
10/3/2023 4:00,4,16,2163,9859,20,12022,TUESDAY,0,0,14.4,70,9.4,1021.6,Clear
10/3/2023 5:00,12,101,31750,82777,113,114527,TUESDAY,0,0,14.4,70,9.4,1021.6,Clear
10/3/2023 6:00,63,306,56453,270149,369,326602,TUESDAY,0,0,12.8,72,0,1021.1,Clear
10/3/2023 7:00,152,835,163036,662559,987,825595,TUESDAY,0,0,13.3,75,5.4,1021.1,Clear
10/3/2023 8:00,213,1446,280393,1937268,1659,2217661,TUESDAY,0,0,12.2,77,0,1020.3,Clear
10/3/2023 9:00,125,792,198203,1115231,917,1313434,TUESDAY,0,0,13.3,72,14.8,1020.2,Clear
10/3/2023 10:00,111,497,184361,405651,608,590012,TUESDAY,0,0,13.3,72,14.8,1020.2,Cloudy
10/3/2023 11:00,148,481,313775,406529,629,720304,TUESDAY,0,0,15,69,13,1020.2,Fair
10/3/2023 12:00,178,532,310124,410033,710,720157,TUESDAY,0,0,17.8,65,13,1020.5,Fair
10/3/2023 13:00,175,526,330941,397160,701,728101,TUESDAY,0,0,19.4,61,7.6,1020.4,Fair
10/3/2023 14:00,183,553,1382443,411401,736,1793844,TUESDAY,0,0,19.4,61,7.6,1020.4,Fair
10/3/2023 15:00,255,687,2501504,996892,942,3498396,TUESDAY,0,0,24.4,50,7.6,1019.7,Fair
10/3/2023 16:00,360,1142,837178,3769836,1502,4607014,TUESDAY,0,0,25.6,50,11.2,1019.1,Fair
10/3/2023 17:00,522,1676,1793495,2589062,2198,4382557,TUESDAY,0,0,27.2,49,13,1018.4,Fair
10/3/2023 18:00,479,1326,4831507,1481115,1805,6312622,TUESDAY,0,0,28.3,48,13,1017.9,Fair
10/3/2023 19:00,223,847,3233554,665240,1070,3898794,TUESDAY,0,0,28.3,48,13,1017.9,Fair
10/3/2023 20:00,178,571,284239,436905,749,721144,TUESDAY,0,0,27.8,51,16.6,1017.6,Fair
10/3/2023 21:00,151,436,1096612,359286,587,1455898,TUESDAY,0,0,26.7,54,18.4,1017.9,Fair
10/3/2023 22:00,151,287,252461,217642,438,470103,TUESDAY,0,0,25.6,60,14.8,1018.1,Fair
10/3/2023 23:00,45,145,109487,125263,190,234750,TUESDAY,0,0,24.4,64,13,1018.5,Fair
10/4/2023 0:00,36,61,74201,48775,97,122976,WEDNESDAY,0,0,24.4,64,13,1018.5,Fair
10/4/2023 1:00,15,25,47230,18066,40,65296,WEDNESDAY,0,0,23.3,71,9.4,1018.9,Fair
10/4/2023 2:00,8,18,9665,13264,26,22929,WEDNESDAY,0,0,22.8,73,9.4,1019,Clear
10/4/2023 3:00,0,5,0,3283,5,3283,WEDNESDAY,0,0,21.1,78,7.6,1019,Clear
10/4/2023 4:00,4,14,3997,11782,18,15779,WEDNESDAY,0,0,21.1,78,7.6,1019,Clear
10/4/2023 5:00,17,97,16490,63424,114,79914,WEDNESDAY,0,0,19.4,84,5.4,1019.4,Clear
10/4/2023 6:00,50,275,75778,198361,325,274139,WEDNESDAY,0,0,19.4,84,5.4,1019.4,Clear
10/4/2023 7:00,122,872,108015,671069,994,779084,WEDNESDAY,0,0,16.7,96,5.4,1020.2,Clear
10/4/2023 8:00,211,1471,222128,1157688,1682,1379816,WEDNESDAY,0,0,16.7,96,5.4,1020.2,Clear
10/4/2023 9:00,154,803,238701,649500,957,888201,WEDNESDAY,0,0,17.2,93,0,1020.5,Fair
10/4/2023 10:00,135,472,292445,371884,607,664329,WEDNESDAY,0,0,18.9,87,5.4,1021.7,Cloudy
10/4/2023 11:00,146,509,247677,368764,655,616441,WEDNESDAY,0,0,20,81,9.4,1022.4,Fair
10/4/2023 12:00,150,583,216595,428408,733,645003,WEDNESDAY,0,0,21.7,73,5.4,1022.9,Fair
10/4/2023 13:00,193,546,468827,398553,739,867380,WEDNESDAY,0,0,23.3,71,0,1023.3,Fair
10/4/2023 14:00,186,587,280106,440519,773,720625,WEDNESDAY,0,0,23.3,71,0,1023.3,Fair
10/4/2023 15:00,277,705,1146014,1174696,982,2320710,WEDNESDAY,0,0,23.3,71,11.2,1023.4,Fair
10/4/2023 16:00,372,1219,3036477,947633,1591,3984110,WEDNESDAY,0,0,22.2,73,13,1023.3,Fair
10/4/2023 17:00,571,1623,2700152,1497328,2194,4197480,WEDNESDAY,0,0,21.7,79,11.2,1022.8,Fair
10/4/2023 18:00,425,1280,2254952,1053691,1705,3308643,WEDNESDAY,0,0,21.1,78,14.8,1022.8,Fair
10/4/2023 19:00,235,858,334621,2256267,1093,2590888,WEDNESDAY,0,0,20,84,13,1022.5,Fair
10/4/2023 20:00,178,596,2466701,491853,774,2958554,WEDNESDAY,0,0,20,84,13,1022.5,Fair
10/4/2023 21:00,114,411,283575,343776,525,627351,WEDNESDAY,0,0,18.9,87,7.6,1022.8,Fair
10/4/2023 22:00,116,262,3462464,1051913,378,4514377,WEDNESDAY,0,0,18.3,90,9.4,1023.1,Fair
10/4/2023 23:00,53,160,114027,114696,213,228723,WEDNESDAY,0,0,17.8,96,7.6,1023.4,Fair
10/5/2023 0:00,34,65,2269988,42877,99,2312865,THURSDAY,0,0,17.8,96,7.6,1023.4,Fair
10/5/2023 1:00,11,37,14425,31319,48,45744,THURSDAY,0,0,17.8,93,0,1023.8,Fair
10/5/2023 2:00,7,22,11519,18929,29,30448,THURSDAY,0,0,17.8,93,0,1023.8,Fair
10/5/2023 3:00,4,8,4244,8885,12,13129,THURSDAY,0,0,17.2,97,7.6,1023.8,Fair
10/5/2023 4:00,4,15,5809,18883,19,24692,THURSDAY,0,0,17.2,97,5.4,1023.9,Fair
10/5/2023 5:00,25,83,18816,85361,108,104177,THURSDAY,0,0,17.2,97,5.4,1023.9,Fair
10/5/2023 6:00,45,266,45541,223458,311,268999,THURSDAY,0,0,16.7,100,0,1024.2,Cloudy
10/5/2023 7:00,114,763,189277,687387,877,876664,THURSDAY,0,0,16.1,100,0,1024.2,Cloudy
10/5/2023 8:00,187,1418,212828,1203830,1605,1416658,THURSDAY,0,0,16.1,100,0,1025,Cloudy
10/5/2023 9:00,144,758,222951,644537,902,867488,THURSDAY,0,0,16.1,97,0,1024.5,Cloudy
10/5/2023 10:00,146,526,334877,404243,672,739120,THURSDAY,0,0,16.1,97,7.6,1024.5,Cloudy
10/5/2023 11:00,160,516,960398,906511,676,1866909,THURSDAY,0,0,15.6,100,9.4,1025,Cloudy
10/5/2023 12:00,203,592,433747,436552,795,870299,THURSDAY,0,0,15.6,100,9.4,1025,Cloudy
10/5/2023 13:00,177,545,332965,489698,722,822663,THURSDAY,0,0,16.7,96,9.4,1026,Cloudy
10/5/2023 14:00,246,591,415281,450651,837,865932,THURSDAY,0,0,17.8,96,9.4,1026.1,Cloudy
10/5/2023 15:00,273,749,3615298,643092,1022,4258390,THURSDAY,0,0,21.1,82,14.8,1024.9,Cloudy
10/5/2023 16:00,384,1148,1580387,965478,1532,2545865,THURSDAY,0,0,21.7,76,11.2,1024.2,Fair
10/5/2023 17:00,597,1563,1018951,1385765,2160,2404716,THURSDAY,0,0,23.3,71,11.2,1023.4,Fair
10/5/2023 18:00,438,1252,1521584,1098756,1690,2620340,THURSDAY,0,0,23.9,66,11.2,1022.7,Fair
10/5/2023 19:00,247,799,1635021,637212,1046,2272233,THURSDAY,0,0,23.9,66,11.2,1022.7,Fair
10/5/2023 20:00,203,561,275261,1116967,764,1392228,THURSDAY,0,0,23.9,60,16.6,1022,Fair
10/5/2023 21:00,155,439,2726847,344184,594,3071031,THURSDAY,0,0,21.7,71,18.4,1021.9,Fair
10/5/2023 22:00,114,293,197919,223139,407,421058,THURSDAY,0,0,20.6,75,13,1022.1,Fair
10/5/2023 23:00,81,186,137013,135743,267,272756,THURSDAY,0,0,20.6,75,13,1022.1,Fair
10/6/2023 0:00,64,109,2444140,108593,173,2552733,FRIDAY,0,0,18.9,84,18.4,1022.9,Fair
10/6/2023 1:00,36,52,152876,43163,88,196039,FRIDAY,0,0,18.3,90,14.8,1023,Cloudy
10/6/2023 2:00,19,20,21660,63927,39,85587,FRIDAY,0,0,18.3,90,14.8,1023,Cloudy
10/6/2023 3:00,8,10,28112,9136,18,37248,FRIDAY,0,0,17.8,90,13,1022.7,Cloudy
10/6/2023 4:00,13,21,16876,14817,34,31693,FRIDAY,0,0,17.2,90,9.4,1022.5,Cloudy
10/6/2023 5:00,26,77,23887,66952,103,90839,FRIDAY,0,0,17.2,90,9.4,1022.5,Cloudy
10/6/2023 6:00,38,217,58066,218084,255,276150,FRIDAY,0,0,17.2,93,11.2,1021.2,Cloudy
10/6/2023 7:00,100,564,116791,528653,664,645444,FRIDAY,0,0,17.2,93,11.2,1021.2,Cloudy
10/6/2023 8:00,152,997,210205,1582427,1149,1792632,FRIDAY,0,0,17.2,93,5.4,1020.8,Cloudy
10/6/2023 9:00,133,670,1291207,548091,803,1839298,FRIDAY,0,0,17.2,93,5.4,1020.8,Cloudy
10/6/2023 10:00,169,499,305678,505786,668,811464,FRIDAY,0,0,17.8,93,11.2,1020.3,Cloudy
10/6/2023 11:00,234,520,1101986,406191,754,1508177,FRIDAY,0,0,17.8,93,11.2,1020.3,Cloudy
10/6/2023 12:00,248,654,605548,490836,902,1096384,FRIDAY,0,0,18.3,90,5.4,1020.7,Cloudy
10/6/2023 13:00,261,615,1529199,453494,876,1982693,FRIDAY,0,0,18.3,90,5.4,1020.7,Cloudy
10/6/2023 14:00,298,606,538201,1217030,904,1755231,FRIDAY,0,0,18.9,93,14.8,1020.3,Cloudy
10/6/2023 15:00,347,811,588503,630879,1158,1219382,FRIDAY,0,0,18.9,90,18.4,1020.1,Cloudy
10/6/2023 16:00,415,1010,3556326,1067640,1425,4623966,FRIDAY,0,0,18.9,90,20.5,1019,Cloudy
10/6/2023 17:00,478,1204,3332971,1044331,1682,4377302,FRIDAY,0,0,19.4,87,22.3,1019,Cloudy
10/6/2023 18:00,412,1021,3496538,872194,1433,4368732,FRIDAY,0,0,19.4,91,20.5,1018.6,Cloudy
10/6/2023 19:00,302,693,452912,3668623,995,4121535,FRIDAY,0,0,18.9,90,20.5,1017.4,Cloudy
10/6/2023 20:00,227,508,299954,428670,735,728624,FRIDAY,0,0,18.9,90,20.5,1017.4,Cloudy
10/6/2023 21:00,238,417,314577,308849,655,623426,FRIDAY,0,0,18.9,90,20.5,1017.3,Cloudy
10/6/2023 22:00,206,338,404504,340831,544,745335,FRIDAY,0,0,18.3,93,18.4,1017.1,Cloudy
10/6/2023 23:00,216,265,3225063,303451,481,3528514,FRIDAY,0,0,18.3,93,18.4,1017.1,Cloudy
10/7/2023 0:00,152,203,622614,190982,355,813596,SATURDAY,1,0,18.3,97,14.8,1016.9,Cloudy
10/7/2023 1:00,173,128,2469142,94914,301,2564056,SATURDAY,1,0,18.3,97,11.2,1016.9,Cloudy
10/7/2023 2:00,100,102,1018140,89008,202,1107148,SATURDAY,1,0,18.3,97,11.2,1016,Cloudy
10/7/2023 3:00,30,37,220922,27873,67,248795,SATURDAY,1,0,17.8,100,11.2,1016,Cloudy
10/7/2023 4:00,15,21,12769,14662,36,27431,SATURDAY,1,0,18.3,97,13,1015.5,Cloudy
10/7/2023 5:00,19,28,21438,26553,47,47991,SATURDAY,1,0,17.8,100,14.8,1013.9,Cloudy
10/7/2023 6:00,9,63,35024,668401,72,703425,SATURDAY,1,0,17.8,100,14.8,1013.9,Cloudy
10/7/2023 7:00,48,151,37930,124427,199,162357,SATURDAY,1,0,17.8,96,18.4,1012.4,Cloudy
10/7/2023 8:00,93,240,181217,196165,333,377382,SATURDAY,1,0,17.8,96,13,1012,Cloudy
10/7/2023 9:00,181,379,325869,311119,560,636988,SATURDAY,1,0,17.8,96,13,1012,Cloudy
10/7/2023 10:00,251,512,1383810,444954,763,1828764,SATURDAY,1,0,17.8,96,13,1011.1,Cloudy
10/7/2023 11:00,330,607,645541,595584,937,1241125,SATURDAY,1,0,17.8,96,22.3,1010.9,Cloudy
10/7/2023 12:00,389,593,1590231,496960,982,2087191,SATURDAY,1,0,18.3,93,22.3,1010.4,Cloudy
10/7/2023 13:00,209,408,3660511,294884,617,3955395,SATURDAY,1,0,18.3,93,22.3,1010.4,Cloudy
10/7/2023 14:00,107,233,169486,179616,340,349102,SATURDAY,1,0,18.9,90,18.4,1009.1,Rain
10/7/2023 15:00,165,397,845689,321451,562,1167140,SATURDAY,1,0,18.9,93,22.3,1007.8,Rain
10/7/2023 16:00,234,467,333735,935968,701,1269703,SATURDAY,1,0,19.4,91,20.5,1006.3,Cloudy
10/7/2023 17:00,280,514,2932443,381218,794,3313661,SATURDAY,1,0,18.3,97,22.3,1004.9,Cloudy
10/7/2023 18:00,236,497,773827,350495,733,1124322,SATURDAY,1,0,18.3,97,22.3,1004.9,Cloudy
10/7/2023 19:00,175,390,701478,320730,565,1022208,SATURDAY,1,0,17.8,100,18.4,1002.5,Cloudy
10/7/2023 20:00,169,331,379345,261942,500,641287,SATURDAY,1,0,17.8,96,18.4,1001.7,Cloudy
10/7/2023 21:00,109,212,571993,153126,321,725119,SATURDAY,1,0,17.8,96,18.4,1001.7,Cloudy
10/7/2023 22:00,130,240,1131087,348946,370,1480033,SATURDAY,1,0,17.8,93,14.8,1000.6,Cloudy
10/7/2023 23:00,111,172,415162,135639,283,550801,SATURDAY,1,0,17.2,97,11.2,998.5,Rain
10/8/2023 0:00,51,86,55527,60843,137,116370,SUNDAY,1,0,17.2,97,11.2,998.5,Rain
10/8/2023 1:00,112,117,2036457,122244,229,2158701,SUNDAY,1,0,17.2,97,11.2,997,Rain
10/8/2023 2:00,67,47,76203,63761,114,139964,SUNDAY,1,0,17.2,93,7.6,997,Rain
10/8/2023 3:00,21,17,41789,16696,38,58485,SUNDAY,1,0,17.2,97,7.6,996,Rain
10/8/2023 4:00,9,12,179691,11277,21,190968,SUNDAY,1,0,17.2,93,0,994.8,Rain
10/8/2023 5:00,13,31,15603,24492,44,40095,SUNDAY,1,0,13.9,93,24.1,994.3,Cloudy
10/8/2023 6:00,21,58,22131,45882,79,68013,SUNDAY,1,0,12.8,87,18.4,994.8,Cloudy
10/8/2023 7:00,45,97,221450,70580,142,292030,SUNDAY,1,0,12.8,87,29.5,994.8,Cloudy
10/8/2023 8:00,110,232,226235,189411,342,415646,SUNDAY,1,0,12.2,83,33.5,995.2,Cloudy
10/8/2023 9:00,186,350,662468,1256869,536,1919337,SUNDAY,1,0,11.7,80,22.3,996.9,Cloudy
10/8/2023 10:00,268,488,509353,426154,756,935507,SUNDAY,1,0,11.1,80,24.1,997.6,Cloudy
10/8/2023 11:00,410,530,1158553,510492,940,1669045,SUNDAY,1,0,11.7,77,29.5,999.1,Fair
10/8/2023 12:00,531,622,3111540,641023,1153,3752563,SUNDAY,1,0,13.3,67,29.5,999.7,Fair
10/8/2023 13:00,566,603,1409540,637401,1169,2046941,SUNDAY,1,0,13.3,67,35.3,999.7,Fair
10/8/2023 14:00,567,635,5247911,636454,1202,5884365,SUNDAY,1,0,15,58,29.5,1000.3,Fair
10/8/2023 15:00,602,679,1862907,776479,1281,2639386,SUNDAY,1,0,16.1,52,18.4,1000.4,Fair
10/8/2023 16:00,563,689,5442790,684902,1252,6127692,SUNDAY,1,0,17.2,48,25.9,1000.5,Fair
10/8/2023 17:00,560,726,3845967,697893,1286,4543860,SUNDAY,1,0,17.8,48,16.6,1000.3,Fair
10/8/2023 18:00,384,667,3282914,535813,1051,3818727,SUNDAY,1,0,17.8,48,16.6,1000.3,Fair
10/8/2023 19:00,248,441,1128151,355203,689,1483354,SUNDAY,1,0,17.8,48,18.4,1000.9,Fair
10/8/2023 20:00,185,325,644388,304962,510,949350,SUNDAY,1,0,17.8,46,24.1,1001.3,Fair
10/8/2023 21:00,157,273,992851,280282,430,1273133,SUNDAY,1,0,16.7,52,24.1,1002,Fair
10/8/2023 22:00,115,183,285327,130764,298,416091,SUNDAY,1,0,16.7,52,24.1,1002,Fair
10/8/2023 23:00,87,119,129086,73502,206,202588,SUNDAY,1,0,13.9,62,16.6,1003.4,Fair
10/9/2023 0:00,57,87,378203,86561,144,464764,MONDAY,0,1,13.3,64,22.3,1004.2,Fair
10/9/2023 1:00,51,46,459559,32501,97,492060,MONDAY,0,1,13.3,64,20.5,1004.7,Fair
10/9/2023 2:00,21,23,57859,14017,44,71876,MONDAY,0,1,13.3,64,20.5,1004.7,Fair
10/9/2023 3:00,13,14,44230,18548,27,62778,MONDAY,0,1,11.7,66,18.4,1005.2,Fair
10/9/2023 4:00,5,16,5265,12335,21,17600,MONDAY,0,1,11.1,69,16.6,1005.1,Fair
10/9/2023 5:00,8,49,6641,29864,57,36505,MONDAY,0,1,11.1,71,14.8,1005.3,Fair
10/9/2023 6:00,22,124,30623,85203,146,115826,MONDAY,0,1,10.6,71,14.8,1005.4,Fair
10/9/2023 7:00,58,329,177502,234608,387,412110,MONDAY,0,1,10.6,71,14.8,1005.4,Fair
10/9/2023 8:00,108,502,147728,397503,610,545231,MONDAY,0,1,9.4,74,14.8,1006.2,Fair
10/9/2023 9:00,126,451,257780,376383,577,634163,MONDAY,0,1,9.4,74,16.6,1006.5,Fair
10/9/2023 10:00,209,430,371354,991948,639,1363302,MONDAY,0,1,8.9,77,13,1006.8,Cloudy
10/9/2023 11:00,255,456,2097492,336854,711,2434346,MONDAY,0,1,8.9,77,13,1006.8,Fair
10/9/2023 12:00,324,525,960755,411486,849,1372241,MONDAY,0,1,11.1,69,16.6,1007.9,Fair
10/9/2023 13:00,312,547,3075761,458912,859,3534673,MONDAY,0,1,11.7,69,11.2,1008.1,Fair
10/9/2023 14:00,358,584,1050257,1276898,942,2327155,MONDAY,0,1,13.9,57,18.4,1007.7,Fair
10/9/2023 15:00,375,657,701111,567231,1032,1268342,MONDAY,0,1,15,51,18.4,1007.6,Fair
10/9/2023 16:00,393,758,2029170,637579,1151,2666749,MONDAY,0,1,15,51,25.9,1007.6,Fair
10/9/2023 17:00,400,978,752853,1121885,1378,1874738,MONDAY,0,1,16.1,44,18.4,1006.6,Cloudy
10/9/2023 18:00,317,861,476989,682823,1178,1159812,MONDAY,0,1,16.7,43,22.3,1006.3,Cloudy
10/9/2023 19:00,212,598,280090,412659,810,692749,MONDAY,0,1,16.1,46,16.6,1006.3,Fair
10/9/2023 20:00,144,404,1031914,1208082,548,2239996,MONDAY,0,1,16.1,44,14.8,1006.5,Fair
10/9/2023 21:00,133,313,229297,279746,446,509043,MONDAY,0,1,16.1,44,14.8,1006.5,Fair
10/9/2023 22:00,85,213,667534,156417,298,823951,MONDAY,0,1,13.9,53,20.5,1007.3,Fair
10/9/2023 23:00,34,143,60028,93083,177,153111,MONDAY,0,1,13.3,55,18.4,1007.9,Fair
10/10/2023 0:00,38,66,106849,43528,104,150377,TUESDAY,0,0,12.8,57,22.3,1008.5,Fair
10/10/2023 1:00,19,21,43744,11831,40,55575,TUESDAY,0,0,12.8,57,22.3,1008.5,Fair
10/10/2023 2:00,4,10,7465,5715,14,13180,TUESDAY,0,0,12.2,61,18.4,1009.1,Fair
10/10/2023 3:00,1,7,2382,5935,8,8317,TUESDAY,0,0,12.2,64,16.6,1009.3,Fair
10/10/2023 4:00,5,11,3828,6877,16,10705,TUESDAY,0,0,11.7,66,16.6,1009.4,Fair
10/10/2023 5:00,15,81,15504,52358,96,67862,TUESDAY,0,0,10.6,71,18.4,1009.5,Fair
10/10/2023 6:00,50,256,38655,301035,306,339690,TUESDAY,0,0,10,74,18.4,1009.6,Fair
10/10/2023 7:00,95,749,123143,730488,844,853631,TUESDAY,0,0,9.4,74,14.8,1009.7,Fair
10/10/2023 8:00,199,1194,210472,1040566,1393,1251038,TUESDAY,0,0,9.4,74,14.8,1009.7,Fair
10/10/2023 9:00,135,667,160320,508816,802,669136,TUESDAY,0,0,9.4,74,14.8,1010.2,Fair
10/10/2023 10:00,101,435,2248801,321904,536,2570705,TUESDAY,0,0,11.1,69,0,1010.4,Cloudy
10/10/2023 11:00,143,459,208618,354899,602,563517,TUESDAY,0,0,11.1,71,5.4,1010.6,Fair
10/10/2023 12:00,168,524,3007181,364228,692,3371409,TUESDAY,0,0,11.1,71,5.4,1010.6,Fair
10/10/2023 13:00,190,496,701279,371185,686,1072464,TUESDAY,0,0,11.7,71,11.2,1010.8,Cloudy
10/10/2023 14:00,215,550,367711,998987,765,1366698,TUESDAY,0,0,15,60,20.5,1010.4,Cloudy
10/10/2023 15:00,245,703,2958269,668020,948,3626289,TUESDAY,0,0,15.6,69,14.8,1009.9,Cloudy
10/10/2023 16:00,325,999,5070507,798791,1324,5869298,TUESDAY,0,0,16.1,72,13,1009,Cloudy
10/10/2023 17:00,492,1511,791422,1432197,2003,2223619,TUESDAY,0,0,16.7,65,13,1008.4,Cloudy
10/10/2023 18:00,381,1161,507630,922203,1542,1429833,TUESDAY,0,0,16.7,65,13,1008.4,Cloudy
10/10/2023 19:00,202,749,236429,569455,951,805884,TUESDAY,0,0,17.8,52,16.6,1008.2,Cloudy
10/10/2023 20:00,184,541,291397,425864,725,717261,TUESDAY,0,0,17.8,52,16.6,1008.2,Cloudy
10/10/2023 21:00,136,367,1302034,342115,503,1644149,TUESDAY,0,0,16.7,48,13,1009.1,Cloudy
10/10/2023 22:00,86,238,272801,159301,324,432102,TUESDAY,0,0,16.7,52,9.4,1009.6,Cloudy
10/10/2023 23:00,64,131,85993,89647,195,175640,TUESDAY,0,0,15,72,11.2,1010.1,Fair
10/11/2023 0:00,26,70,49942,65250,96,115192,WEDNESDAY,0,0,15,72,11.2,1010.1,Fair
10/11/2023 1:00,14,21,35461,15790,35,51251,WEDNESDAY,0,0,13.9,69,18.4,1010.6,Fair
10/11/2023 2:00,6,16,22142,8905,22,31047,WEDNESDAY,0,0,13.9,69,18.4,1010.6,Fair
10/11/2023 3:00,1,4,1269,3474,5,4743,WEDNESDAY,0,0,12.8,74,13,1010.7,Fair
10/11/2023 4:00,2,14,1522,9658,16,11180,WEDNESDAY,0,0,11.7,80,13,1010.8,Clear
10/11/2023 5:00,22,92,14993,57823,114,72816,WEDNESDAY,0,0,11.1,83,9.4,1010.8,Clear
10/11/2023 6:00,42,268,39000,255345,310,294345,WEDNESDAY,0,0,11.7,86,5.4,1010.4,Clear
10/11/2023 7:00,114,807,136885,756205,921,893090,WEDNESDAY,0,0,10.6,89,9.4,1010.5,Fair
10/11/2023 8:00,206,1376,254480,3254544,1582,3509024,WEDNESDAY,0,0,10.6,89,9.4,1010.5,Fair
10/11/2023 9:00,107,799,142164,629391,906,771555,WEDNESDAY,0,0,11.1,89,7.6,1011,Fair
10/11/2023 10:00,128,495,182596,363112,623,545708,WEDNESDAY,0,0,12.2,86,7.6,1011.3,Fair
10/11/2023 11:00,153,534,236337,439525,687,675862,WEDNESDAY,0,0,12.2,86,7.6,1011.8,Cloudy
10/11/2023 12:00,183,566,251468,439323,749,690791,WEDNESDAY,0,0,13.3,84,7.6,1012.1,Cloudy
10/11/2023 13:00,197,538,2723713,417681,735,3141394,WEDNESDAY,0,0,13.3,84,7.6,1012.1,Cloudy
10/11/2023 14:00,194,628,1687247,815726,822,2502973,WEDNESDAY,0,0,17.8,65,11.2,1012,Cloudy
10/11/2023 15:00,232,655,686836,674192,887,1361028,WEDNESDAY,0,0,18.9,47,14.8,1011.6,Cloudy
10/11/2023 16:00,351,1142,3803236,1008459,1493,4811695,WEDNESDAY,0,0,18.3,50,13,1011,Cloudy
10/11/2023 17:00,428,1457,1436157,1355270,1885,2791427,WEDNESDAY,0,0,18.9,49,22.3,1010.3,Cloudy
10/11/2023 18:00,324,1165,2703192,1013210,1489,3716402,WEDNESDAY,0,0,18.9,49,22.3,1010.3,Cloudy
10/11/2023 19:00,210,771,283701,663297,981,946998,WEDNESDAY,0,0,18.9,52,14.8,1009.9,Cloudy
10/11/2023 20:00,130,560,1452266,487343,690,1939609,WEDNESDAY,0,0,18.3,54,14.8,1009.8,Cloudy
10/11/2023 21:00,119,421,347108,352271,540,699379,WEDNESDAY,0,0,17.2,63,16.6,1010,Cloudy
10/11/2023 22:00,96,299,286151,472577,395,758728,WEDNESDAY,0,0,16.7,67,14.8,1010.5,Cloudy
10/11/2023 23:00,47,156,73215,120293,203,193508,WEDNESDAY,0,0,16.7,67,14.8,1010.5,Cloudy
10/12/2023 0:00,27,73,30009,42685,100,72694,THURSDAY,0,0,16.1,75,14.8,1010.9,Cloudy
10/12/2023 1:00,15,28,10121,22102,43,32223,THURSDAY,0,0,16.1,75,18.4,1011.5,Fair
10/12/2023 2:00,9,23,35299,19588,32,54887,THURSDAY,0,0,16.1,75,18.4,1011.5,Fair
10/12/2023 3:00,7,11,836211,3829,18,840040,THURSDAY,0,0,16.1,70,11.2,1011.8,Fair
10/12/2023 4:00,3,16,19059,11493,19,30552,THURSDAY,0,0,15.6,64,11.2,1011.7,Fair
10/12/2023 5:00,15,81,11730,51679,96,63409,THURSDAY,0,0,14.4,67,11.2,1012,Fair
10/12/2023 6:00,41,236,39114,195517,277,234631,THURSDAY,0,0,13.9,67,5.4,1012.1,Fair
10/12/2023 7:00,112,737,107891,573391,849,681282,THURSDAY,0,0,12.2,75,0,1011.8,Fair
10/12/2023 8:00,166,1384,157705,1818854,1550,1976559,THURSDAY,0,0,12.2,75,5.4,1012,Fair
10/12/2023 9:00,130,779,195638,617115,909,812753,THURSDAY,0,0,12.8,74,0,1012.1,Fair
10/12/2023 10:00,122,488,1239523,363425,610,1602948,THURSDAY,0,0,12.8,77,0,1012.4,Fair
10/12/2023 11:00,135,495,405417,372376,630,777793,THURSDAY,0,0,14.4,70,0,1012.6,Fair
10/12/2023 12:00,163,576,326123,599147,739,925270,THURSDAY,0,0,14.4,70,0,1012.6,Fair
10/12/2023 13:00,181,560,757298,722634,741,1479932,THURSDAY,0,0,17.2,52,7.6,1012.5,Fair
10/12/2023 14:00,205,608,459583,598981,813,1058564,THURSDAY,0,0,18.3,48,7.6,1012.2,Fair
10/12/2023 15:00,262,677,431935,611738,939,1043673,THURSDAY,0,0,18.3,52,11.2,1011.8,Fair
10/12/2023 16:00,317,1094,471148,1056708,1411,1527856,THURSDAY,0,0,18.3,52,11.2,1011.8,Fair
10/12/2023 17:00,436,1514,565374,1729663,1950,2295037,THURSDAY,0,0,20.6,42,13,1010.6,Fair
10/12/2023 18:00,297,1134,1883067,1384707,1431,3267774,THURSDAY,0,0,17.8,65,13,1010.5,Fair
10/12/2023 19:00,196,760,1242296,601706,956,1844002,THURSDAY,0,0,16.7,70,16.6,1010.1,Fair
10/12/2023 20:00,155,540,1381002,395441,695,1776443,THURSDAY,0,0,16.7,72,13,1010,Fair
10/12/2023 21:00,114,424,179130,345074,538,524204,THURSDAY,0,0,16.7,72,13,1010,Fair
10/12/2023 22:00,127,296,372213,1672511,423,2044724,THURSDAY,0,0,16.1,75,7.6,1010.4,Cloudy
10/12/2023 23:00,89,191,96753,136776,280,233529,THURSDAY,0,0,16.1,75,7.6,1010.4,Cloudy
10/13/2023 0:00,46,86,592749,52288,132,645037,FRIDAY,0,0,16.7,67,9.4,1010.6,Cloudy
10/13/2023 1:00,34,45,70473,29185,79,99658,FRIDAY,0,0,15.6,67,14.8,1010.9,Fair
10/13/2023 2:00,14,30,19054,23555,44,42609,FRIDAY,0,0,15.6,67,14.8,1010.9,Fair
10/13/2023 3:00,5,13,3635,10870,18,14505,FRIDAY,0,0,15,62,16.6,1011,Fair
10/13/2023 4:00,8,15,17667,13197,23,30864,FRIDAY,0,0,14.4,65,11.2,1010.9,Fair
10/13/2023 5:00,16,82,219618,72215,98,291833,FRIDAY,0,0,12.2,69,22.3,1011.6,Fair
10/13/2023 6:00,35,185,67439,182095,220,249534,FRIDAY,0,0,12.2,69,22.3,1011.6,Fair
10/13/2023 7:00,84,551,79494,614083,635,693577,FRIDAY,0,0,10,74,14.8,1011.6,Fair
10/13/2023 8:00,139,948,180804,1713579,1087,1894383,FRIDAY,0,0,10,68,14.8,1012,Fair
10/13/2023 9:00,132,725,339085,553350,857,892435,FRIDAY,0,0,10,63,18.4,1012.3,Fair
10/13/2023 10:00,127,458,344882,1436681,585,1781563,FRIDAY,0,0,9.4,69,16.6,1012.5,Cloudy
10/13/2023 11:00,155,510,1030082,370614,665,1400696,FRIDAY,0,0,9.4,69,16.6,1012.5,Fair
10/13/2023 12:00,206,525,293096,379756,731,672852,FRIDAY,0,0,11.1,59,20.5,1012.6,Fair
10/13/2023 13:00,188,629,796939,485024,817,1281963,FRIDAY,0,0,12.2,57,20.5,1012.9,Fair
10/13/2023 14:00,285,617,3084316,764552,902,3848868,FRIDAY,0,0,13.3,55,25.9,1012.4,Fair
10/13/2023 15:00,317,739,2571840,585612,1056,3157452,FRIDAY,0,0,15,49,24.1,1012,Fair
10/13/2023 16:00,396,979,3115986,933243,1375,4049229,FRIDAY,0,0,15,49,24.1,1012,Fair
10/13/2023 17:00,430,1168,2867722,2342263,1598,5209985,FRIDAY,0,0,16.7,46,27.7,1011.4,Fair
10/13/2023 18:00,314,923,566055,859354,1237,1425409,FRIDAY,0,0,17.2,43,25.9,1011.7,Fair
10/13/2023 19:00,245,686,1401247,554458,931,1955705,FRIDAY,0,0,17.2,43,25.9,1011.7,Fair
10/13/2023 20:00,139,493,145685,370521,632,516206,FRIDAY,0,0,16.7,46,29.5,1011.5,Fair
10/13/2023 21:00,165,388,375368,317723,553,693091,FRIDAY,0,0,15,47,24.1,1012.1,Fair
10/13/2023 22:00,151,302,2051478,215520,453,2266998,FRIDAY,0,0,14.4,53,20.5,1012.4,Fair
10/13/2023 23:00,136,236,520874,175416,372,696290,FRIDAY,0,0,13.3,57,14.8,1012.7,Fair
10/14/2023 0:00,99,186,387852,191769,285,579621,SATURDAY,1,0,13.3,57,16.6,1013.1,Fair
10/14/2023 1:00,128,117,2001143,95449,245,2096592,SATURDAY,1,0,13.3,57,16.6,1013.1,Fair
10/14/2023 2:00,80,75,136113,62482,155,198595,SATURDAY,1,0,11.7,64,16.6,1012.5,Fair
10/14/2023 3:00,15,26,15565,18659,41,34224,SATURDAY,1,0,11.7,64,20.5,1012.4,Fair
10/14/2023 4:00,6,16,5028,10416,22,15444,SATURDAY,1,0,11.7,64,20.5,1012.3,Fair
10/14/2023 5:00,12,34,18402,55133,46,73535,SATURDAY,1,0,11.1,63,20.5,1012,Fair
10/14/2023 6:00,12,66,26327,70426,78,96753,SATURDAY,1,0,11.1,63,24.1,1012,Clear
10/14/2023 7:00,47,123,74845,114896,170,189741,SATURDAY,1,0,10,71,14.8,1011.2,Fair
10/14/2023 8:00,83,252,177073,199405,335,376478,SATURDAY,1,0,10,71,16.6,1010.6,Fair
10/14/2023 9:00,184,409,295389,361927,593,657316,SATURDAY,1,0,10,71,18.4,1010.9,Fair
10/14/2023 10:00,277,481,626239,401783,758,1028022,SATURDAY,1,0,10,71,18.4,1010.8,Cloudy
10/14/2023 11:00,323,550,699447,839112,873,1538559,SATURDAY,1,0,10,71,22.3,1010.8,Cloudy
10/14/2023 12:00,427,643,801690,528848,1070,1330538,SATURDAY,1,0,11.7,66,16.6,1010.8,Cloudy
10/14/2023 13:00,427,683,2784482,793862,1110,3578344,SATURDAY,1,0,13.3,62,22.3,1010,Cloudy
10/14/2023 14:00,452,636,861142,641443,1088,1502585,SATURDAY,1,0,15,55,20.5,1009.2,Cloudy
10/14/2023 15:00,439,566,1105852,833961,1005,1939813,SATURDAY,1,0,15,55,20.5,1009.2,Cloudy
10/14/2023 16:00,372,629,2604277,610522,1001,3214799,SATURDAY,1,0,15.6,55,13,1007.4,Cloudy
10/14/2023 17:00,410,662,1293014,553458,1072,1846472,SATURDAY,1,0,15,58,11.2,1006.5,Cloudy
10/14/2023 18:00,263,616,4949963,1013151,879,5963114,SATURDAY,1,0,15,58,11.2,1006.5,Cloudy
10/14/2023 19:00,208,432,262650,326774,640,589424,SATURDAY,1,0,15,55,11.2,1005.5,Cloudy
10/14/2023 20:00,164,351,227800,258435,515,486235,SATURDAY,1,0,15,55,11.2,1005.5,Cloudy
10/14/2023 21:00,175,306,410133,221220,481,631353,SATURDAY,1,0,14.4,60,14.8,1005.8,Cloudy
10/14/2023 22:00,157,256,1552534,214247,413,1766781,SATURDAY,1,0,13.9,62,13,1005,Cloudy
10/14/2023 23:00,134,208,1445933,150982,342,1596915,SATURDAY,1,0,13.3,64,9.4,1004.5,Cloudy
10/15/2023 0:00,132,143,327695,112457,275,440152,SUNDAY,1,0,13.3,64,9.4,1003.8,Cloudy
10/15/2023 1:00,136,122,215184,92609,258,307793,SUNDAY,1,0,13.3,64,9.4,1003.8,Cloudy
10/15/2023 2:00,74,60,182518,40588,134,223106,SUNDAY,1,0,12.8,69,9.4,1003.2,Cloudy
10/15/2023 3:00,18,14,18523,12869,32,31392,SUNDAY,1,0,12.2,69,9.4,1001.9,Cloudy
10/15/2023 4:00,9,12,11410,14726,21,26136,SUNDAY,1,0,12.2,69,11.2,1000.6,Cloudy
10/15/2023 5:00,14,23,15181,17649,37,32830,SUNDAY,1,0,11.7,69,13,1000.3,Cloudy
10/15/2023 6:00,12,44,10163,30372,56,40535,SUNDAY,1,0,11.7,69,13,1000.3,Cloudy
10/15/2023 7:00,35,110,107925,160545,145,268470,SUNDAY,1,0,10.6,77,16.6,998.3,Cloudy
10/15/2023 8:00,72,183,127655,149650,255,277305,SUNDAY,1,0,10.6,74,16.6,998.1,Cloudy
10/15/2023 9:00,161,367,291764,301395,528,593159,SUNDAY,1,0,10,74,13,997.9,Cloudy
10/15/2023 10:00,233,496,428777,398776,729,827553,SUNDAY,1,0,10,74,13,997.9,Cloudy
10/15/2023 11:00,299,548,2749809,546531,847,3296340,SUNDAY,1,0,10,77,22.3,997,Cloudy
10/15/2023 12:00,348,568,667619,472246,916,1139865,SUNDAY,1,0,10.6,74,20.5,996.8,Cloudy
10/15/2023 13:00,404,621,5286333,537456,1025,5823789,SUNDAY,1,0,11.7,66,20.5,996.8,Cloudy
10/15/2023 14:00,369,661,658212,1091649,1030,1749861,SUNDAY,1,0,12.8,62,20.5,996.6,Cloudy
10/15/2023 15:00,380,654,2279712,590152,1034,2869864,SUNDAY,1,0,12.8,62,20.5,996.6,Cloudy
10/15/2023 16:00,343,661,1252598,552950,1004,1805548,SUNDAY,1,0,15,53,13,995.9,Cloudy
10/15/2023 17:00,296,698,1432651,946620,994,2379271,SUNDAY,1,0,15.6,51,11.2,995.6,Cloudy
10/15/2023 18:00,235,565,1414925,956984,800,2371909,SUNDAY,1,0,15,49,11.2,995.9,Cloudy
10/15/2023 19:00,167,402,244107,282821,569,526928,SUNDAY,1,0,15,49,16.6,996,Cloudy
10/15/2023 20:00,100,305,2352681,328071,405,2680752,SUNDAY,1,0,15,49,16.6,996,Cloudy
10/15/2023 21:00,98,222,210854,149970,320,360824,SUNDAY,1,0,14.4,47,24.1,996.8,Cloudy
10/15/2023 22:00,72,184,149591,172129,256,321720,SUNDAY,1,0,12.8,55,18.4,997.2,Cloudy
10/15/2023 23:00,47,104,57724,61891,151,119615,SUNDAY,1,0,12.2,59,18.4,997.5,Cloudy
10/16/2023 0:00,28,45,672764,24814,73,697578,MONDAY,0,0,12.2,59,18.4,997.5,Cloudy
10/16/2023 1:00,9,28,8786,36313,37,45099,MONDAY,0,0,11.1,63,20.5,998.1,Cloudy
10/16/2023 2:00,4,7,3125,4117,11,7242,MONDAY,0,0,11.1,63,20.5,998.1,Cloudy
10/16/2023 3:00,1,4,2770,1541,5,4311,MONDAY,0,0,11.1,66,18.4,997.8,Cloudy
10/16/2023 4:00,2,18,1834,14024,20,15858,MONDAY,0,0,10,71,18.4,997.4,Fair
10/16/2023 5:00,10,82,6481,61401,92,67882,MONDAY,0,0,10,71,18.4,997.4,Cloudy
10/16/2023 6:00,23,177,191514,130812,200,322326,MONDAY,0,0,9.4,83,14.8,997.7,Cloudy
10/16/2023 7:00,63,506,142984,437540,569,580524,MONDAY,0,0,9.4,90,13,997.7,Cloudy
10/16/2023 8:00,134,1076,163318,1487788,1210,1651106,MONDAY,0,0,10,86,14.8,997.9,Cloudy
10/16/2023 9:00,97,648,137366,498041,745,635407,MONDAY,0,0,10,86,14.8,997.9,Cloudy
10/16/2023 10:00,106,395,219767,273227,501,492994,MONDAY,0,0,10.6,83,16.6,998.3,Cloudy
10/16/2023 11:00,131,468,359196,312319,599,671515,MONDAY,0,0,10.6,86,14.8,998.9,Rain
10/16/2023 12:00,138,465,714172,391228,603,1105400,MONDAY,0,0,11.7,80,16.6,999.3,Rain
10/16/2023 13:00,87,424,934066,273479,511,1207545,MONDAY,0,0,12.2,75,16.6,999.6,Rain
10/16/2023 14:00,169,476,1965841,335380,645,2301221,MONDAY,0,0,12.2,75,16.6,999.6,Rain
10/16/2023 15:00,142,600,236683,437743,742,674426,MONDAY,0,0,13.9,62,16.6,1000.3,Rain
10/16/2023 16:00,161,873,1161954,993162,1034,2155116,MONDAY,0,0,14.4,62,11.2,1000.4,Cloudy
10/16/2023 17:00,163,817,979441,779602,980,1759043,MONDAY,0,0,12.8,72,11.2,1000.8,Cloudy
10/16/2023 18:00,121,660,571734,501072,781,1072806,MONDAY,0,0,14.4,65,7.6,1001,Cloudy
10/16/2023 19:00,93,555,2091825,401497,648,2493322,MONDAY,0,0,14.4,65,7.6,1001,Cloudy
10/16/2023 20:00,66,426,64796,296849,492,361645,MONDAY,0,0,12.8,74,5.4,1002,Rain
10/16/2023 21:00,44,331,609857,250629,375,860486,MONDAY,0,0,12.8,80,18.4,1002.9,Rain
10/16/2023 22:00,51,181,56801,126509,232,183310,MONDAY,0,0,11.7,83,9.4,1003.7,Cloudy
10/16/2023 23:00,26,119,1049393,104287,145,1153680,MONDAY,0,0,11.1,86,13,1004.5,Cloudy
10/17/2023 0:00,29,63,381050,62800,92,443850,TUESDAY,0,0,11.1,86,13,1004.5,Cloudy
10/17/2023 1:00,11,24,1109680,13821,35,1123501,TUESDAY,0,0,11.7,86,11.2,1005.6,Cloudy
10/17/2023 2:00,8,13,6759,9404,21,16163,TUESDAY,0,0,11.7,86,11.2,1005.6,Cloudy
10/17/2023 3:00,1,7,692,5432,8,6124,TUESDAY,0,0,11.1,89,9.4,1006,Cloudy
10/17/2023 4:00,4,13,2647,8249,17,10896,TUESDAY,0,0,11.1,86,18.4,1006.2,Cloudy
10/17/2023 5:00,20,95,15228,60564,115,75792,TUESDAY,0,0,10.6,89,11.2,1006.5,Cloudy
10/17/2023 6:00,40,263,37142,236605,303,273747,TUESDAY,0,0,10.6,89,14.8,1007.5,Cloudy
10/17/2023 7:00,99,753,104833,702962,852,807795,TUESDAY,0,0,10.6,86,14.8,1007.8,Cloudy
10/17/2023 8:00,175,1363,232807,1320229,1538,1553036,TUESDAY,0,0,10.6,86,14.8,1007.8,Cloudy
10/17/2023 9:00,123,695,292756,672030,818,964786,TUESDAY,0,0,10,86,11.2,1008.7,Cloudy
10/17/2023 10:00,99,418,183959,321616,517,505575,TUESDAY,0,0,10,89,14.8,1009.3,Cloudy
10/17/2023 11:00,151,479,277055,343332,630,620387,TUESDAY,0,0,10,89,14.8,1009.3,Cloudy
10/17/2023 12:00,139,495,297448,425066,634,722514,TUESDAY,0,0,12.2,83,13,1011.3,Cloudy
10/17/2023 13:00,163,460,264196,1146622,623,1410818,TUESDAY,0,0,12.8,80,9.4,1011.9,Cloudy
10/17/2023 14:00,172,523,336930,591573,695,928503,TUESDAY,0,0,13.9,74,7.6,1012.2,Cloudy
10/17/2023 15:00,185,654,479728,553290,839,1033018,TUESDAY,0,0,14.4,70,11.2,1012.4,Cloudy
10/17/2023 16:00,261,1062,1028667,1195129,1323,2223796,TUESDAY,0,0,14.4,70,11.2,1012.4,Cloudy
10/17/2023 17:00,275,1153,316065,1005358,1428,1321423,TUESDAY,0,0,13.9,72,14.8,1012.6,Cloudy
10/17/2023 18:00,192,973,469232,844605,1165,1313837,TUESDAY,0,0,13.3,80,13,1013.1,Cloudy
10/17/2023 19:00,115,744,350656,659899,859,1010555,TUESDAY,0,0,12.8,83,13,1013.5,Cloudy
10/17/2023 20:00,85,468,2086282,312641,553,2398923,TUESDAY,0,0,12.8,83,13,1013.5,Cloudy
10/17/2023 21:00,74,344,196414,285966,418,482380,TUESDAY,0,0,12.8,77,0,1014.7,Cloudy
10/17/2023 22:00,71,274,74042,214055,345,288097,TUESDAY,0,0,12.8,77,7.6,1015.3,Cloudy
10/17/2023 23:00,53,133,70280,96250,186,166530,TUESDAY,0,0,12.8,80,7.6,1015.9,Cloudy
10/18/2023 0:00,12,49,405595,33743,61,439338,WEDNESDAY,0,0,12.8,80,7.6,1015.9,Cloudy
10/18/2023 1:00,10,23,9981,13026,33,23007,WEDNESDAY,0,0,12.2,83,11.2,1016.5,Cloudy
10/18/2023 2:00,3,12,1320,9101,15,10421,WEDNESDAY,0,0,11.1,89,11.2,1017.1,Cloudy
10/18/2023 3:00,2,7,2586,4957,9,7543,WEDNESDAY,0,0,10.6,89,7.6,1017.3,Cloudy
10/18/2023 4:00,4,17,2059,14749,21,16808,WEDNESDAY,0,0,10.6,89,5.4,1018.3,Fair
10/18/2023 5:00,19,102,9886,83623,121,93509,WEDNESDAY,0,0,10.6,92,9.4,1018.5,Fair
10/18/2023 6:00,30,263,23085,267278,293,290363,WEDNESDAY,0,0,10.6,92,9.4,1018.5,Fair
10/18/2023 7:00,126,731,115415,1408470,857,1523885,WEDNESDAY,0,0,10.6,92,7.6,1018.7,Fair
10/18/2023 8:00,169,1343,228223,1093787,1512,1322010,WEDNESDAY,0,0,10.6,92,7.6,1019,Fair
10/18/2023 9:00,128,772,161540,2606182,900,2767722,WEDNESDAY,0,0,11.7,86,5.4,1019.8,Fair
10/18/2023 10:00,129,475,204141,396238,604,600379,WEDNESDAY,0,0,11.7,80,7.6,1020.2,Cloudy
10/18/2023 11:00,127,531,229214,388518,658,617732,WEDNESDAY,0,0,11.7,80,7.6,1020.2,Cloudy
10/18/2023 12:00,142,516,493175,632486,658,1125661,WEDNESDAY,0,0,13.3,75,0,1021,Cloudy
10/18/2023 13:00,152,565,282128,416253,717,698381,WEDNESDAY,0,0,14.4,70,5.4,1021.4,Cloudy
10/18/2023 14:00,149,559,658793,495713,708,1154506,WEDNESDAY,0,0,13.9,77,9.4,1021.6,Cloudy
10/18/2023 15:00,229,595,570923,851012,824,1421935,WEDNESDAY,0,0,13.9,77,9.4,1021.6,Cloudy
10/18/2023 16:00,273,1101,1170620,1063184,1374,2233804,WEDNESDAY,0,0,15,72,11.2,1021.1,Cloudy
10/18/2023 17:00,388,1496,1487363,1931723,1884,3419086,WEDNESDAY,0,0,15.6,67,14.8,1020.8,Cloudy
10/18/2023 18:00,259,1079,284003,1708046,1338,1992049,WEDNESDAY,0,0,16.1,62,13,1020.4,Cloudy
10/18/2023 19:00,168,701,1265552,558894,869,1824446,WEDNESDAY,0,0,16.1,65,13,1020.4,Cloudy
10/18/2023 20:00,101,514,216155,551117,615,767272,WEDNESDAY,0,0,16.1,65,13,1020.4,Cloudy
10/18/2023 21:00,92,398,147161,399460,490,546621,WEDNESDAY,0,0,14.4,75,14.8,1020.6,Cloudy
10/18/2023 22:00,88,259,783183,188723,347,971906,WEDNESDAY,0,0,13.9,83,9.4,1020.9,Cloudy
10/18/2023 23:00,45,181,76971,161283,226,238254,WEDNESDAY,0,0,14.4,78,11.2,1020.8,Cloudy
10/19/2023 0:00,25,70,24933,43535,95,68468,THURSDAY,0,0,14.4,70,11.2,1021.3,Cloudy
10/19/2023 1:00,18,37,16773,22234,55,39007,THURSDAY,0,0,14.4,70,11.2,1021.3,Fair
10/19/2023 2:00,6,24,5545,24610,30,30155,THURSDAY,0,0,13.3,77,13,1021.5,Fair
10/19/2023 3:00,5,9,1083510,7183,14,1090693,THURSDAY,0,0,13.3,80,11.2,1021.3,Fair
10/19/2023 4:00,2,17,2239,644837,19,647076,THURSDAY,0,0,13.3,80,11.2,1021.3,Fair
10/19/2023 5:00,11,78,6890,55274,89,62164,THURSDAY,0,0,12.2,83,9.4,1021.2,Fair
10/19/2023 6:00,46,260,40683,970301,306,1010984,THURSDAY,0,0,12.2,83,14.8,1021.1,Fair
10/19/2023 7:00,110,663,111961,542856,773,654817,THURSDAY,0,0,12.2,83,9.4,1021,Fair
10/19/2023 8:00,211,1401,209642,1147551,1612,1357193,THURSDAY,0,0,12.2,86,9.4,1021.3,Fair
10/19/2023 9:00,128,776,181289,608505,904,789794,THURSDAY,0,0,12.2,86,13,1021.3,Fair
10/19/2023 10:00,135,478,431055,341699,613,772754,THURSDAY,0,0,12.2,86,13,1021.3,Cloudy
10/19/2023 11:00,136,482,346743,350669,618,697412,THURSDAY,0,0,12.8,87,16.6,1021.9,Fair
10/19/2023 12:00,168,555,822792,444773,723,1267565,THURSDAY,0,0,13.9,81,16.6,1022,Fair
10/19/2023 13:00,242,537,455611,445825,779,901436,THURSDAY,0,0,16.1,70,16.6,1022,Fair
10/19/2023 14:00,215,593,431961,471121,808,903082,THURSDAY,0,0,16.7,65,16.6,1021.5,Fair
10/19/2023 15:00,308,738,690428,855000,1046,1545428,THURSDAY,0,0,16.7,65,16.6,1021.5,Fair
10/19/2023 16:00,344,1124,545128,901390,1468,1446518,THURSDAY,0,0,17.2,56,20.5,1019.8,Fair
10/19/2023 17:00,451,1464,4290478,1319108,1915,5609586,THURSDAY,0,0,17.8,54,20.5,1019,Fair
10/19/2023 18:00,335,1120,1553113,960649,1455,2513762,THURSDAY,0,0,17.8,56,25.9,1018.4,Fair
10/19/2023 19:00,222,813,252918,1210528,1035,1463446,THURSDAY,0,0,17.8,56,25.9,1018.4,Fair
10/19/2023 20:00,163,558,824095,409907,721,1234002,THURSDAY,0,0,16.7,60,27.7,1017.9,Fair
10/19/2023 21:00,129,418,182974,314571,547,497545,THURSDAY,0,0,15,67,25.9,1018.1,Fair
10/19/2023 22:00,81,279,1429457,227046,360,1656503,THURSDAY,0,0,14.4,70,22.3,1018.5,Cloudy
10/19/2023 23:00,89,206,169661,229216,295,398877,THURSDAY,0,0,13.3,75,14.8,1018.5,Fair
10/20/2023 0:00,50,95,618950,80064,145,699014,FRIDAY,0,0,13.3,75,14.8,1018.5,Fair
10/20/2023 1:00,32,63,55498,41232,95,96730,FRIDAY,0,0,12.2,86,16.6,1017.8,Fair
10/20/2023 2:00,25,15,228820,10328,40,239148,FRIDAY,0,0,12.2,86,16.6,1017.8,Fair
10/20/2023 3:00,7,8,665713,5877,15,671590,FRIDAY,0,0,11.7,89,13,1017.4,Cloudy
10/20/2023 4:00,7,15,5942,13823,22,19765,FRIDAY,0,0,11.7,93,7.6,1017.2,Cloudy
10/20/2023 5:00,18,79,13269,69447,97,82716,FRIDAY,0,0,11.7,93,7.6,1017.2,Cloudy
10/20/2023 6:00,33,201,42548,201740,234,244288,FRIDAY,0,0,11.1,93,11.2,1015.9,Cloudy
10/20/2023 7:00,88,507,124900,417390,595,542290,FRIDAY,0,0,10.6,96,9.4,1015.1,Cloudy
10/20/2023 8:00,173,962,234981,725378,1135,960359,FRIDAY,0,0,10.6,96,11.2,1014.8,Cloudy
10/20/2023 9:00,169,725,426506,505368,894,931874,FRIDAY,0,0,11.1,97,13,1014.8,Cloudy
10/20/2023 10:00,206,467,493367,1031219,673,1524586,FRIDAY,0,0,11.1,97,13,1014.8,Cloudy
10/20/2023 11:00,204,475,476401,351163,679,827564,FRIDAY,0,0,12.2,100,9.4,1013.5,Cloudy
10/20/2023 12:00,284,548,504330,681313,832,1185643,FRIDAY,0,0,13.3,97,13,1013.3,Cloudy
10/20/2023 13:00,283,614,548497,460734,897,1009231,FRIDAY,0,0,13.3,97,13,1013.3,Cloudy
10/20/2023 14:00,289,648,1443178,652632,937,2095810,FRIDAY,0,0,15,93,14.8,1013,Cloudy
10/20/2023 15:00,346,779,2713270,607449,1125,3320719,FRIDAY,0,0,16.1,87,9.4,1011.3,Cloudy
10/20/2023 16:00,463,933,1990892,960581,1396,2951473,FRIDAY,0,0,16.1,87,9.4,1010.2,Cloudy
10/20/2023 17:00,463,1194,4059028,1790366,1657,5849394,FRIDAY,0,0,17.8,78,14.8,1009.1,Rain
10/20/2023 18:00,320,849,1491367,1163527,1169,2654894,FRIDAY,0,0,17.8,75,16.6,1007.7,Cloudy
10/20/2023 19:00,157,521,2048379,562419,678,2610798,FRIDAY,0,0,17.8,75,16.6,1007.7,Cloudy
10/20/2023 20:00,166,394,899778,424321,560,1324099,FRIDAY,0,0,16.1,90,13,1007.1,Cloudy
10/20/2023 21:00,158,333,202080,252520,491,454600,FRIDAY,0,0,15.6,93,14.8,1006.1,Cloudy
10/20/2023 22:00,163,279,3449448,221051,442,3670499,FRIDAY,0,0,15.6,96,9.4,1005.4,Cloudy
10/20/2023 23:00,191,244,921942,345892,435,1267834,FRIDAY,0,0,16.1,93,18.4,1004.6,Cloudy
10/21/2023 0:00,185,177,1062973,191819,362,1254792,SATURDAY,1,0,16.1,93,18.4,1004.6,Rain
10/21/2023 1:00,192,151,2579677,307504,343,2887181,SATURDAY,1,0,15,96,18.4,1002.5,Rain
10/21/2023 2:00,86,69,1570443,886300,155,2456743,SATURDAY,1,0,15,96,18.4,1002.5,Rain
10/21/2023 3:00,21,24,314243,22474,45,336717,SATURDAY,1,0,15,96,13,1001.1,Rain
10/21/2023 4:00,15,14,41422,10197,29,51619,SATURDAY,1,0,15.6,96,13,999.5,Rain
10/21/2023 5:00,12,28,11896,24460,40,36356,SATURDAY,1,0,15.6,93,11.2,998.6,Rain
10/21/2023 6:00,26,59,33883,40464,85,74347,SATURDAY,1,0,15,93,13,997.8,Cloudy
10/21/2023 7:00,49,109,785681,111300,158,896981,SATURDAY,1,0,15,96,13,995.4,Cloudy
10/21/2023 8:00,94,162,166654,109499,256,276153,SATURDAY,1,0,15,96,13,995.4,Cloudy
10/21/2023 9:00,81,228,96403,251204,309,347607,SATURDAY,1,0,13.9,100,7.6,994.8,Rain
10/21/2023 10:00,172,353,333952,480681,525,814633,SATURDAY,1,0,14.4,97,9.4,993.4,Rain
10/21/2023 11:00,243,443,1726817,704489,686,2431306,SATURDAY,1,0,15,96,9.4,993.1,Rain
10/21/2023 12:00,135,308,469529,346599,443,816128,SATURDAY,1,0,15,96,9.4,993.1,Rain
10/21/2023 13:00,120,249,888946,200964,369,1089910,SATURDAY,1,0,15,96,16.6,992.2,Rain
10/21/2023 14:00,85,208,125085,165529,293,290614,SATURDAY,1,0,15,96,16.6,991,Rain
10/21/2023 15:00,84,198,241503,144722,282,386225,SATURDAY,1,0,15,96,22.3,987.7,Rain
10/21/2023 16:00,46,122,111540,87429,168,198969,SATURDAY,1,0,15,96,22.3,987.7,Rain
10/21/2023 17:00,49,183,59263,147696,232,206959,SATURDAY,1,0,14.4,100,22.3,984.9,Rain
10/21/2023 18:00,58,187,751402,225684,245,977086,SATURDAY,1,0,14.4,97,20.5,984.2,Rain
10/21/2023 19:00,35,155,43005,112352,190,155357,SATURDAY,1,0,14.4,97,20.5,984.2,Rain
10/21/2023 20:00,43,116,94316,78272,159,172588,SATURDAY,1,0,14.4,97,14.8,983.8,Rain
10/21/2023 21:00,66,149,118996,103835,215,222831,SATURDAY,1,0,13.3,90,29.5,984,Rain
10/21/2023 22:00,74,173,100275,178973,247,279248,SATURDAY,1,0,13.3,93,20.5,985.1,Rain
10/21/2023 23:00,86,159,88070,136772,245,224842,SATURDAY,1,0,13.3,93,27.7,985.1,Rain
10/22/2023 0:00,127,135,516233,106402,262,622635,SUNDAY,1,0,13.3,93,24.1,986.2,Rain
10/22/2023 1:00,161,108,2107098,119873,269,2226971,SUNDAY,1,0,13.3,87,31.7,987.3,Rain
10/22/2023 2:00,71,70,128100,50072,141,178172,SUNDAY,1,0,13.3,87,31.7,987.3,Rain
10/22/2023 3:00,17,21,20465,14916,38,35381,SUNDAY,1,0,13.9,77,35.3,988.8,Cloudy
10/22/2023 4:00,9,10,10166,10922,19,21088,SUNDAY,1,0,13.9,77,42.5,988.8,Cloudy
10/22/2023 5:00,14,25,13194,21394,39,34588,SUNDAY,1,0,13.3,75,29.5,990.2,Cloudy
10/22/2023 6:00,19,43,28243,36905,62,65148,SUNDAY,1,0,13.3,72,25.9,991.1,Fair
10/22/2023 7:00,61,95,136977,77480,156,214457,SUNDAY,1,0,12.8,69,27.7,992.1,Fair
10/22/2023 8:00,96,210,248953,196398,306,445351,SUNDAY,1,0,11.7,74,25.9,993.2,Fair
10/22/2023 9:00,237,361,628139,315266,598,943405,SUNDAY,1,0,11.7,74,25.9,993.2,Fair
10/22/2023 10:00,351,541,820938,505695,892,1326633,SUNDAY,1,0,11.1,69,20.5,995,Cloudy
10/22/2023 11:00,396,604,2333832,522019,1000,2855851,SUNDAY,1,0,11.1,69,25.9,995.9,Fair
10/22/2023 12:00,486,695,2674835,702066,1181,3376901,SUNDAY,1,0,11.7,66,25.9,996.7,Fair
10/22/2023 13:00,530,718,1551489,730343,1248,2281832,SUNDAY,1,0,12.8,62,22.3,997.1,Fair
10/22/2023 14:00,504,640,1273773,633001,1144,1906774,SUNDAY,1,0,12.8,62,22.3,997.1,Fair
10/22/2023 15:00,488,732,2671053,774184,1220,3445237,SUNDAY,1,0,13.3,57,29.5,998.1,Fair
10/22/2023 16:00,440,607,1881244,559464,1047,2440708,SUNDAY,1,0,13.9,53,27.7,998.1,Fair
10/22/2023 17:00,343,640,998324,563052,983,1561376,SUNDAY,1,0,14.4,51,29.5,998.2,Cloudy
10/22/2023 18:00,216,616,492064,564540,832,1056604,SUNDAY,1,0,13.3,53,29.5,998.7,Cloudy
10/22/2023 19:00,143,417,1816569,297265,560,2113834,SUNDAY,1,0,13.3,53,29.5,998.7,Cloudy
10/22/2023 20:00,98,282,129326,212480,380,341806,SUNDAY,1,0,12.2,57,25.9,1001,Cloudy
10/22/2023 21:00,83,241,204204,166341,324,370545,SUNDAY,1,0,12.2,55,25.9,1002,Cloudy
10/22/2023 22:00,60,175,79650,159217,235,238867,SUNDAY,1,0,12.2,55,24.1,1002,Cloudy
10/22/2023 23:00,38,113,487765,67290,151,555055,SUNDAY,1,0,12.2,55,20.5,1002.9,Cloudy
10/23/2023 0:00,30,61,61791,679530,91,741321,MONDAY,0,0,11.1,59,22.3,1004.6,Cloudy
10/23/2023 1:00,13,24,12047,15034,37,27081,MONDAY,0,0,10.6,56,22.3,1005.6,Cloudy
10/23/2023 2:00,7,16,5202,10535,23,15737,MONDAY,0,0,10.6,56,27.7,1005.6,Cloudy
10/23/2023 3:00,2,8,2006,8149,10,10155,MONDAY,0,0,9.4,66,18.4,1006.8,Cloudy
10/23/2023 4:00,6,14,8674,12681,20,21355,MONDAY,0,0,9.4,66,18.4,1006.8,Cloudy
10/23/2023 5:00,12,73,8887,48206,85,57093,MONDAY,0,0,8.3,76,22.3,1008.4,Cloudy
10/23/2023 6:00,28,215,38168,162772,243,200940,MONDAY,0,0,8.3,80,18.4,1009.2,Cloudy
10/23/2023 7:00,72,610,98247,469322,682,567569,MONDAY,0,0,8.9,71,20.5,1010,Cloudy
10/23/2023 8:00,136,1156,622933,901480,1292,1524413,MONDAY,0,0,8.9,71,20.5,1010,Cloudy
10/23/2023 9:00,106,652,447677,495287,758,942964,MONDAY,0,0,8.9,73,20.5,1012.2,Cloudy
10/23/2023 10:00,126,437,737461,332765,563,1070226,MONDAY,0,0,8.9,73,16.6,1013.1,Cloudy
10/23/2023 11:00,139,438,262199,761354,577,1023553,MONDAY,0,0,8.9,77,20.5,1014.8,Cloudy
10/23/2023 12:00,131,455,248758,316689,586,565447,MONDAY,0,0,10.6,68,20.5,1016.3,Cloudy
10/23/2023 13:00,147,471,237242,346395,618,583637,MONDAY,0,0,10.6,68,22.3,1016.3,Cloudy
10/23/2023 14:00,175,567,746577,459926,742,1206503,MONDAY,0,0,13.3,60,18.4,1017.7,Cloudy
10/23/2023 15:00,192,628,1007983,551844,820,1559827,MONDAY,0,0,14.4,57,5.4,1018,Cloudy
10/23/2023 16:00,244,1024,314873,766401,1268,1081274,MONDAY,0,0,16.1,52,16.6,1018,Cloudy
10/23/2023 17:00,312,1310,386896,1114999,1622,1501895,MONDAY,0,0,16.7,52,14.8,1018.1,Cloudy
10/23/2023 18:00,186,992,2120783,739323,1178,2860106,MONDAY,0,0,16.7,52,14.8,1018.1,Cloudy
10/23/2023 19:00,128,677,160167,485912,805,646079,MONDAY,0,0,15.6,53,18.4,1019.1,Cloudy
10/23/2023 20:00,103,504,2819003,436217,607,3255220,MONDAY,0,0,14.4,56,22.3,1019.9,Cloudy
10/23/2023 21:00,77,288,182225,223043,365,405268,MONDAY,0,0,13.9,59,22.3,1020.9,Cloudy
10/23/2023 22:00,59,228,66794,157307,287,224101,MONDAY,0,0,12.8,62,22.3,1022.2,Cloudy
10/23/2023 23:00,35,111,31849,71313,146,103162,MONDAY,0,0,12.8,62,22.3,1022.2,Cloudy
10/24/2023 0:00,17,55,68305,40323,72,108628,TUESDAY,0,0,12.2,61,18.4,1024,Fair
10/24/2023 1:00,14,34,20505,45338,48,65843,TUESDAY,0,0,11.7,64,11.2,1024.6,Fair
10/24/2023 2:00,3,9,3167,6842,12,10009,TUESDAY,0,0,10.6,68,13,1025,Fair
10/24/2023 3:00,6,10,7412,4292,16,11704,TUESDAY,0,0,10,71,13,1025.2,Fair
10/24/2023 4:00,4,16,3312,10599,20,13911,TUESDAY,0,0,10,71,13,1025.2,Fair
10/24/2023 5:00,13,71,8888,54077,84,62965,TUESDAY,0,0,8.9,73,11.2,1025.9,Fair
10/24/2023 6:00,31,259,37759,239205,290,276964,TUESDAY,0,0,8.9,73,11.2,1026.4,Fair
10/24/2023 7:00,98,707,369955,656989,805,1026944,TUESDAY,0,0,8.3,74,7.6,1026.4,Fair
10/24/2023 8:00,180,1330,1134690,1048709,1510,2183399,TUESDAY,0,0,8.3,74,7.6,1026.4,Fair
10/24/2023 9:00,94,690,143552,1458511,784,1602063,TUESDAY,0,0,7.2,80,7.6,1027.7,Cloudy
10/24/2023 10:00,164,463,738458,868520,627,1606978,TUESDAY,0,0,7.8,76,5.4,1028,Cloudy
10/24/2023 11:00,129,494,520104,353733,623,873837,TUESDAY,0,0,8.9,73,5.4,1028.6,Cloudy
10/24/2023 12:00,154,532,750284,367877,686,1118161,TUESDAY,0,0,8.9,73,5.4,1028.6,Cloudy
10/24/2023 13:00,176,544,1121520,826715,720,1948235,TUESDAY,0,0,9.4,74,7.6,1029.2,Cloudy
10/24/2023 14:00,183,487,292785,405571,670,698356,TUESDAY,0,0,12.2,72,11.2,1028.5,Cloudy
10/24/2023 15:00,219,671,2110011,511041,890,2621052,TUESDAY,0,0,12.2,72,11.2,1028.5,Cloudy
10/24/2023 16:00,260,1101,960988,940054,1361,1901042,TUESDAY,0,0,14.4,56,20.5,1027.5,Cloudy
10/24/2023 17:00,426,1520,976568,1479397,1946,2455965,TUESDAY,0,0,15,55,16.6,1027.1,Cloudy
10/24/2023 18:00,255,1096,367527,1039708,1351,1407235,TUESDAY,0,0,15,55,16.6,1027.1,Cloudy
10/24/2023 19:00,134,749,393087,615048,883,1008135,TUESDAY,0,0,15.6,57,14.8,1026.4,Fair
10/24/2023 20:00,96,496,90514,544088,592,634602,TUESDAY,0,0,15,62,13,1026.1,Fair
10/24/2023 21:00,102,366,117563,321242,468,438805,TUESDAY,0,0,13.9,64,13,1025.7,Fair
10/24/2023 22:00,57,277,170245,287620,334,457865,TUESDAY,0,0,13.9,67,13,1026.1,Cloudy
10/24/2023 23:00,55,135,733466,203274,190,936740,TUESDAY,0,0,13.3,72,16.6,1026.2,Fair
10/25/2023 0:00,20,82,18413,53024,102,71437,WEDNESDAY,0,0,13.3,72,16.6,1026.2,Fair
10/25/2023 1:00,23,30,21208,18034,53,39242,WEDNESDAY,0,0,12.2,80,14.8,1025.4,Fair
10/25/2023 2:00,10,11,34904,9221,21,44125,WEDNESDAY,0,0,12.2,83,16.6,1025.2,Fair
10/25/2023 3:00,2,8,1355,5917,10,7272,WEDNESDAY,0,0,12.2,83,16.6,1025.2,Clear
10/25/2023 4:00,6,13,4105,9861,19,13966,WEDNESDAY,0,0,12.2,83,13,1025.5,Clear
10/25/2023 5:00,16,76,11366,63966,92,75332,WEDNESDAY,0,0,11.7,89,14.8,1025.6,Fair
10/25/2023 6:00,28,270,19209,300125,298,319334,WEDNESDAY,0,0,11.7,89,14.8,1024.8,Clear
10/25/2023 7:00,109,740,567271,735897,849,1303168,WEDNESDAY,0,0,11.7,93,13,1024,Clear
10/25/2023 8:00,191,1369,221432,1470047,1560,1691479,WEDNESDAY,0,0,11.7,93,13,1024,Clear
10/25/2023 9:00,116,787,666569,1626833,903,2293402,WEDNESDAY,0,0,11.7,93,14.8,1024.4,Clear
10/25/2023 10:00,130,449,652914,348971,579,1001885,WEDNESDAY,0,0,11.7,93,14.8,1024,Cloudy
10/25/2023 11:00,145,418,325109,313438,563,638547,WEDNESDAY,0,0,12.2,90,18.4,1024.1,Fair
10/25/2023 12:00,147,523,1641266,371584,670,2012850,WEDNESDAY,0,0,13.3,80,20.5,1024.1,Fair
10/25/2023 13:00,163,523,195589,428481,686,624070,WEDNESDAY,0,0,13.3,80,20.5,1024.1,Fair
10/25/2023 14:00,181,560,301781,430193,741,731974,WEDNESDAY,0,0,17.2,65,14.8,1023.9,Fair
10/25/2023 15:00,229,741,362138,574189,970,936327,WEDNESDAY,0,0,19.4,55,20.5,1023.2,Fair
10/25/2023 16:00,274,1159,1844133,1025599,1433,2869732,WEDNESDAY,0,0,21.1,49,18.4,1022,Fair
10/25/2023 17:00,406,1447,767757,1672603,1853,2440360,WEDNESDAY,0,0,23.3,45,13,1021.5,Cloudy
10/25/2023 18:00,259,1117,339405,927875,1376,1267280,WEDNESDAY,0,0,23.3,45,13,1021.5,Cloudy
10/25/2023 19:00,198,716,207209,542115,914,749324,WEDNESDAY,0,0,23.3,41,18.4,1021.5,Cloudy
10/25/2023 20:00,119,553,305725,423613,672,729338,WEDNESDAY,0,0,22.2,46,14.8,1021.1,Cloudy
10/25/2023 21:00,106,407,130831,305614,513,436445,WEDNESDAY,0,0,21.7,49,18.4,1021.4,Cloudy
10/25/2023 22:00,110,276,422523,229667,386,652190,WEDNESDAY,0,0,21.7,49,18.4,1021.4,Cloudy
10/25/2023 23:00,56,148,59396,114004,204,173400,WEDNESDAY,0,0,20,55,7.6,1021.9,Cloudy
10/26/2023 0:00,27,50,37062,36742,77,73804,THURSDAY,0,0,19.4,52,14.8,1022,Cloudy
10/26/2023 1:00,14,34,45808,58253,48,104061,THURSDAY,0,0,18.3,56,14.8,1021.5,Cloudy
10/26/2023 2:00,8,16,10101,11435,24,21536,THURSDAY,0,0,17.8,60,16.6,1021.3,Cloudy
10/26/2023 3:00,13,8,11224,7994,21,19218,THURSDAY,0,0,17.8,60,16.6,1021.3,Cloudy
10/26/2023 4:00,7,14,6368,562253,21,568621,THURSDAY,0,0,16.7,67,14.8,1021.3,Cloudy
10/26/2023 5:00,18,78,21390,333435,96,354825,THURSDAY,0,0,16.1,70,11.2,1021.3,Cloudy
10/26/2023 6:00,30,257,77854,738318,287,816172,THURSDAY,0,0,16.7,67,14.8,1021,Cloudy
10/26/2023 7:00,101,679,426352,1107735,780,1534087,THURSDAY,0,0,16.1,70,11.2,1020.7,Cloudy
10/26/2023 8:00,194,1227,191365,3818468,1421,4009833,THURSDAY,0,0,16.1,70,11.2,1020.7,Cloudy
10/26/2023 9:00,120,746,243849,550380,866,794229,THURSDAY,0,0,17.8,63,13,1021.6,Cloudy
10/26/2023 10:00,100,502,1794812,946910,602,2741722,THURSDAY,0,0,15.6,72,7.6,1021.3,Cloudy
10/26/2023 11:00,165,466,360291,320701,631,680992,THURSDAY,0,0,16.1,72,13,1022,Cloudy
10/26/2023 12:00,202,563,415488,405357,765,820845,THURSDAY,0,0,17.8,65,5.4,1022.7,Cloudy
10/26/2023 13:00,187,575,1411657,522838,762,1934495,THURSDAY,0,0,19.4,55,9.4,1023,Cloudy
10/26/2023 14:00,242,589,521651,554164,831,1075815,THURSDAY,0,0,19.4,55,9.4,1023,Cloudy
10/26/2023 15:00,298,775,551507,718410,1073,1269917,THURSDAY,0,0,23.3,43,5.4,1021.8,Cloudy
10/26/2023 16:00,343,1122,690363,1472514,1465,2162877,THURSDAY,0,0,25,37,5.4,1020.9,Fair
10/26/2023 17:00,486,1563,1236394,2622785,2049,3859179,THURSDAY,0,0,25,37,5.4,1020.9,Fair
10/26/2023 18:00,346,1144,2334760,1057903,1490,3392663,THURSDAY,0,0,24.4,43,7.6,1020.4,Fair
10/26/2023 19:00,246,811,296992,627743,1057,924735,THURSDAY,0,0,26.1,35,9.4,1020.1,Cloudy
10/26/2023 20:00,181,628,536652,499916,809,1036568,THURSDAY,0,0,25.6,42,13,1020.2,Cloudy
10/26/2023 21:00,139,446,223666,738046,585,961712,THURSDAY,0,0,25.6,42,7.6,1020.4,Cloudy
10/26/2023 22:00,154,330,1390734,285355,484,1676089,THURSDAY,0,0,19.4,63,7.6,1020.4,Fair
10/26/2023 23:00,96,209,520104,193268,305,713372,THURSDAY,0,0,20.6,57,0,1020.7,Cloudy
10/27/2023 0:00,77,113,1025541,95692,190,1121233,FRIDAY,0,0,20.6,57,7.6,1020.7,Cloudy
10/27/2023 1:00,54,72,104904,57913,126,162817,FRIDAY,0,0,17.8,73,5.4,1020.7,Cloudy
10/27/2023 2:00,20,29,136921,29302,49,166223,FRIDAY,0,0,17.8,73,5.4,1020.7,Cloudy
10/27/2023 3:00,14,9,12550,13255,23,25805,FRIDAY,0,0,17.2,75,5.4,1020.7,Cloudy
10/27/2023 4:00,5,15,5860,8995,20,14855,FRIDAY,0,0,18.9,68,7.6,1020.3,Cloudy
10/27/2023 5:00,20,72,16988,54016,92,71004,FRIDAY,0,0,16.7,78,5.4,1020,Cloudy
10/27/2023 6:00,35,196,29650,171851,231,201501,FRIDAY,0,0,17.2,72,5.4,1019.5,Cloudy
10/27/2023 7:00,98,532,154190,531987,630,686177,FRIDAY,0,0,18.9,63,5.4,1019,Cloudy
10/27/2023 8:00,180,1076,212701,940941,1256,1153642,FRIDAY,0,0,18.9,63,5.4,1019,Cloudy
10/27/2023 9:00,148,712,202635,578881,860,781516,FRIDAY,0,0,19.4,61,5.4,1018.8,Cloudy
10/27/2023 10:00,166,485,308305,369581,651,677886,FRIDAY,0,0,17.2,67,9.4,1018.8,Cloudy
10/27/2023 11:00,195,510,342493,396974,705,739467,FRIDAY,0,0,17.2,70,11.2,1018.8,Cloudy
10/27/2023 12:00,279,595,1301049,1143291,874,2444340,FRIDAY,0,0,18.3,65,11.2,1019.1,Cloudy
10/27/2023 13:00,336,643,713809,471291,979,1185100,FRIDAY,0,0,18.3,65,11.2,1019.1,Cloudy
10/27/2023 14:00,374,703,2901998,524172,1077,3426170,FRIDAY,0,0,20.6,57,11.2,1018.5,Cloudy
10/27/2023 15:00,451,807,2557148,795362,1258,3352510,FRIDAY,0,0,23.9,46,11.2,1017.8,Cloudy
10/27/2023 16:00,517,1019,1785690,900230,1536,2685920,FRIDAY,0,0,21.7,57,11.2,1016.7,Cloudy
10/27/2023 17:00,635,1360,3119228,1928263,1995,5047491,FRIDAY,0,0,23.9,48,14.8,1016.3,Fair
10/27/2023 18:00,416,974,1438750,1313574,1390,2752324,FRIDAY,0,0,23.9,48,14.8,1016.3,Fair
10/27/2023 19:00,315,687,691121,743684,1002,1434805,FRIDAY,0,0,25.6,42,14.8,1015.2,Fair
10/27/2023 20:00,258,529,709981,477684,787,1187665,FRIDAY,0,0,25.6,42,14.8,1015.2,Fair
10/27/2023 21:00,215,459,643951,377385,674,1021336,FRIDAY,0,0,23.3,48,13,1014.9,Fair
10/27/2023 22:00,235,374,1011498,332040,609,1343538,FRIDAY,0,0,23.3,48,13,1014.9,Fair
10/27/2023 23:00,200,288,1580347,250101,488,1830448,FRIDAY,0,0,20.6,61,14.8,1014.8,Fair
10/28/2023 0:00,217,213,1314236,210459,430,1524695,SATURDAY,1,0,20,63,16.6,1014.5,Fair
10/28/2023 1:00,231,190,1370113,177914,421,1548027,SATURDAY,1,0,19.4,66,13,1014.7,Fair
10/28/2023 2:00,120,122,235265,127643,242,362908,SATURDAY,1,0,19.4,66,14.8,1014.5,Fair
10/28/2023 3:00,44,28,53190,21116,72,74306,SATURDAY,1,0,19.4,66,14.8,1014.5,Fair
10/28/2023 4:00,10,24,9399,25028,34,34427,SATURDAY,1,0,18.3,70,14.8,1013.7,Clear
10/28/2023 5:00,14,31,19338,26823,45,46161,SATURDAY,1,0,17.8,73,9.4,1013.4,Fair
10/28/2023 6:00,27,67,23263,42506,94,65769,SATURDAY,1,0,17.2,75,9.4,1013.2,Fair
10/28/2023 7:00,60,135,815680,97864,195,913544,SATURDAY,1,0,17.2,75,9.4,1013.2,Fair
10/28/2023 8:00,129,290,500174,336695,419,836869,SATURDAY,1,0,17.8,73,9.4,1012.8,Fair
10/28/2023 9:00,243,482,1133646,498461,725,1632107,SATURDAY,1,0,16.7,78,9.4,1012.8,Fair
10/28/2023 10:00,378,521,1595406,506461,899,2101867,SATURDAY,1,0,17.8,73,9.4,1013.2,Cloudy
10/28/2023 11:00,501,654,1288179,648614,1155,1936793,SATURDAY,1,0,17.2,75,9.4,1013.7,Fair
10/28/2023 12:00,603,741,1868076,710793,1344,2578869,SATURDAY,1,0,17.2,75,9.4,1013.7,Fair
10/28/2023 13:00,748,740,1750844,797156,1488,2548000,SATURDAY,1,0,21.7,63,11.2,1013.5,Fair
10/28/2023 14:00,725,791,1445581,830547,1516,2276128,SATURDAY,1,0,23.3,57,16.6,1013.2,Fair
10/28/2023 15:00,667,732,2292760,915479,1399,3208239,SATURDAY,1,0,25,54,14.8,1012.5,Fair
10/28/2023 16:00,750,795,2766966,788135,1545,3555101,SATURDAY,1,0,26.1,50,18.4,1012,Fair
10/28/2023 17:00,664,760,4387309,731897,1424,5119206,SATURDAY,1,0,26.1,50,18.4,1012,Fair
10/28/2023 18:00,474,738,1068561,700151,1212,1768712,SATURDAY,1,0,26.7,49,20.5,1011.5,Fair
10/28/2023 19:00,361,601,3669139,521910,962,4191049,SATURDAY,1,0,26.7,49,24.1,1011.8,Fair
10/28/2023 20:00,276,483,828657,599699,759,1428356,SATURDAY,1,0,26.7,49,14.8,1011.7,Fair
10/28/2023 21:00,233,386,625779,318407,619,944186,SATURDAY,1,0,25,54,16.6,1012.7,Fair
10/28/2023 22:00,274,333,2179578,276241,607,2455819,SATURDAY,1,0,25,54,16.6,1012.7,Fair
10/28/2023 23:00,229,238,362632,196011,467,558643,SATURDAY,1,0,22.2,49,20.5,1014.6,Fair
10/29/2023 0:00,240,216,1603028,194617,456,1797645,SUNDAY,1,0,20.6,45,22.3,1015.6,Fair
10/29/2023 1:00,340,235,1609629,209857,575,1819486,SUNDAY,1,0,19.4,49,25.9,1016.2,Fair
10/29/2023 2:00,218,93,4632186,116763,311,4748949,SUNDAY,1,0,17.8,60,25.9,1016.8,Fair
10/29/2023 3:00,41,23,405050,18839,64,423889,SUNDAY,1,0,17.8,60,24.1,1016.8,Fair
10/29/2023 4:00,9,19,8236,14448,28,22684,SUNDAY,1,0,16.1,56,22.3,1018.3,Fair
10/29/2023 5:00,19,17,18960,13820,36,32780,SUNDAY,1,0,16.1,56,22.3,1018.3,Cloudy
10/29/2023 6:00,11,44,8986,40238,55,49224,SUNDAY,1,0,13.9,62,14.8,1019.1,Cloudy
10/29/2023 7:00,36,87,78455,65158,123,143613,SUNDAY,1,0,13.9,62,14.8,1019.1,Cloudy
10/29/2023 8:00,98,192,320802,152611,290,473413,SUNDAY,1,0,12.2,61,18.4,1021.2,Cloudy
10/29/2023 9:00,119,317,586077,254850,436,840927,SUNDAY,1,0,12.2,61,18.4,1021.2,Cloudy
10/29/2023 10:00,189,357,1824229,260981,546,2085210,SUNDAY,1,0,11.1,59,11.2,1021.4,Cloudy
10/29/2023 11:00,53,234,63920,185920,287,249840,SUNDAY,1,0,11.7,56,11.2,1021.6,Cloudy
10/29/2023 12:00,73,214,90165,151058,287,241223,SUNDAY,1,0,11.7,56,11.2,1021.6,Rain
10/29/2023 13:00,66,224,93134,493495,290,586629,SUNDAY,1,0,12.2,59,14.8,1022.1,Rain
10/29/2023 14:00,60,233,65526,183649,293,249175,SUNDAY,1,0,11.7,69,14.8,1023.2,Rain
10/29/2023 15:00,65,309,337411,292801,374,630212,SUNDAY,1,0,10.6,77,16.6,1023.1,Rain
10/29/2023 16:00,114,380,131685,801751,494,933436,SUNDAY,1,0,10,86,11.2,1022.6,Rain
10/29/2023 17:00,148,397,242162,364318,545,606480,SUNDAY,1,0,10,86,11.2,1022.6,Rain
10/29/2023 18:00,68,395,95117,308761,463,403878,SUNDAY,1,0,9.4,86,16.6,1020.9,Rain
10/29/2023 19:00,70,295,80143,574169,365,654312,SUNDAY,1,0,10,83,20.5,1020.5,Rain
10/29/2023 20:00,38,170,40349,172258,208,212607,SUNDAY,1,0,10,80,18.4,1020.4,Rain
10/29/2023 21:00,28,134,77428,85524,162,162952,SUNDAY,1,0,10,80,18.4,1020.4,Rain
10/29/2023 22:00,49,105,119323,64209,154,183532,SUNDAY,1,0,9.4,80,18.4,1020.7,Rain
10/29/2023 23:00,21,56,19102,34774,77,53876,SUNDAY,1,0,9.4,83,16.6,1020.7,Rain
10/30/2023 0:00,21,33,159270,64037,54,223307,MONDAY,0,0,9.4,86,18.4,1020.1,Rain
10/30/2023 1:00,5,18,4569,14521,23,19090,MONDAY,0,0,8.9,86,25.9,1020,Rain
10/30/2023 2:00,4,11,4777,5080,15,9857,MONDAY,0,0,8.9,86,25.9,1020,Rain
10/30/2023 3:00,4,4,2197,5642,8,7839,MONDAY,0,0,8.3,93,24.1,1019,Rain
10/30/2023 4:00,3,8,2636,4789,11,7425,MONDAY,0,0,8.9,89,24.1,1018.4,Rain
10/30/2023 5:00,6,54,16456,54373,60,70829,MONDAY,0,0,8.3,97,20.5,1017.4,Rain
10/30/2023 6:00,11,145,7931,217777,156,225708,MONDAY,0,0,8.9,93,24.1,1016.9,Rain
10/30/2023 7:00,22,251,521159,475917,273,997076,MONDAY,0,0,8.9,93,24.1,1016.9,Rain
10/30/2023 8:00,32,370,23366,353195,402,376561,MONDAY,0,0,9.4,93,20.5,1015.3,Rain
10/30/2023 9:00,49,455,75616,418012,504,493628,MONDAY,0,0,10,93,22.3,1012.7,Rain
10/30/2023 10:00,55,384,279078,322120,439,601198,MONDAY,0,0,10,93,22.3,1012.7,Rain
10/30/2023 11:00,25,232,100887,169162,257,270049,MONDAY,0,0,10.6,92,27.7,1010.3,Rain
10/30/2023 12:00,20,217,19342,128915,237,148257,MONDAY,0,0,10.6,92,25.9,1010.3,Rain
10/30/2023 13:00,37,220,108073,142947,257,251020,MONDAY,0,0,11.7,96,14.8,1008.3,Rain
10/30/2023 14:00,33,193,34013,124993,226,159006,MONDAY,0,0,11.7,96,5.4,1007.5,Rain
10/30/2023 15:00,31,199,632352,131671,230,764023,MONDAY,0,0,12.2,93,9.4,1006.4,Rain
10/30/2023 16:00,65,371,1641664,579334,436,2220998,MONDAY,0,0,12.2,93,9.4,1006.4,Rain
10/30/2023 17:00,86,634,142088,1221572,720,1363660,MONDAY,0,0,11.7,96,13,1005.3,Rain
10/30/2023 18:00,71,587,541136,1007237,658,1548373,MONDAY,0,0,11.7,96,13,1005.3,Rain
10/30/2023 19:00,50,373,199295,256026,423,455321,MONDAY,0,0,11.7,96,11.2,1004.5,Rain
10/30/2023 20:00,37,284,86069,334545,321,420614,MONDAY,0,0,10.6,92,20.5,1005.4,Rain
10/30/2023 21:00,44,262,74408,235104,306,309512,MONDAY,0,0,9.4,97,14.8,1005.4,Rain
10/30/2023 22:00,32,196,64684,145516,228,210200,MONDAY,0,0,8.9,93,16.6,1007.7,Rain
10/30/2023 23:00,20,93,64702,56666,113,121368,MONDAY,0,0,8.3,93,13,1008.3,Rain
10/31/2023 0:00,25,57,29983,41274,82,71257,TUESDAY,0,0,8.3,93,13,1008.3,Rain
10/31/2023 1:00,5,20,5968,11984,25,17952,TUESDAY,0,0,7.8,93,11.2,1009.1,Rain
10/31/2023 2:00,4,14,2267,8843,18,11110,TUESDAY,0,0,8.3,90,13,1010.2,Cloudy
10/31/2023 3:00,5,9,8002,6822,14,14824,TUESDAY,0,0,8.3,80,20.5,1012.4,Cloudy
10/31/2023 4:00,5,12,2672,45346,17,48018,TUESDAY,0,0,7.2,74,22.3,1012.9,Cloudy
10/31/2023 5:00,10,73,5432,41776,83,47208,TUESDAY,0,0,6.7,73,18.4,1014,Cloudy
10/31/2023 6:00,32,241,37371,170459,273,207830,TUESDAY,0,0,6.7,73,18.4,1014,Cloudy
10/31/2023 7:00,57,593,74098,435018,650,509116,TUESDAY,0,0,6.1,65,27.7,1015.8,Fair
10/31/2023 8:00,117,1184,128691,1493562,1301,1622253,TUESDAY,0,0,5.6,64,18.4,1016.5,Fair
10/31/2023 9:00,84,637,131632,680225,721,811857,TUESDAY,0,0,5,60,16.6,1017.5,Fair
10/31/2023 10:00,110,397,165605,665509,507,831114,TUESDAY,0,0,4.4,62,18.4,1018.3,Fair
10/31/2023 11:00,95,371,127193,286608,466,413801,TUESDAY,0,0,4.4,62,18.4,1018.3,Fair
10/31/2023 12:00,130,470,643516,310741,600,954257,TUESDAY,0,0,5,57,14.8,1020.2,Fair
10/31/2023 13:00,136,471,815052,327147,607,1142199,TUESDAY,0,0,6.1,49,18.4,1020.6,Fair
10/31/2023 14:00,133,526,648709,376289,659,1024998,TUESDAY,0,0,7.8,45,14.8,1020.3,Fair
10/31/2023 15:00,190,694,899519,1299811,884,2199330,TUESDAY,0,0,8.3,34,7.6,1019.9,Fair
10/31/2023 16:00,200,1031,1360705,1561901,1231,2922606,TUESDAY,0,0,8.3,34,7.6,1019.9,Fair
10/31/2023 17:00,253,1370,953244,1427192,1623,2380436,TUESDAY,0,0,9.4,30,9.4,1018.7,Fair
10/31/2023 18:00,190,820,2056103,799957,1010,2856060,TUESDAY,0,0,10,33,11.2,1018.4,Fair
10/31/2023 19:00,140,592,606658,527118,732,1133776,TUESDAY,0,0,9.4,36,7.6,1018.2,Fair
10/31/2023 20:00,92,430,128948,317867,522,446815,TUESDAY,0,0,9.4,36,7.6,1018.2,Fair
10/31/2023 21:00,62,280,892012,207704,342,1099716,TUESDAY,0,0,6.7,47,11.2,1018.4,Fair
10/31/2023 22:00,57,210,66161,146781,267,212942,TUESDAY,0,0,6.7,45,7.6,1018.4,Cloudy
10/31/2023 23:00,43,164,35899,114580,207,150479,TUESDAY,0,0,5.6,55,13,1018.4,Cloudy
11/1/2023 0:00,23,69,56544,50094,92,106638,WEDNESDAY,0,0,6.7,53,16.6,1018.3,Fair
11/1/2023 1:00,8,37,47939,28686,45,76625,WEDNESDAY,0,0,6.7,53,16.6,1018.3,Fair
11/1/2023 2:00,21,26,39103,23720,47,62823,WEDNESDAY,0,0,6.7,55,11.2,1017.4,Fair
11/1/2023 3:00,1,13,612,10177,14,10789,WEDNESDAY,0,0,6.7,55,11.2,1017.4,Fair
11/1/2023 4:00,6,10,4078,10964,16,15042,WEDNESDAY,0,0,7.2,60,11.2,1016.5,Cloudy
11/1/2023 5:00,16,71,1077334,49902,87,1127236,WEDNESDAY,0,0,7.2,56,20.5,1015.9,Cloudy
11/1/2023 6:00,24,198,26288,144857,222,171145,WEDNESDAY,0,0,7.2,56,20.5,1015.9,Cloudy
11/1/2023 7:00,71,577,69522,447141,648,516663,WEDNESDAY,0,0,7.2,58,20.5,1014.8,Cloudy
11/1/2023 8:00,105,1100,116372,839524,1205,955896,WEDNESDAY,0,0,7.2,58,20.5,1014.8,Cloudy
11/1/2023 9:00,86,620,116453,471452,706,587905,WEDNESDAY,0,0,5,67,22.3,1014.5,Cloudy
11/1/2023 10:00,63,368,265819,263132,431,528951,WEDNESDAY,0,0,5,67,22.3,1014.5,Cloudy
11/1/2023 11:00,55,373,91225,253969,428,345194,WEDNESDAY,0,0,3.9,79,18.4,1014.3,Cloudy
11/1/2023 12:00,80,446,109726,289301,526,399027,WEDNESDAY,0,0,4.4,76,18.4,1014.6,Cloudy
11/1/2023 13:00,85,431,96749,265881,516,362630,WEDNESDAY,0,0,5,70,25.9,1014.7,Cloudy
11/1/2023 14:00,103,434,150656,286868,537,437524,WEDNESDAY,0,0,6.1,68,22.3,1014.9,Cloudy
11/1/2023 15:00,126,484,626027,328394,610,954421,WEDNESDAY,0,0,6.1,68,22.3,1014.9,Cloudy
11/1/2023 16:00,147,854,207036,702935,1001,909971,WEDNESDAY,0,0,7.2,63,22.3,1015,Cloudy
11/1/2023 17:00,185,1197,459052,1008287,1382,1467339,WEDNESDAY,0,0,6.7,62,18.4,1015.4,Cloudy
11/1/2023 18:00,161,886,164902,794993,1047,959895,WEDNESDAY,0,0,7.2,56,18.4,1015.7,Cloudy
11/1/2023 19:00,79,543,90267,571563,622,661830,WEDNESDAY,0,0,7.2,53,20.5,1016.6,Cloudy
11/1/2023 20:00,75,371,68388,2751089,446,2819477,WEDNESDAY,0,0,7.2,53,20.5,1016.6,Cloudy
11/1/2023 21:00,53,285,97136,333619,338,430755,WEDNESDAY,0,0,6.7,47,14.8,1017.7,Cloudy
11/1/2023 22:00,40,189,44837,172337,229,217174,WEDNESDAY,0,0,6.7,55,13,1018.7,Cloudy
11/1/2023 23:00,23,96,51074,578065,119,629139,WEDNESDAY,0,0,5.6,62,14.8,1019.6,Cloudy
11/2/2023 0:00,10,43,9047,24879,53,33926,THURSDAY,0,0,5,65,14.8,1020.5,Fair
11/2/2023 1:00,10,25,44750,53882,35,98632,THURSDAY,0,0,5,65,14.8,1020.5,Fair
11/2/2023 2:00,3,18,3347,15700,21,19047,THURSDAY,0,0,3.9,70,20.5,1021.5,Fair
11/2/2023 3:00,4,5,6694,5422,9,12116,THURSDAY,0,0,2.8,76,18.4,1023.4,Fair
11/2/2023 4:00,7,13,3074,8429,20,11503,THURSDAY,0,0,2.2,73,16.6,1024,Fair
11/2/2023 5:00,12,61,31222,45569,73,76791,THURSDAY,0,0,2.2,73,16.6,1024,Clear
11/2/2023 6:00,23,170,24401,134973,193,159374,THURSDAY,0,0,1.1,67,22.3,1025.3,Clear
11/2/2023 7:00,52,554,41008,552326,606,593334,THURSDAY,0,0,1.1,67,18.4,1026.1,Clear
11/2/2023 8:00,87,1026,89083,999712,1113,1088795,THURSDAY,0,0,1.1,67,14.8,1026.6,Clear
11/2/2023 9:00,78,649,88096,857688,727,945784,THURSDAY,0,0,1.1,64,20.5,1027.4,Clear
11/2/2023 10:00,66,392,69373,264898,458,334271,THURSDAY,0,0,1.1,64,20.5,1027.4,Cloudy
11/2/2023 11:00,78,348,124463,245675,426,370138,THURSDAY,0,0,1.1,67,20.5,1029.4,Fair
11/2/2023 12:00,71,454,88645,317318,525,405963,THURSDAY,0,0,2.8,59,16.6,1030.2,Fair
11/2/2023 13:00,128,405,251005,258525,533,509530,THURSDAY,0,0,2.8,59,16.6,1030.2,Fair
11/2/2023 14:00,110,461,134276,348809,571,483085,THURSDAY,0,0,5,48,7.6,1030.7,Fair
11/2/2023 15:00,161,608,301115,426646,769,727761,THURSDAY,0,0,5,48,7.6,1030.7,Fair
11/2/2023 16:00,189,860,376746,631142,1049,1007888,THURSDAY,0,0,6.7,38,20.5,1029.9,Fair
11/2/2023 17:00,246,1268,370600,2092447,1514,2463047,THURSDAY,0,0,7.8,38,16.6,1029.7,Fair
11/2/2023 18:00,171,886,202223,752805,1057,955028,THURSDAY,0,0,7.8,38,16.6,1029.7,Fair
11/2/2023 19:00,106,573,101264,464629,679,565893,THURSDAY,0,0,8.3,39,7.6,1029.5,Fair
11/2/2023 20:00,72,402,160994,273391,474,434385,THURSDAY,0,0,7.8,35,14.8,1029.9,Fair
11/2/2023 21:00,67,316,746507,276837,383,1023344,THURSDAY,0,0,7.8,35,14.8,1029.9,Fair
11/2/2023 22:00,69,226,187871,194770,295,382641,THURSDAY,0,0,6.7,45,11.2,1031.1,Fair
11/2/2023 23:00,26,112,26681,129194,138,155875,THURSDAY,0,0,6.7,43,14.8,1031.6,Fair
11/3/2023 0:00,25,53,20104,54663,78,74767,FRIDAY,0,0,6.7,43,14.8,1031.6,Fair
11/3/2023 1:00,20,39,1164318,64112,59,1228430,FRIDAY,0,0,4.4,55,11.2,1032.1,Clear
11/3/2023 2:00,7,12,6603,7118,19,13721,FRIDAY,0,0,4.4,55,11.2,1032.1,Clear
11/3/2023 3:00,13,7,767639,6669,20,774308,FRIDAY,0,0,4.4,57,11.2,1032.2,Fair
11/3/2023 4:00,5,11,4650,6342,16,10992,FRIDAY,0,0,3.9,59,13,1032.2,Fair
11/3/2023 5:00,11,56,35786,35032,67,70818,FRIDAY,0,0,2.8,67,11.2,1032,Clear
11/3/2023 6:00,23,165,18723,145275,188,163998,FRIDAY,0,0,3.3,67,13,1032.1,Fair
11/3/2023 7:00,58,390,46499,309429,448,355928,FRIDAY,0,0,3.3,67,13,1032.1,Fair
11/3/2023 8:00,95,805,124371,677427,900,801798,FRIDAY,0,0,3.3,67,13,1032.1,Fair
11/3/2023 9:00,104,586,126622,454776,690,581398,FRIDAY,0,0,4.4,68,11.2,1031.9,Fair
11/3/2023 10:00,97,442,215933,335752,539,551685,FRIDAY,0,0,5,65,9.4,1032.2,Cloudy
11/3/2023 11:00,98,367,134089,279714,465,413803,FRIDAY,0,0,4.4,68,13,1032.1,Fair
11/3/2023 12:00,133,437,290844,317541,570,608385,FRIDAY,0,0,4.4,68,13,1032.1,Fair
11/3/2023 13:00,190,533,269656,374499,723,644155,FRIDAY,0,0,8.9,50,20.5,1031.9,Fair
11/3/2023 14:00,205,565,316276,445444,770,761720,FRIDAY,0,0,10.6,46,20.5,1031.4,Fair
11/3/2023 15:00,239,680,421330,513076,919,934406,FRIDAY,0,0,11.1,44,24.1,1030.7,Fair
11/3/2023 16:00,314,902,938427,719807,1216,1658234,FRIDAY,0,0,12.2,37,24.1,1029.6,Fair
11/3/2023 17:00,309,1120,1271445,902950,1429,2174395,FRIDAY,0,0,12.2,37,24.1,1029.6,Fair
11/3/2023 18:00,212,850,493922,990426,1062,1484348,FRIDAY,0,0,12.8,35,27.7,1027.7,Fair
11/3/2023 19:00,133,531,173667,392142,664,565809,FRIDAY,0,0,12.8,40,27.7,1027.3,Fair
11/3/2023 20:00,109,349,142776,245144,458,387920,FRIDAY,0,0,12.2,38,27.7,1027.1,Fair
11/3/2023 21:00,111,311,1328039,240186,422,1568225,FRIDAY,0,0,11.1,44,27.7,1026.8,Fair
11/3/2023 22:00,120,260,196220,1220778,380,1416998,FRIDAY,0,0,11.1,44,24.1,1026.8,Cloudy
11/3/2023 23:00,77,178,313611,126946,255,440557,FRIDAY,0,0,9.4,69,24.1,1026.9,Fair
11/4/2023 0:00,75,136,110935,107330,211,218265,SATURDAY,1,0,9.4,71,24.1,1026.3,Fair
11/4/2023 1:00,103,88,246147,67604,191,313751,SATURDAY,1,0,9.4,74,25.9,1026.1,Cloudy
11/4/2023 2:00,50,60,857017,89921,110,946938,SATURDAY,1,0,9.4,74,25.9,1026.1,Cloudy
11/4/2023 3:00,20,31,33714,25800,51,59514,SATURDAY,1,0,8.9,77,29.5,1025,Cloudy
11/4/2023 4:00,5,16,11038,11645,21,22683,SATURDAY,1,0,8.9,77,27.7,1024.8,Fair
11/4/2023 5:00,8,28,7892,28182,36,36074,SATURDAY,1,0,8.9,77,27.7,1024.4,Cloudy
11/4/2023 6:00,14,65,12984,152041,79,165025,SATURDAY,1,0,8.3,80,24.1,1023.9,Cloudy
11/4/2023 7:00,50,102,63412,79556,152,142968,SATURDAY,1,0,8.3,80,24.1,1023.1,Cloudy
11/4/2023 8:00,58,244,173378,263471,302,436849,SATURDAY,1,0,8.3,80,25.9,1023.1,Cloudy
11/4/2023 9:00,147,336,243259,275657,483,518916,SATURDAY,1,0,8.3,76,24.1,1023,Cloudy
11/4/2023 10:00,197,420,480537,416959,617,897496,SATURDAY,1,0,8.9,66,20.5,1022.6,Cloudy
11/4/2023 11:00,265,524,482691,1807493,789,2290184,SATURDAY,1,0,8.9,66,13,1023.3,Cloudy
11/4/2023 12:00,347,627,2777140,1324968,974,4102108,SATURDAY,1,0,8.9,66,13,1023.3,Cloudy
11/4/2023 13:00,386,681,1650387,662893,1067,2313280,SATURDAY,1,0,10.6,56,14.8,1023.4,Cloudy
11/4/2023 14:00,436,615,3241863,1472030,1051,4713893,SATURDAY,1,0,11.7,50,13,1023.4,Cloudy
11/4/2023 15:00,414,628,4518995,548111,1042,5067106,SATURDAY,1,0,12.2,50,13,1022.7,Cloudy
11/4/2023 16:00,405,641,650970,658586,1046,1309556,SATURDAY,1,0,13.3,49,7.6,1021.7,Cloudy
11/4/2023 17:00,354,639,2241259,566906,993,2808165,SATURDAY,1,0,13.3,49,7.6,1021.7,Cloudy
11/4/2023 18:00,240,542,1469130,453782,782,1922912,SATURDAY,1,0,15,41,11.2,1020.8,Cloudy
11/4/2023 19:00,208,475,2478060,466699,683,2944759,SATURDAY,1,0,14.4,44,11.2,1020.4,Cloudy
11/4/2023 20:00,151,287,693674,208419,438,902093,SATURDAY,1,0,12.8,64,7.6,1020.4,Cloudy
11/4/2023 21:00,167,269,1229011,207133,436,1436144,SATURDAY,1,0,12.8,64,7.6,1020.4,Cloudy
11/4/2023 22:00,132,249,348719,206932,381,555651,SATURDAY,1,0,11.7,74,7.6,1019.9,Cloudy
11/4/2023 23:00,140,169,2690724,709574,309,3400298,SATURDAY,1,0,11.1,74,7.6,1020,Cloudy
11/5/2023 0:00,134,141,268194,599462,275,867656,SUNDAY,1,0,11.1,74,0,1019.6,Cloudy
11/5/2023 1:00,180,144,373791,111059,324,484850,SUNDAY,1,0,11.1,74,5.4,1019.4,Cloudy
11/5/2023 2:00,27,27,27800,16278,54,44078,SUNDAY,1,0,11.1,74,5.4,1019.4,Cloudy
11/5/2023 3:00,12,14,14762,12202,26,26964,SUNDAY,1,0,10,74,5.4,1019.2,Cloudy
11/5/2023 4:00,5,14,73176,15154,19,88330,SUNDAY,1,0,11.7,61,11.2,1018.3,Cloudy
11/5/2023 5:00,20,43,48751,39955,63,88706,SUNDAY,1,0,11.1,61,7.6,1017.4,Cloudy
11/5/2023 6:00,76,158,94956,185677,234,280633,SUNDAY,1,0,11.1,61,7.6,1017.4,Cloudy
11/5/2023 7:00,103,139,1210150,150778,242,1360928,SUNDAY,1,0,10.6,63,7.6,1017.2,Cloudy
11/5/2023 8:00,164,317,260118,392225,481,652343,SUNDAY,1,0,10.6,66,13,1016.8,Cloudy
11/5/2023 9:00,264,474,1368534,2526307,738,3894841,SUNDAY,1,0,10,66,5.4,1016.4,Cloudy
11/5/2023 10:00,300,569,521873,1701681,869,2223554,SUNDAY,1,0,8.9,68,0,1016.2,Cloudy
11/5/2023 11:00,304,618,698785,677065,922,1375850,SUNDAY,1,0,8.9,73,9.4,1015.9,Cloudy
11/5/2023 12:00,336,643,2744379,528575,979,3272954,SUNDAY,1,0,8.9,73,9.4,1015.9,Cloudy
11/5/2023 13:00,381,588,962155,530706,969,1492861,SUNDAY,1,0,11.7,64,5.4,1016.4,Cloudy
11/5/2023 14:00,392,643,809855,604787,1035,1414642,SUNDAY,1,0,13.9,49,7.6,1016.2,Cloudy
11/5/2023 15:00,375,636,2173544,639820,1011,2813364,SUNDAY,1,0,14.4,49,9.4,1015.8,Cloudy
11/5/2023 16:00,357,656,1145003,1154988,1013,2299991,SUNDAY,1,0,14.4,49,9.4,1015.8,Cloudy
11/5/2023 17:00,168,591,241515,485167,759,726682,SUNDAY,1,0,15.6,41,14.8,1014.8,Cloudy
11/5/2023 18:00,155,503,1624550,414626,658,2039176,SUNDAY,1,0,15,46,14.8,1014.7,Cloudy
11/5/2023 19:00,117,335,257939,2294110,452,2552049,SUNDAY,1,0,15.6,46,11.2,1014.7,Cloudy
11/5/2023 20:00,87,298,215252,370296,385,585548,SUNDAY,1,0,14.4,47,11.2,1014.8,Fair
11/5/2023 21:00,63,198,144155,172880,261,317035,SUNDAY,1,0,14.4,47,11.2,1014.8,Fair
11/5/2023 22:00,50,163,43405,113451,213,156856,SUNDAY,1,0,12.8,55,5.4,1016.5,Cloudy
11/5/2023 23:00,21,69,20664,42122,90,62786,SUNDAY,1,0,12.2,55,7.6,1017.1,Fair
11/6/2023 0:00,14,38,218246,24053,52,242299,MONDAY,0,0,11.1,57,9.4,1017.5,Fair
11/6/2023 1:00,5,26,3519,29171,31,32690,MONDAY,0,0,10.6,56,11.2,1017.8,Fair
11/6/2023 2:00,7,9,4380,4967,16,9347,MONDAY,0,0,10.6,56,11.2,1017.8,Fair
11/6/2023 3:00,4,7,4301,4457,11,8758,MONDAY,0,0,8.3,63,20.5,1019.4,Fair
11/6/2023 4:00,2,15,39423,9578,17,49001,MONDAY,0,0,8.3,63,22.3,1019.4,Fair
11/6/2023 5:00,13,74,9495,50118,87,59613,MONDAY,0,0,7.8,60,14.8,1019.8,Fair
11/6/2023 6:00,20,227,18268,195463,247,213731,MONDAY,0,0,7.8,60,14.8,1020.9,Fair
11/6/2023 7:00,76,619,2007377,489570,695,2496947,MONDAY,0,0,7.8,60,14.8,1020.9,Fair
11/6/2023 8:00,106,1017,122797,813767,1123,936564,MONDAY,0,0,7.2,60,13,1021.2,Fair
11/6/2023 9:00,74,552,150810,1645417,626,1796227,MONDAY,0,0,7.2,60,13,1021.2,Fair
11/6/2023 10:00,83,350,121326,262778,433,384104,MONDAY,0,0,6.7,58,13,1022.5,Cloudy
11/6/2023 11:00,84,363,152579,244349,447,396928,MONDAY,0,0,6.7,60,11.2,1022.8,Cloudy
11/6/2023 12:00,92,400,861040,416107,492,1277147,MONDAY,0,0,6.7,60,11.2,1022.8,Cloudy
11/6/2023 13:00,94,388,151229,282329,482,433558,MONDAY,0,0,7.2,60,13,1023.5,Cloudy
11/6/2023 14:00,97,415,390637,279070,512,669707,MONDAY,0,0,8.3,63,14.8,1023.1,Cloudy
11/6/2023 15:00,122,499,189050,376681,621,565731,MONDAY,0,0,9.4,56,16.6,1022.3,Cloudy
11/6/2023 16:00,142,795,294890,592954,937,887844,MONDAY,0,0,9.4,56,16.6,1022.3,Cloudy
11/6/2023 17:00,160,1043,167570,803082,1203,970652,MONDAY,0,0,9.4,63,16.6,1020.8,Cloudy
11/6/2023 18:00,130,852,197925,954614,982,1152539,MONDAY,0,0,8.9,66,14.8,1020.4,Cloudy
11/6/2023 19:00,71,536,185032,393602,607,578634,MONDAY,0,0,8.9,66,18.4,1020.1,Cloudy
11/6/2023 20:00,72,395,68992,248985,467,317977,MONDAY,0,0,8.9,66,16.6,1019.9,Cloudy
11/6/2023 21:00,64,276,121323,192086,340,313409,MONDAY,0,0,8.9,66,16.6,1019.9,Cloudy
11/6/2023 22:00,36,176,889710,109178,212,998888,MONDAY,0,0,8.9,71,13,1019.6,Cloudy
11/6/2023 23:00,30,117,35308,76174,147,111482,MONDAY,0,0,9.4,71,11.2,1018.9,Cloudy
11/7/2023 0:00,18,37,46461,49479,55,95940,TUESDAY,0,0,9.4,80,11.2,1018,Cloudy
11/7/2023 1:00,6,10,5803,8012,16,13815,TUESDAY,0,0,9.4,80,11.2,1018,Cloudy
11/7/2023 2:00,2,5,1855,6017,7,7872,TUESDAY,0,0,9.4,80,13,1017.1,Cloudy
11/7/2023 3:00,2,6,2813,4126,8,6939,TUESDAY,0,0,8.9,89,11.2,1015.6,Cloudy
11/7/2023 4:00,2,12,7840,17595,14,25435,TUESDAY,0,0,9.4,90,13,1014.2,Cloudy
11/7/2023 5:00,11,83,10439,64707,94,75146,TUESDAY,0,0,10,86,14.8,1014,Cloudy
11/7/2023 6:00,24,249,21854,244178,273,266032,TUESDAY,0,0,10,86,14.8,1014,Cloudy
11/7/2023 7:00,63,598,2821421,512641,661,3334062,TUESDAY,0,0,10,93,18.4,1011.8,Cloudy
11/7/2023 8:00,85,910,72861,704612,995,777473,TUESDAY,0,0,10.6,92,20.5,1010.5,Cloudy
11/7/2023 9:00,74,614,1429789,1843841,688,3273630,TUESDAY,0,0,11.1,93,24.1,1009.3,Rain
11/7/2023 10:00,88,340,107780,250578,428,358358,TUESDAY,0,0,11.1,93,24.1,1009.3,Rain
11/7/2023 11:00,81,402,138272,1913305,483,2051577,TUESDAY,0,0,12.2,86,25.9,1008.6,Rain
11/7/2023 12:00,119,435,469131,313751,554,782882,TUESDAY,0,0,12.8,87,22.3,1007.5,Rain
11/7/2023 13:00,146,483,251352,347161,629,598513,TUESDAY,0,0,13.3,90,24.1,1006.9,Cloudy
11/7/2023 14:00,151,523,187050,532629,674,719679,TUESDAY,0,0,13.3,90,24.1,1006.9,Cloudy
11/7/2023 15:00,218,647,3403237,527566,865,3930803,TUESDAY,0,0,16.1,81,20.5,1005,Cloudy
11/7/2023 16:00,185,897,1155427,720863,1082,1876290,TUESDAY,0,0,16.1,81,20.5,1005,Cloudy
11/7/2023 17:00,210,1184,318321,1009599,1394,1327920,TUESDAY,0,0,18.3,65,25.9,1003,Cloudy
11/7/2023 18:00,153,941,2490629,874907,1094,3365536,TUESDAY,0,0,18.9,59,24.1,1002.5,Cloudy
11/7/2023 19:00,103,621,113580,463343,724,576923,TUESDAY,0,0,18.9,52,27.7,1002.2,Cloudy
11/7/2023 20:00,77,444,87704,402524,521,490228,TUESDAY,0,0,18.3,52,24.1,1002.5,Cloudy
11/7/2023 21:00,88,318,151343,239079,406,390422,TUESDAY,0,0,18.3,52,24.1,1002.5,Cloudy
11/7/2023 22:00,54,233,53335,167150,287,220485,TUESDAY,0,0,16.1,58,29.5,1004.6,Cloudy
11/7/2023 23:00,41,110,36345,71439,151,107784,TUESDAY,0,0,15.6,51,29.5,1005.2,Fair
11/8/2023 0:00,9,55,13366,34987,64,48353,WEDNESDAY,0,0,13.9,53,29.5,1006,Fair
11/8/2023 1:00,5,21,6451,13863,26,20314,WEDNESDAY,0,0,12.8,55,29.5,1006.9,Fair
11/8/2023 2:00,4,13,3228,7709,17,10937,WEDNESDAY,0,0,12.8,55,24.1,1006.9,Fair
11/8/2023 3:00,0,7,0,112542,7,112542,WEDNESDAY,0,0,11.7,56,18.4,1007.9,Fair
11/8/2023 4:00,3,17,1287,12537,20,13824,WEDNESDAY,0,0,11.7,56,18.4,1008.5,Fair
11/8/2023 5:00,14,71,10994,46513,85,57507,WEDNESDAY,0,0,9.4,59,22.3,1008.9,Fair
11/8/2023 6:00,30,242,17392,207043,272,224435,WEDNESDAY,0,0,9.4,59,22.3,1008.9,Fair
11/8/2023 7:00,69,603,86863,566598,672,653461,WEDNESDAY,0,0,7.2,56,25.9,1009.8,Fair
11/8/2023 8:00,98,1163,142869,1091344,1261,1234213,WEDNESDAY,0,0,6.1,53,25.9,1011.1,Fair
11/8/2023 9:00,77,607,131805,547416,684,679221,WEDNESDAY,0,0,5.6,53,24.1,1012.5,Fair
11/8/2023 10:00,72,323,137430,352906,395,490336,WEDNESDAY,0,0,4.4,53,24.1,1013.6,Cloudy
11/8/2023 11:00,64,371,345981,370124,435,716105,WEDNESDAY,0,0,4.4,53,27.7,1013.6,Fair
11/8/2023 12:00,56,318,72261,359914,374,432175,WEDNESDAY,0,0,3.3,46,25.9,1016.2,Fair
11/8/2023 13:00,100,422,139487,297796,522,437283,WEDNESDAY,0,0,3.9,46,22.3,1016.6,Fair
11/8/2023 14:00,71,444,108348,324979,515,433327,WEDNESDAY,0,0,4.4,44,27.7,1016.9,Fair
11/8/2023 15:00,105,543,114797,403838,648,518635,WEDNESDAY,0,0,5.6,39,27.7,1016.5,Fair
11/8/2023 16:00,133,851,333436,694820,984,1028256,WEDNESDAY,0,0,5.6,39,33.5,1016.5,Fair
11/8/2023 17:00,168,1043,187247,931477,1211,1118724,WEDNESDAY,0,0,6.1,38,31.7,1016.2,Fair
11/8/2023 18:00,141,737,282929,566607,878,849536,WEDNESDAY,0,0,6.7,36,27.7,1015.9,Fair
11/8/2023 19:00,74,500,76868,398664,574,475532,WEDNESDAY,0,0,6.1,38,25.9,1016.3,Fair
11/8/2023 20:00,61,343,60800,292033,404,352833,WEDNESDAY,0,0,6.1,38,25.9,1016.3,Fair
11/8/2023 21:00,51,301,80184,202905,352,283089,WEDNESDAY,0,0,5.6,41,16.6,1017.2,Cloudy
11/8/2023 22:00,33,188,34626,130249,221,164875,WEDNESDAY,0,0,5.6,41,22.3,1017.5,Cloudy
11/8/2023 23:00,25,92,22109,60701,117,82810,WEDNESDAY,0,0,5,43,25.9,1017.8,Cloudy
11/9/2023 0:00,18,48,16193,35302,66,51495,THURSDAY,0,0,4.4,46,18.4,1018.2,Cloudy
11/9/2023 1:00,14,18,14602,9908,32,24510,THURSDAY,0,0,4.4,46,18.4,1018.2,Cloudy
11/9/2023 2:00,2,5,1064,2600,7,3664,THURSDAY,0,0,3.9,48,16.6,1018.3,Cloudy
11/9/2023 3:00,2,6,1627,3616,8,5243,THURSDAY,0,0,2.8,52,18.4,1017.9,Cloudy
11/9/2023 4:00,2,15,1669,11489,17,13158,THURSDAY,0,0,2.8,52,14.8,1017.9,Cloudy
11/9/2023 5:00,8,61,433244,47639,69,480883,THURSDAY,0,0,2.8,54,11.2,1017.6,Cloudy
11/9/2023 6:00,13,182,12200,223535,195,235735,THURSDAY,0,0,2.8,54,11.2,1017.6,Cloudy
11/9/2023 7:00,23,286,16399,276054,309,292453,THURSDAY,0,0,2.8,59,11.2,1016.8,Cloudy
11/9/2023 8:00,52,527,46284,481203,579,527487,THURSDAY,0,0,2.8,59,0,1016.4,Cloudy
11/9/2023 9:00,56,506,67119,392759,562,459878,THURSDAY,0,0,3.3,57,0,1016.1,Cloudy
11/9/2023 10:00,33,302,37680,192799,335,230479,THURSDAY,0,0,3.3,62,7.6,1016.2,Cloudy
11/9/2023 11:00,50,252,267528,160905,302,428433,THURSDAY,0,0,3.3,62,7.6,1016.2,Cloudy
11/9/2023 12:00,34,213,133412,226316,247,359728,THURSDAY,0,0,3.3,73,13,1015.7,Cloudy
11/9/2023 13:00,32,232,37978,157942,264,195920,THURSDAY,0,0,3.3,76,0,1015.8,Rain
11/9/2023 14:00,46,266,69875,203201,312,273076,THURSDAY,0,0,4.4,83,11.2,1014.9,Rain
11/9/2023 15:00,70,361,101556,276820,431,378376,THURSDAY,0,0,4.4,83,11.2,1014.9,Rain
11/9/2023 16:00,104,608,2166767,452899,712,2619666,THURSDAY,0,0,5.6,79,11.2,1013.6,Cloudy
11/9/2023 17:00,144,812,251147,707938,956,959085,THURSDAY,0,0,5.6,89,13,1012.2,Cloudy
11/9/2023 18:00,120,657,211127,480162,777,691289,THURSDAY,0,0,6.1,93,13,1011.4,Cloudy
11/9/2023 19:00,70,476,77305,402289,546,479594,THURSDAY,0,0,7.8,96,11.2,1010.6,Cloudy
11/9/2023 20:00,66,300,95508,345410,366,440918,THURSDAY,0,0,7.8,96,11.2,1010.6,Cloudy
11/9/2023 21:00,69,281,114056,257951,350,372007,THURSDAY,0,0,5.6,100,13,1011.1,Cloudy
11/9/2023 22:00,46,205,88333,142649,251,230982,THURSDAY,0,0,5.6,100,13,1011.1,Cloudy
11/9/2023 23:00,41,106,194471,579466,147,773937,THURSDAY,0,0,5,100,11.2,1011.6,Cloudy
11/10/2023 0:00,37,84,59272,61511,121,120783,FRIDAY,0,1,5,96,14.8,1012.4,Cloudy
11/10/2023 1:00,52,24,75402,20631,76,96033,FRIDAY,0,1,3.9,100,14.8,1013,Cloudy
11/10/2023 2:00,14,24,15522,14835,38,30357,FRIDAY,0,1,4.4,93,9.4,1013.8,Cloudy
11/10/2023 3:00,3,8,1287,4677,11,5964,FRIDAY,0,1,3.9,93,11.2,1013.9,Cloudy
11/10/2023 4:00,7,12,4034,11844,19,15878,FRIDAY,0,1,4.4,93,0,1014,Cloudy
11/10/2023 5:00,10,34,7146,21411,44,28557,FRIDAY,0,1,3.9,89,13,1014.4,Cloudy
11/10/2023 6:00,22,129,129515,93276,151,222791,FRIDAY,0,1,3.9,89,13,1014.4,Cloudy
11/10/2023 7:00,47,301,64977,316966,348,381943,FRIDAY,0,1,5.6,89,14.8,1014.3,Cloudy
11/10/2023 8:00,81,559,127587,553777,640,681364,FRIDAY,0,1,5.6,85,14.8,1014.5,Cloudy
11/10/2023 9:00,92,484,299874,879363,576,1179237,FRIDAY,0,1,4.4,89,14.8,1014.8,Cloudy
11/10/2023 10:00,106,408,308700,912621,514,1221321,FRIDAY,0,1,5.6,82,20.5,1015.6,Cloudy
11/10/2023 11:00,145,455,395100,412360,600,807460,FRIDAY,0,1,5.6,82,20.5,1015.6,Cloudy
11/10/2023 12:00,184,475,690080,432928,659,1123008,FRIDAY,0,1,6.7,76,24.1,1016.6,Cloudy
11/10/2023 13:00,163,497,366899,385774,660,752673,FRIDAY,0,1,8.9,68,14.8,1016.8,Cloudy
11/10/2023 14:00,181,469,562703,367853,650,930556,FRIDAY,0,1,9.4,63,25.9,1017.1,Cloudy
11/10/2023 15:00,167,525,253356,389446,692,642802,FRIDAY,0,1,9.4,63,25.9,1017.1,Cloudy
11/10/2023 16:00,223,633,308893,488385,856,797278,FRIDAY,0,1,10,61,20.5,1016.2,Cloudy
11/10/2023 17:00,176,729,275412,567365,905,842777,FRIDAY,0,1,10,61,18.4,1015.9,Cloudy
11/10/2023 18:00,158,622,754383,528482,780,1282865,FRIDAY,0,1,10.6,50,14.8,1016,Cloudy
11/10/2023 19:00,147,440,251698,327876,587,579574,FRIDAY,0,1,10.6,48,22.3,1016,Cloudy
11/10/2023 20:00,100,298,460422,260441,398,720863,FRIDAY,0,1,10.6,48,22.3,1016,Cloudy
11/10/2023 21:00,99,224,176212,184442,323,360654,FRIDAY,0,1,10,42,16.6,1016,Cloudy
11/10/2023 22:00,96,204,491611,156972,300,648583,FRIDAY,0,1,8.3,52,16.6,1016.8,Cloudy
11/10/2023 23:00,59,167,62324,178360,226,240684,FRIDAY,0,1,8.3,56,18.4,1017.2,Cloudy
11/11/2023 0:00,73,95,1550632,68879,168,1619511,SATURDAY,1,1,7.2,60,18.4,1017.3,Fair
11/11/2023 1:00,94,60,918826,45454,154,964280,SATURDAY,1,1,7.2,60,18.4,1017.3,Fair
11/11/2023 2:00,56,36,1353817,23299,92,1377116,SATURDAY,1,1,7.2,58,16.6,1018.4,Fair
11/11/2023 3:00,13,20,60248,43193,33,103441,SATURDAY,1,1,7.2,58,16.6,1018.4,Fair
11/11/2023 4:00,9,13,11599,10858,22,22457,SATURDAY,1,1,6.7,60,14.8,1018.5,Fair
11/11/2023 5:00,8,12,6607,11619,20,18226,SATURDAY,1,1,6.7,60,14.8,1018.9,Fair
11/11/2023 6:00,15,38,22709,40562,53,63271,SATURDAY,1,1,6.1,62,18.4,1019.5,Fair
11/11/2023 7:00,36,101,120160,78374,137,198534,SATURDAY,1,1,7.2,58,14.8,1019.6,Fair
11/11/2023 8:00,65,204,70410,149306,269,219716,SATURDAY,1,1,7.8,53,24.1,1019.7,Fair
11/11/2023 9:00,105,311,174100,249063,416,423163,SATURDAY,1,1,6.7,60,18.4,1020.5,Fair
11/11/2023 10:00,216,381,1041041,310412,597,1351453,SATURDAY,1,1,6.7,60,18.4,1020.5,Cloudy
11/11/2023 11:00,257,463,733135,378766,720,1111901,SATURDAY,1,1,5.6,64,14.8,1022.3,Fair
11/11/2023 12:00,299,494,921230,409023,793,1330253,SATURDAY,1,1,6.7,62,14.8,1023.3,Fair
11/11/2023 13:00,315,509,533771,528668,824,1062439,SATURDAY,1,1,6.7,62,14.8,1023.3,Fair
11/11/2023 14:00,302,521,575943,488338,823,1064281,SATURDAY,1,1,8.3,56,24.1,1024.3,Fair
11/11/2023 15:00,275,525,1246667,930218,800,2176885,SATURDAY,1,1,8.3,56,24.1,1024.3,Fair
11/11/2023 16:00,262,507,587174,482458,769,1069632,SATURDAY,1,1,8.9,47,24.1,1024.7,Fair
11/11/2023 17:00,152,485,497092,383766,637,880858,SATURDAY,1,1,9.4,39,22.3,1024.9,Fair
11/11/2023 18:00,142,381,426169,360328,523,786497,SATURDAY,1,1,9.4,38,24.1,1024.9,Fair
11/11/2023 19:00,99,329,498185,345810,428,843995,SATURDAY,1,1,8.9,37,18.4,1025.5,Fair
11/11/2023 20:00,74,247,76615,160693,321,237308,SATURDAY,1,1,8.9,37,18.4,1025.5,Fair
11/11/2023 21:00,90,188,162933,127836,278,290769,SATURDAY,1,1,6.7,43,18.4,1027,Fair
11/11/2023 22:00,75,148,450372,102568,223,552940,SATURDAY,1,1,5.6,44,16.6,1028,Cloudy
11/11/2023 23:00,37,101,41495,75264,138,116759,SATURDAY,1,1,3.9,52,13,1028.8,Fair
11/12/2023 0:00,67,95,103816,65518,162,169334,SUNDAY,1,0,3.9,52,13,1028.8,Fair
11/12/2023 1:00,89,82,272134,56632,171,328766,SUNDAY,1,0,2.8,57,20.5,1030.4,Clear
11/12/2023 2:00,59,32,333697,29650,91,363347,SUNDAY,1,0,2.2,59,18.4,1030.7,Clear
11/12/2023 3:00,12,13,12038,25133,25,37171,SUNDAY,1,0,2.2,59,18.4,1030.7,Clear
11/12/2023 4:00,3,10,2518,7004,13,9522,SUNDAY,1,0,1.1,61,11.2,1031,Fair
11/12/2023 5:00,14,22,17251,21116,36,38367,SUNDAY,1,0,1.1,61,13,1031.6,Clear
11/12/2023 6:00,13,54,60753,49713,67,110466,SUNDAY,1,0,0.6,63,16.6,1031.6,Clear
11/12/2023 7:00,29,78,60998,57783,107,118781,SUNDAY,1,0,0.6,63,18.4,1031.5,Fair
11/12/2023 8:00,50,154,92520,117599,204,210119,SUNDAY,1,0,0,64,13,1031.3,Fair
11/12/2023 9:00,110,247,155265,209544,357,364809,SUNDAY,1,0,-0.6,66,14.8,1031.7,Fair
11/12/2023 10:00,163,347,672759,275228,510,947987,SUNDAY,1,0,-0.6,66,16.6,1032.2,Cloudy
11/12/2023 11:00,172,394,347217,402742,566,749959,SUNDAY,1,0,-0.6,66,16.6,1032.2,Cloudy
11/12/2023 12:00,171,436,321768,546103,607,867871,SUNDAY,1,0,1.1,61,16.6,1032.9,Cloudy
11/12/2023 13:00,223,480,315627,489503,703,805130,SUNDAY,1,0,1.7,58,18.4,1033.1,Cloudy
11/12/2023 14:00,192,449,391782,474487,641,866269,SUNDAY,1,0,2.8,54,20.5,1032.9,Cloudy
11/12/2023 15:00,196,454,332555,376318,650,708873,SUNDAY,1,0,2.8,54,20.5,1032.9,Cloudy
11/12/2023 16:00,179,418,237811,299334,597,537145,SUNDAY,1,0,5,51,11.2,1032.1,Cloudy
11/12/2023 17:00,109,413,1641066,421188,522,2062254,SUNDAY,1,0,5,51,13,1031.4,Cloudy
11/12/2023 18:00,87,312,310705,204039,399,514744,SUNDAY,1,0,5.6,49,11.2,1031,Fair
11/12/2023 19:00,50,247,227050,356285,297,583335,SUNDAY,1,0,5.6,49,11.2,1031,Fair
11/12/2023 20:00,45,181,89887,160090,226,249977,SUNDAY,1,0,4.4,48,18.4,1030.4,Fair
11/12/2023 21:00,36,147,36233,96033,183,132266,SUNDAY,1,0,3.3,52,18.4,1030.7,Fair
11/12/2023 22:00,30,132,26780,90748,162,117528,SUNDAY,1,0,2.8,54,11.2,1030.8,Cloudy
11/12/2023 23:00,22,75,42215,133316,97,175531,SUNDAY,1,0,2.2,56,9.4,1030.8,Fair
11/13/2023 0:00,6,35,4159,21708,41,25867,MONDAY,0,0,2.2,56,9.4,1030.8,Fair
11/13/2023 1:00,6,13,7821,36856,19,44677,MONDAY,0,0,2.2,56,13,1030.6,Fair
11/13/2023 2:00,2,1,26657,1940,3,28597,MONDAY,0,0,2.2,56,13,1030.6,Fair
11/13/2023 3:00,0,6,0,6460,6,6460,MONDAY,0,0,1.1,59,9.4,1030.3,Fair
11/13/2023 4:00,5,12,4848,8492,17,13340,MONDAY,0,0,0.6,63,13,1030.2,Fair
11/13/2023 5:00,5,57,2522,46778,62,49300,MONDAY,0,0,-0.6,66,14.8,1030.3,Clear
11/13/2023 6:00,22,152,29951,107922,174,137873,MONDAY,0,0,-0.6,66,14.8,1030.3,Clear
11/13/2023 7:00,44,425,47251,351014,469,398265,MONDAY,0,0,-1.1,69,13,1029.6,Fair
11/13/2023 8:00,73,848,106973,662301,921,769274,MONDAY,0,0,-1.7,72,14.8,1029.3,Fair
11/13/2023 9:00,65,487,61014,372314,552,433328,MONDAY,0,0,-1.7,72,14.8,1029.3,Fair
11/13/2023 10:00,57,306,95284,250321,363,345605,MONDAY,0,0,-2.2,71,16.6,1028.7,Cloudy
11/13/2023 11:00,73,339,84827,245658,412,330485,MONDAY,0,0,-1.7,72,14.8,1028.7,Fair
11/13/2023 12:00,83,355,297396,317754,438,615150,MONDAY,0,0,-1.1,69,14.8,1028.9,Fair
11/13/2023 13:00,53,314,153730,264430,367,418160,MONDAY,0,0,0.6,66,11.2,1028.2,Fair
11/13/2023 14:00,80,375,188444,259797,455,448241,MONDAY,0,0,0.6,66,11.2,1028.2,Fair
11/13/2023 15:00,87,438,114618,495936,525,610554,MONDAY,0,0,3.9,52,5.4,1026.7,Fair
11/13/2023 16:00,117,670,139126,486177,787,625303,MONDAY,0,0,5.6,53,0,1025.3,Fair
11/13/2023 17:00,123,856,120196,716454,979,836650,MONDAY,0,0,5.6,55,7.6,1024.4,Cloudy
11/13/2023 18:00,98,719,102295,503974,817,606269,MONDAY,0,0,6.7,47,14.8,1023.6,Cloudy
11/13/2023 19:00,67,505,60982,469082,572,530064,MONDAY,0,0,6.7,47,14.8,1023.6,Cloudy
11/13/2023 20:00,46,299,46761,251824,345,298585,MONDAY,0,0,5.6,59,16.6,1022.3,Cloudy
11/13/2023 21:00,39,208,49900,145636,247,195536,MONDAY,0,0,5,67,13,1022,Cloudy
11/13/2023 22:00,46,173,53862,119765,219,173627,MONDAY,0,0,5,70,9.4,1022.4,Cloudy
11/13/2023 23:00,21,87,15311,57278,108,72589,MONDAY,0,0,6.1,70,7.6,1022.2,Cloudy
11/14/2023 0:00,13,37,41263,23588,50,64851,TUESDAY,0,0,6.1,43,7.6,1022.2,Cloudy
11/14/2023 1:00,6,9,29401,6207,15,35608,TUESDAY,0,0,3.9,62,14.8,1022,Cloudy
11/14/2023 2:00,2,6,1177,3844,8,5021,TUESDAY,0,0,3.9,62,14.8,1022,Cloudy
11/14/2023 3:00,3,8,1864,4015,11,5879,TUESDAY,0,0,3.3,67,14.8,1021.2,Cloudy
11/14/2023 4:00,4,11,4767,8648,15,13415,TUESDAY,0,0,3.3,67,14.8,1021.2,Cloudy
11/14/2023 5:00,6,63,3628,42747,69,46375,TUESDAY,0,0,2.8,72,7.6,1020.1,Cloudy
11/14/2023 6:00,24,196,27428,131418,220,158846,TUESDAY,0,0,2.8,72,7.6,1020.1,Cloudy
11/14/2023 7:00,64,566,63572,561853,630,625425,TUESDAY,0,0,3.3,73,0,1019.6,Cloudy
11/14/2023 8:00,108,1052,91457,911661,1160,1003118,TUESDAY,0,0,3.3,76,5.4,1019.6,Cloudy
11/14/2023 9:00,80,552,170552,429067,632,599619,TUESDAY,0,0,3.3,76,5.4,1019.6,Cloudy
11/14/2023 10:00,56,346,388797,248117,402,636914,TUESDAY,0,0,2.8,78,11.2,1020.3,Cloudy
11/14/2023 11:00,73,328,147170,300962,401,448132,TUESDAY,0,0,2.2,82,11.2,1021,Cloudy
11/14/2023 12:00,98,373,175006,247941,471,422947,TUESDAY,0,0,3.3,79,13,1021.8,Cloudy
11/14/2023 13:00,82,384,96642,258724,466,355366,TUESDAY,0,0,4.4,73,9.4,1022.2,Cloudy
11/14/2023 14:00,106,424,217613,381230,530,598843,TUESDAY,0,0,4.4,73,9.4,1022.2,Cloudy
11/14/2023 15:00,130,500,169829,397270,630,567099,TUESDAY,0,0,7.2,63,13,1023,Cloudy
11/14/2023 16:00,135,794,259850,610352,929,870202,TUESDAY,0,0,7.8,55,14.8,1022.9,Cloudy
11/14/2023 17:00,163,1035,441401,896987,1198,1338388,TUESDAY,0,0,8.9,54,16.6,1023,Cloudy
11/14/2023 18:00,121,769,213825,598407,890,812232,TUESDAY,0,0,9.4,52,14.8,1023.2,Cloudy
11/14/2023 19:00,55,552,51752,375651,607,427403,TUESDAY,0,0,9.4,52,14.8,1023.2,Cloudy
11/14/2023 20:00,53,361,59980,253050,414,313030,TUESDAY,0,0,8.9,54,16.6,1024.3,Fair
11/14/2023 21:00,49,277,45207,190023,326,235230,TUESDAY,0,0,7.8,55,24.1,1025,Fair
11/14/2023 22:00,31,160,63373,100707,191,164080,TUESDAY,0,0,6.7,60,22.3,1026,Cloudy
11/14/2023 23:00,33,103,119573,62115,136,181688,TUESDAY,0,0,6.7,60,22.3,1026,Fair
11/15/2023 0:00,10,56,5687,37319,66,43006,WEDNESDAY,0,0,5,65,16.6,1027.1,Fair
11/15/2023 1:00,6,12,32655,8097,18,40752,WEDNESDAY,0,0,4.4,68,20.5,1027.7,Fair
11/15/2023 2:00,6,9,5732,5729,15,11461,WEDNESDAY,0,0,3.9,67,14.8,1028.1,Fair
11/15/2023 3:00,3,10,35994,6699,13,42693,WEDNESDAY,0,0,3.9,70,14.8,1028.3,Fair
11/15/2023 4:00,4,14,3954,10706,18,14660,WEDNESDAY,0,0,3.9,70,14.8,1028.3,Fair
11/15/2023 5:00,7,75,6675,81406,82,88081,WEDNESDAY,0,0,2.8,76,13,1029,Fair
11/15/2023 6:00,22,198,41085,167707,220,208792,WEDNESDAY,0,0,2.8,76,11.2,1028.8,Fair
11/15/2023 7:00,64,529,75781,564789,593,640570,WEDNESDAY,0,0,2.8,76,9.4,1029,Fair
11/15/2023 8:00,123,1083,115733,1360626,1206,1476359,WEDNESDAY,0,0,2.2,79,5.4,1029.4,Fair
11/15/2023 9:00,71,605,172243,423018,676,595261,WEDNESDAY,0,0,2.2,79,5.4,1029.4,Fair
11/15/2023 10:00,52,366,48847,279263,418,328110,WEDNESDAY,0,0,2.2,79,11.2,1029.8,Fair
11/15/2023 11:00,73,366,91055,309970,439,401025,WEDNESDAY,0,0,2.2,79,11.2,1030.1,Fair
11/15/2023 12:00,71,438,78528,313436,509,391964,WEDNESDAY,0,0,3.9,73,9.4,1030.3,Fair
11/15/2023 13:00,77,393,156983,326403,470,483386,WEDNESDAY,0,0,3.9,73,9.4,1030.3,Fair
11/15/2023 14:00,98,415,143285,291531,513,434816,WEDNESDAY,0,0,6.1,65,7.6,1030.6,Fair
11/15/2023 15:00,110,526,129711,577961,636,707672,WEDNESDAY,0,0,6.7,62,14.8,1029.6,Fair
11/15/2023 16:00,139,787,734501,644654,926,1379155,WEDNESDAY,0,0,8.3,54,11.2,1028.4,Cloudy
11/15/2023 17:00,167,1014,167175,879979,1181,1047154,WEDNESDAY,0,0,8.3,54,13,1027.8,Cloudy
11/15/2023 18:00,136,805,147940,623979,941,771919,WEDNESDAY,0,0,8.3,54,13,1027.8,Cloudy
11/15/2023 19:00,108,550,199826,372585,658,572411,WEDNESDAY,0,0,10,46,16.6,1026,Cloudy
11/15/2023 20:00,70,352,150359,247250,422,397609,WEDNESDAY,0,0,9.4,48,20.5,1025.4,Cloudy
11/15/2023 21:00,55,312,104781,208411,367,313192,WEDNESDAY,0,0,8.3,54,13,1025.2,Cloudy
11/15/2023 22:00,46,210,37423,242509,256,279932,WEDNESDAY,0,0,7.2,65,16.6,1024.7,Cloudy
11/15/2023 23:00,30,99,62227,123608,129,185835,WEDNESDAY,0,0,7.2,65,16.6,1024.7,Cloudy
11/16/2023 0:00,18,37,53174,50760,55,103934,THURSDAY,0,0,7.2,68,18.4,1023.7,Cloudy
11/16/2023 1:00,4,23,4680,12577,27,17257,THURSDAY,0,0,7.2,71,22.3,1023.3,Cloudy
11/16/2023 2:00,10,15,12042,10771,25,22813,THURSDAY,0,0,7.2,74,24.1,1022.4,Cloudy
11/16/2023 3:00,2,7,2600,6154,9,8754,THURSDAY,0,0,7.8,73,25.9,1022.3,Cloudy
11/16/2023 4:00,4,15,9536,8388,19,17924,THURSDAY,0,0,7.8,73,25.9,1022.3,Cloudy
11/16/2023 5:00,11,56,22620,39170,67,61790,THURSDAY,0,0,8.3,71,22.3,1021.9,Fair
11/16/2023 6:00,30,207,29137,154389,237,183526,THURSDAY,0,0,7.8,73,14.8,1022.1,Fair
11/16/2023 7:00,68,569,62605,531722,637,594327,THURSDAY,0,0,6.7,79,18.4,1021.7,Fair
11/16/2023 8:00,126,1098,143013,842033,1224,985046,THURSDAY,0,0,6.7,76,14.8,1021.6,Fair
11/16/2023 9:00,80,657,162733,529531,737,692264,THURSDAY,0,0,6.7,76,14.8,1021.6,Fair
11/16/2023 10:00,86,399,103622,391261,485,494883,THURSDAY,0,0,7.2,71,16.6,1021.9,Cloudy
11/16/2023 11:00,102,418,127909,366123,520,494032,THURSDAY,0,0,6.7,73,13,1022.3,Fair
11/16/2023 12:00,115,424,156237,287724,539,443961,THURSDAY,0,0,8.9,63,16.6,1022.9,Fair
11/16/2023 13:00,129,428,927545,327758,557,1255303,THURSDAY,0,0,8.9,63,16.6,1022.9,Fair
11/16/2023 14:00,145,459,222382,339279,604,561661,THURSDAY,0,0,11.7,50,13,1023.2,Fair
11/16/2023 15:00,181,623,264466,471602,804,736068,THURSDAY,0,0,13.3,45,7.6,1022.9,Fair
11/16/2023 16:00,213,922,508867,805382,1135,1314249,THURSDAY,0,0,14.4,44,9.4,1022.2,Fair
11/16/2023 17:00,230,1055,453195,884902,1285,1338097,THURSDAY,0,0,16.1,39,9.4,1021.4,Fair
11/16/2023 18:00,194,888,284031,827330,1082,1111361,THURSDAY,0,0,16.1,39,9.4,1021.4,Fair
11/16/2023 19:00,118,604,216933,420065,722,636998,THURSDAY,0,0,16.7,39,18.4,1021.1,Fair
11/16/2023 20:00,109,449,284683,316116,558,600799,THURSDAY,0,0,16.7,39,18.4,1021.1,Fair
11/16/2023 21:00,92,389,95794,292484,481,388278,THURSDAY,0,0,15,44,11.2,1021.7,Fair
11/16/2023 22:00,86,244,94168,183594,330,277762,THURSDAY,0,0,15,44,11.2,1021.7,Cloudy
11/16/2023 23:00,33,136,39204,180561,169,219765,THURSDAY,0,0,13.9,45,7.6,1021.9,Fair
11/17/2023 0:00,42,61,50190,38048,103,88238,FRIDAY,0,0,8.3,71,14.8,1021.9,Fair
11/17/2023 1:00,18,32,116197,435721,50,551918,FRIDAY,0,0,7.8,76,11.2,1022.2,Fair
11/17/2023 2:00,12,15,44270,6251,27,50521,FRIDAY,0,0,7.8,76,11.2,1022.2,Fair
11/17/2023 3:00,6,11,4536,4748,17,9284,FRIDAY,0,0,7.8,79,9.4,1022.3,Clear
11/17/2023 4:00,5,19,3546,12824,24,16370,FRIDAY,0,0,7.2,80,9.4,1022.1,Clear
11/17/2023 5:00,5,48,5099,31446,53,36545,FRIDAY,0,0,6.7,82,9.4,1021.2,Clear
11/17/2023 6:00,27,179,112048,250799,206,362847,FRIDAY,0,0,6.1,86,7.6,1020.8,Clear
11/17/2023 7:00,60,417,56594,444143,477,500737,FRIDAY,0,0,6.1,86,7.6,1020.8,Clear
11/17/2023 8:00,117,836,409248,996670,953,1405918,FRIDAY,0,0,5.6,85,9.4,1020.2,Clear
11/17/2023 9:00,104,613,193574,699331,717,892905,FRIDAY,0,0,5,89,9.4,1019.7,Fair
11/17/2023 10:00,114,432,235417,300807,546,536224,FRIDAY,0,0,7.2,97,11.2,1019.4,Cloudy
11/17/2023 11:00,151,441,270365,441166,592,711531,FRIDAY,0,0,7.2,100,9.4,1019.4,Cloudy
11/17/2023 12:00,169,539,288499,505356,708,793855,FRIDAY,0,0,7.2,100,9.4,1019.4,Fair
11/17/2023 13:00,177,539,379840,415594,716,795434,FRIDAY,0,0,12.2,86,20.5,1018.6,Fair
11/17/2023 14:00,177,548,317484,486900,725,804384,FRIDAY,0,0,16.1,67,25.9,1017.4,Fair
11/17/2023 15:00,198,645,313523,590607,843,904130,FRIDAY,0,0,16.1,70,24.1,1016.3,Cloudy
11/17/2023 16:00,252,820,476754,646939,1072,1123693,FRIDAY,0,0,17.8,60,24.1,1015.1,Cloudy
11/17/2023 17:00,233,869,281007,713934,1102,994941,FRIDAY,0,0,17.8,60,25.9,1015.1,Cloudy
11/17/2023 18:00,207,779,385319,943542,986,1328861,FRIDAY,0,0,18.3,54,25.9,1013.3,Cloudy
11/17/2023 19:00,160,523,333471,392301,683,725772,FRIDAY,0,0,17.2,65,29.5,1012.9,Cloudy
11/17/2023 20:00,149,339,289601,322940,488,612541,FRIDAY,0,0,16.1,70,24.1,1013.1,Cloudy
11/17/2023 21:00,160,260,1911629,254676,420,2166305,FRIDAY,0,0,15,78,20.5,1013.2,Cloudy
11/17/2023 22:00,152,294,244534,262570,446,507104,FRIDAY,0,0,15,78,20.5,1013.2,Cloudy
11/17/2023 23:00,147,180,472042,309088,327,781130,FRIDAY,0,0,13.9,83,18.4,1012.1,Cloudy
11/18/2023 0:00,117,146,346054,225995,263,572049,SATURDAY,1,0,13.3,87,14.8,1011.6,Cloudy
11/18/2023 1:00,161,108,543389,151954,269,695343,SATURDAY,1,0,13.9,83,14.8,1010.8,Cloudy
11/18/2023 2:00,79,68,152119,115158,147,267277,SATURDAY,1,0,13.9,83,14.8,1010.8,Cloudy
11/18/2023 3:00,29,22,158814,65592,51,224406,SATURDAY,1,0,13.9,87,13,1010.2,Cloudy
11/18/2023 4:00,20,9,60747,8074,29,68821,SATURDAY,1,0,13.3,90,13,1009.6,Cloudy
11/18/2023 5:00,15,24,49552,30531,39,80083,SATURDAY,1,0,12.2,97,14.8,1008,Cloudy
11/18/2023 6:00,21,39,53848,46792,60,100640,SATURDAY,1,0,12.8,96,14.8,1007.3,Cloudy
11/18/2023 7:00,29,78,37318,74439,107,111757,SATURDAY,1,0,12.8,96,14.8,1007.3,Cloudy
11/18/2023 8:00,26,95,66276,76043,121,142319,SATURDAY,1,0,12.8,96,9.4,1005.8,Cloudy
11/18/2023 9:00,34,105,50716,74552,139,125268,SATURDAY,1,0,12.8,96,13,1005.3,Cloudy
11/18/2023 10:00,57,246,87208,245926,303,333134,SATURDAY,1,0,12.8,96,13,1004.8,Cloudy
11/18/2023 11:00,108,323,154074,335056,431,489130,SATURDAY,1,0,12.8,96,13,1004.8,Rain
11/18/2023 12:00,141,405,214302,405158,546,619460,SATURDAY,1,0,13.3,100,0,1004.8,Rain
11/18/2023 13:00,184,444,258998,437113,628,696111,SATURDAY,1,0,13.9,93,14.8,1004.8,Rain
11/18/2023 14:00,222,445,650460,544285,667,1194745,SATURDAY,1,0,11.7,89,16.6,1005.5,Rain
11/18/2023 15:00,224,480,469607,421672,704,891279,SATURDAY,1,0,10.6,83,25.9,1005.1,Rain
11/18/2023 16:00,200,432,819116,433955,632,1253071,SATURDAY,1,0,10.6,83,25.9,1005.1,Cloudy
11/18/2023 17:00,139,414,252333,337795,553,590128,SATURDAY,1,0,9.4,80,25.9,1003.9,Rain
11/18/2023 18:00,83,330,85706,326306,413,412012,SATURDAY,1,0,9.4,69,25.9,1003.5,Cloudy
11/18/2023 19:00,99,294,315743,294871,393,610614,SATURDAY,1,0,8.3,65,33.5,1004.4,Cloudy
11/18/2023 20:00,63,241,124893,134246,304,259139,SATURDAY,1,0,7.2,60,35.3,1005.1,Cloudy
11/18/2023 21:00,65,200,59670,161219,265,220889,SATURDAY,1,0,7.2,60,27.7,1005.1,Cloudy
11/18/2023 22:00,54,157,91534,86469,211,178003,SATURDAY,1,0,5,62,22.3,1006.1,Cloudy
11/18/2023 23:00,64,118,89803,73213,182,163016,SATURDAY,1,0,4.4,60,24.1,1006.9,Fair
11/19/2023 0:00,43,81,668342,48113,124,716455,SUNDAY,1,0,3.9,55,24.1,1007.3,Fair
11/19/2023 1:00,121,78,584020,147462,199,731482,SUNDAY,1,0,3.3,57,18.4,1008.1,Fair
11/19/2023 2:00,37,54,34521,42088,91,76609,SUNDAY,1,0,3.3,57,18.4,1008.1,Fair
11/19/2023 3:00,17,14,73533,8796,31,82329,SUNDAY,1,0,2.8,57,22.3,1008.1,Clear
11/19/2023 4:00,1,12,219,9017,13,9236,SUNDAY,1,0,1.7,66,16.6,1009,Clear
11/19/2023 5:00,6,14,7765,9911,20,17676,SUNDAY,1,0,1.7,66,18.4,1008.8,Clear
11/19/2023 6:00,7,29,18509,41098,36,59607,SUNDAY,1,0,1.7,66,18.4,1008.8,Clear
11/19/2023 7:00,14,64,17502,52679,78,70181,SUNDAY,1,0,2.2,64,13,1009.5,Clear
11/19/2023 8:00,39,151,56065,102323,190,158388,SUNDAY,1,0,1.7,64,18.4,1009.6,Clear
11/19/2023 9:00,74,288,92160,392380,362,484540,SUNDAY,1,0,2.8,61,11.2,1009.9,Clear
11/19/2023 10:00,121,364,158247,278695,485,436942,SUNDAY,1,0,2.8,61,11.2,1009.9,Cloudy
11/19/2023 11:00,164,397,261925,497796,561,759721,SUNDAY,1,0,3.3,62,16.6,1010.1,Fair
11/19/2023 12:00,224,503,431557,391115,727,822672,SUNDAY,1,0,3.9,64,14.8,1010.7,Fair
11/19/2023 13:00,217,486,1623561,397342,703,2020903,SUNDAY,1,0,6.1,57,18.4,1010.5,Fair
11/19/2023 14:00,230,493,1045583,510060,723,1555643,SUNDAY,1,0,7.2,56,14.8,1010.6,Fair
11/19/2023 15:00,193,459,373349,404997,652,778346,SUNDAY,1,0,9.4,50,16.6,1010,Fair
11/19/2023 16:00,165,428,960761,344263,593,1305024,SUNDAY,1,0,9.4,50,16.6,1010,Fair
11/19/2023 17:00,111,395,130792,430310,506,561102,SUNDAY,1,0,10.6,41,25.9,1008.7,Fair
11/19/2023 18:00,73,336,140529,222784,409,363313,SUNDAY,1,0,11.7,32,22.3,1008.5,Fair
11/19/2023 19:00,68,302,143782,345633,370,489415,SUNDAY,1,0,10.6,33,27.7,1009,Fair
11/19/2023 20:00,61,195,82234,129255,256,211489,SUNDAY,1,0,10,33,27.7,1010,Fair
11/19/2023 21:00,43,166,48911,104312,209,153223,SUNDAY,1,0,10,33,24.1,1010,Fair
11/19/2023 22:00,39,102,49854,74324,141,124178,SUNDAY,1,0,8.9,40,14.8,1011.9,Cloudy
11/19/2023 23:00,32,67,102933,40735,99,143668,SUNDAY,1,0,8.3,48,18.4,1012.7,Cloudy
11/20/2023 0:00,8,31,6032,18473,39,24505,MONDAY,0,0,7.8,49,20.5,1013.2,Fair
11/20/2023 1:00,7,23,5625,17519,30,23144,MONDAY,0,0,7.2,53,18.4,1014.1,Fair
11/20/2023 2:00,5,11,6494,5408,16,11902,MONDAY,0,0,7.2,53,18.4,1014.1,Fair
11/20/2023 3:00,2,10,1039,6501,12,7540,MONDAY,0,0,5,62,18.4,1016.1,Fair
11/20/2023 4:00,3,13,2010,8750,16,10760,MONDAY,0,0,4.4,65,13,1017.2,Fair
11/20/2023 5:00,4,49,2182,33661,53,35843,MONDAY,0,0,3.9,59,14.8,1018.3,Fair
11/20/2023 6:00,21,140,13653,90841,161,104494,MONDAY,0,0,3.9,59,14.8,1018.3,Clear
11/20/2023 7:00,45,390,395894,361913,435,757807,MONDAY,0,0,2.2,56,18.4,1020.1,Clear
11/20/2023 8:00,69,804,50583,605457,873,656040,MONDAY,0,0,2.2,54,18.4,1020.8,Clear
11/20/2023 9:00,44,445,84124,338042,489,422166,MONDAY,0,0,1.7,58,20.5,1022,Fair
11/20/2023 10:00,58,247,87571,199179,305,286750,MONDAY,0,0,1.1,59,22.3,1023.2,Cloudy
11/20/2023 11:00,40,271,45534,208059,311,253593,MONDAY,0,0,1.1,59,22.3,1023.2,Fair
11/20/2023 12:00,70,344,85694,219711,414,305405,MONDAY,0,0,1.1,46,22.3,1026.3,Fair
11/20/2023 13:00,68,320,70153,219729,388,289882,MONDAY,0,0,1.7,44,24.1,1027,Fair
11/20/2023 14:00,77,329,82870,230825,406,313695,MONDAY,0,0,2.8,40,27.7,1027.4,Fair
11/20/2023 15:00,79,424,102395,381743,503,484138,MONDAY,0,0,3.3,39,24.1,1027.4,Fair
11/20/2023 16:00,109,646,124605,592220,755,716825,MONDAY,0,0,3.3,39,24.1,1027.4,Fair
11/20/2023 17:00,100,696,191893,541225,796,733118,MONDAY,0,0,3.9,36,18.4,1027.4,Fair
11/20/2023 18:00,84,572,76679,436912,656,513591,MONDAY,0,0,4.4,33,18.4,1028,Fair
11/20/2023 19:00,62,382,55183,290668,444,345851,MONDAY,0,0,3.9,34,18.4,1028.8,Fair
11/20/2023 20:00,33,277,25301,226258,310,251559,MONDAY,0,0,3.9,34,18.4,1028.8,Fair
11/20/2023 21:00,24,151,108038,95554,175,203592,MONDAY,0,0,2.8,37,18.4,1031,Fair
11/20/2023 22:00,34,104,32815,120976,138,153791,MONDAY,0,0,1.7,40,14.8,1032.1,Cloudy
11/20/2023 23:00,18,60,23860,41291,78,65151,MONDAY,0,0,1.1,43,16.6,1032.6,Fair
11/21/2023 0:00,7,36,5761,69011,43,74772,TUESDAY,0,0,0.6,45,14.8,1033.6,Clear
11/21/2023 1:00,5,6,2991,4146,11,7137,TUESDAY,0,0,0.6,45,14.8,1033.6,Clear
11/21/2023 2:00,2,8,899,3147,10,4046,TUESDAY,0,0,-0.6,51,14.8,1034.5,Clear
11/21/2023 3:00,3,6,2404,5199,9,7603,TUESDAY,0,0,-0.6,51,14.8,1034.5,Clear
11/21/2023 4:00,10,12,12648,8804,22,21452,TUESDAY,0,0,-1.1,53,14.8,1034.8,Clear
11/21/2023 5:00,9,45,5083,105431,54,110514,TUESDAY,0,0,-1.7,56,13,1034.9,Fair
11/21/2023 6:00,18,141,10226,91502,159,101728,TUESDAY,0,0,-1.7,56,13,1034.9,Fair
11/21/2023 7:00,40,383,48491,296488,423,344979,TUESDAY,0,0,-2.2,58,13,1034.9,Fair
11/21/2023 8:00,75,769,903722,728932,844,1632654,TUESDAY,0,0,-1.7,56,16.6,1035.2,Fair
11/21/2023 9:00,71,473,110633,506064,544,616697,TUESDAY,0,0,-2.2,60,13,1035.2,Fair
11/21/2023 10:00,52,272,54955,223285,324,278240,TUESDAY,0,0,-2.8,60,13,1035.2,Cloudy
11/21/2023 11:00,55,294,73341,212698,349,286039,TUESDAY,0,0,-2.8,60,13,1035.2,Fair
11/21/2023 12:00,63,386,64045,312898,449,376943,TUESDAY,0,0,-1.1,58,13,1035.8,Fair
11/21/2023 13:00,75,318,173430,241036,393,414466,TUESDAY,0,0,1.1,56,13,1035.4,Fair
11/21/2023 14:00,76,361,122818,344984,437,467802,TUESDAY,0,0,2.8,57,7.6,1035.4,Fair
11/21/2023 15:00,77,438,101422,314865,515,416287,TUESDAY,0,0,2.8,57,7.6,1035.4,Fair
11/21/2023 16:00,105,619,199592,468964,724,668556,TUESDAY,0,0,5,48,11.2,1033.6,Cloudy
11/21/2023 17:00,85,731,94782,692239,816,787021,TUESDAY,0,0,5,51,13,1033.7,Cloudy
11/21/2023 18:00,89,527,83307,548257,616,631564,TUESDAY,0,0,5,51,14.8,1033.2,Cloudy
11/21/2023 19:00,43,356,44295,289559,399,333854,TUESDAY,0,0,5,51,14.8,1033.2,Cloudy
11/21/2023 20:00,38,273,38726,198828,311,237554,TUESDAY,0,0,5,51,20.5,1032.1,Cloudy
11/21/2023 21:00,29,180,66341,134442,209,200783,TUESDAY,0,0,4.4,55,14.8,1032,Cloudy
11/21/2023 22:00,20,113,21547,72323,133,93870,TUESDAY,0,0,4.4,57,18.4,1031.4,Cloudy
11/21/2023 23:00,14,38,102670,22510,52,125180,TUESDAY,0,0,4.4,57,20.5,1030.6,Cloudy
11/22/2023 0:00,5,13,5369,8198,18,13567,WEDNESDAY,0,0,4.4,60,20.5,1030.1,Cloudy
11/22/2023 1:00,2,4,18338,2787,6,21125,WEDNESDAY,0,0,4.4,60,22.3,1030.1,Cloudy
11/22/2023 2:00,6,5,4511,2259,11,6770,WEDNESDAY,0,0,5,62,25.9,1028.9,Rain
11/22/2023 3:00,0,3,0,1416,3,1416,WEDNESDAY,0,0,5,67,25.9,1026.6,Rain
11/22/2023 4:00,4,5,3015,4235,9,7250,WEDNESDAY,0,0,4.4,79,25.9,1025.8,Rain
11/22/2023 5:00,2,26,1925,18715,28,20640,WEDNESDAY,0,0,4.4,79,24.1,1025.8,Rain
11/22/2023 6:00,7,66,5098,43888,73,48986,WEDNESDAY,0,0,3.3,89,24.1,1022.8,Rain
11/22/2023 7:00,4,66,1226,45443,70,46669,WEDNESDAY,0,0,4.4,93,24.1,1020.4,Rain
11/22/2023 8:00,7,115,7825,101038,122,108863,WEDNESDAY,0,0,6.1,89,29.5,1019.3,Rain
11/22/2023 9:00,3,108,2341,64534,111,66875,WEDNESDAY,0,0,6.7,89,29.5,1016.5,Rain
11/22/2023 10:00,12,82,7741,48115,94,55856,WEDNESDAY,0,0,6.7,89,38.9,1016.5,Rain
11/22/2023 11:00,12,96,26637,59987,108,86624,WEDNESDAY,0,0,7.8,93,37.1,1012.7,Rain
11/22/2023 12:00,25,140,19764,78980,165,98744,WEDNESDAY,0,0,8.3,93,33.5,1011,Rain
11/22/2023 13:00,24,158,38934,109992,182,148926,WEDNESDAY,0,0,8.9,93,31.7,1008.7,Rain
11/22/2023 14:00,40,225,137230,168914,265,306144,WEDNESDAY,0,0,9.4,97,18.4,1007.4,Rain
11/22/2023 15:00,59,301,74618,300890,360,375508,WEDNESDAY,0,0,9.4,97,18.4,1007.4,Rain
11/22/2023 16:00,42,334,134818,494134,376,628952,WEDNESDAY,0,0,10.6,100,11.2,1002.8,Rain
11/22/2023 17:00,65,320,144103,246090,385,390193,WEDNESDAY,0,0,10.6,100,16.6,1001.1,Rain
11/22/2023 18:00,62,318,139831,461456,380,601287,WEDNESDAY,0,0,11.1,100,13,999.1,Rain
11/22/2023 19:00,29,225,38777,155137,254,193914,WEDNESDAY,0,0,11.1,100,13,999.1,Cloudy
11/22/2023 20:00,31,181,260877,169538,212,430415,WEDNESDAY,0,0,11.1,100,20.5,998.5,Cloudy
11/22/2023 21:00,25,129,28315,96413,154,124728,WEDNESDAY,0,0,9.4,100,27.7,999.9,Cloudy
11/22/2023 22:00,38,105,51847,78158,143,130005,WEDNESDAY,0,0,7.2,97,22.3,1000.4,Cloudy
11/22/2023 23:00,14,81,12123,54245,95,66368,WEDNESDAY,0,0,7.2,97,22.3,1000.4,Cloudy
11/23/2023 0:00,10,43,7823,32094,53,39917,THURSDAY,0,1,6.7,93,20.5,1001.5,Cloudy
11/23/2023 1:00,51,30,91350,126851,81,218201,THURSDAY,0,1,6.1,89,16.6,1001.8,Cloudy
11/23/2023 2:00,8,6,11086,2923,14,14009,THURSDAY,0,1,6.1,89,20.5,1001.3,Cloudy
11/23/2023 3:00,9,3,10467,2224,12,12691,THURSDAY,0,1,6.1,86,16.6,1001,Cloudy
11/23/2023 4:00,5,2,5796,1173,7,6969,THURSDAY,0,1,5.6,89,14.8,1001.4,Cloudy
11/23/2023 5:00,8,8,21662,9002,16,30664,THURSDAY,0,1,5.6,89,14.8,1001.4,Cloudy
11/23/2023 6:00,4,29,4179,20114,33,24293,THURSDAY,0,1,5,89,11.2,1002,Cloudy
11/23/2023 7:00,8,69,7251,59511,77,66762,THURSDAY,0,1,5,89,13,1002.3,Cloudy
11/23/2023 8:00,27,87,38518,151568,114,190086,THURSDAY,0,1,5,89,13,1002.8,Cloudy
11/23/2023 9:00,42,136,102279,99221,178,201500,THURSDAY,0,1,5,89,14.8,1002.9,Cloudy
11/23/2023 10:00,60,171,947114,105490,231,1052604,THURSDAY,0,1,5,89,14.8,1002.9,Cloudy
11/23/2023 11:00,92,222,193010,280808,314,473818,THURSDAY,0,1,5.6,82,20.5,1004.9,Cloudy
11/23/2023 12:00,130,225,258983,210707,355,469690,THURSDAY,0,1,6.1,79,27.7,1005.6,Cloudy
11/23/2023 13:00,139,177,374669,145591,316,520260,THURSDAY,0,1,7.2,71,24.1,1006.1,Cloudy
11/23/2023 14:00,156,209,330806,188858,365,519664,THURSDAY,0,1,7.8,68,33.5,1006.6,Cloudy
11/23/2023 15:00,148,218,640778,206703,366,847481,THURSDAY,0,1,7.8,68,29.5,1006.6,Cloudy
11/23/2023 16:00,87,177,131289,151418,264,282707,THURSDAY,0,1,10,56,25.9,1005.8,Cloudy
11/23/2023 17:00,59,147,540333,262864,206,803197,THURSDAY,0,1,11.1,54,20.5,1006.4,Fair
11/23/2023 18:00,47,103,66401,74104,150,140505,THURSDAY,0,1,10.6,52,16.6,1006.7,Fair
11/23/2023 19:00,19,92,29934,77107,111,107041,THURSDAY,0,1,11.1,48,22.3,1007.5,Fair
11/23/2023 20:00,56,64,70955,47583,120,118538,THURSDAY,0,1,11.1,48,22.3,1007.5,Fair
11/23/2023 21:00,37,81,60798,156823,118,217621,THURSDAY,0,1,8.9,54,18.4,1009.7,Fair
11/23/2023 22:00,33,78,98487,55431,111,153918,THURSDAY,0,1,7.8,55,22.3,1010.7,Cloudy
11/23/2023 23:00,15,46,14939,90111,61,105050,THURSDAY,0,1,7.2,58,20.5,1011.5,Fair
11/24/2023 0:00,20,37,65979,33075,57,99054,FRIDAY,0,0,7.2,58,20.5,1011.5,Fair
11/24/2023 1:00,9,17,105677,17805,26,123482,FRIDAY,0,0,7.2,60,16.6,1011.9,Fair
11/24/2023 2:00,9,13,24778,6541,22,31319,FRIDAY,0,0,7.2,63,14.8,1013.2,Fair
11/24/2023 3:00,10,8,12429,6336,18,18765,FRIDAY,0,0,7.8,60,18.4,1013.4,Fair
11/24/2023 4:00,6,5,52039,3227,11,55266,FRIDAY,0,0,7.8,60,13,1013.5,Fair
11/24/2023 5:00,5,17,3633,10804,22,14437,FRIDAY,0,0,7.8,60,13,1013.5,Clear
11/24/2023 6:00,10,45,34487,29744,55,64231,FRIDAY,0,0,7.2,63,11.2,1014.3,Clear
11/24/2023 7:00,8,79,6828,45921,87,52749,FRIDAY,0,0,5.6,70,14.8,1014.5,Clear
11/24/2023 8:00,19,103,24147,169493,122,193640,FRIDAY,0,0,6.7,68,13,1014.8,Clear
11/24/2023 9:00,53,160,152496,879543,213,1032039,FRIDAY,0,0,5,73,14.8,1015.4,Fair
11/24/2023 10:00,73,178,140747,144402,251,285149,FRIDAY,0,0,5,73,14.8,1015.4,Cloudy
11/24/2023 11:00,127,228,222907,179671,355,402578,FRIDAY,0,0,4.4,76,16.6,1016.5,Fair
11/24/2023 12:00,120,251,240748,214753,371,455501,FRIDAY,0,0,6.1,68,14.8,1017,Fair
11/24/2023 13:00,150,275,265449,211839,425,477288,FRIDAY,0,0,7.8,53,20.5,1017.4,Fair
11/24/2023 14:00,168,298,268619,372770,466,641389,FRIDAY,0,0,7.8,53,20.5,1017.4,Fair
11/24/2023 15:00,154,316,217409,270174,470,487583,FRIDAY,0,0,9.4,46,13,1016.8,Fair
11/24/2023 16:00,93,308,166412,243294,401,409706,FRIDAY,0,0,8.9,44,18.4,1016.2,Fair
11/24/2023 17:00,72,252,124161,184060,324,308221,FRIDAY,0,0,9.4,36,22.3,1015.8,Cloudy
11/24/2023 18:00,46,203,197817,147777,249,345594,FRIDAY,0,0,9.4,33,22.3,1015.8,Cloudy
11/24/2023 19:00,49,185,140175,145427,234,285602,FRIDAY,0,0,9.4,33,22.3,1015.8,Cloudy
11/24/2023 20:00,29,130,97601,87313,159,184914,FRIDAY,0,0,7.2,37,22.3,1017.3,Cloudy
11/24/2023 21:00,30,88,34643,68756,118,103399,FRIDAY,0,0,6.1,43,27.7,1018.6,Cloudy
11/24/2023 22:00,14,62,11887,43459,76,55346,FRIDAY,0,0,4.4,44,25.9,1019.8,Cloudy
11/24/2023 23:00,17,47,52348,24542,64,76890,FRIDAY,0,0,3.3,48,25.9,1020.4,Fair
11/25/2023 0:00,12,28,10759,18783,40,29542,SATURDAY,1,0,3.3,48,25.9,1020.4,Fair
11/25/2023 1:00,23,18,23874,57857,41,81731,SATURDAY,1,0,1.7,49,25.9,1022.4,Fair
11/25/2023 2:00,15,11,104554,15006,26,119560,SATURDAY,1,0,0.6,47,25.9,1023.2,Clear
11/25/2023 3:00,3,7,1800,94134,10,95934,SATURDAY,1,0,-0.6,39,25.9,1024.3,Clear
11/25/2023 4:00,0,7,0,5204,7,5204,SATURDAY,1,0,-1.1,43,25.9,1025.1,Clear
11/25/2023 5:00,3,6,4256,6703,9,10959,SATURDAY,1,0,-1.1,43,25.9,1025.1,Clear
11/25/2023 6:00,7,26,5568,18522,33,24090,SATURDAY,1,0,-1.7,43,16.6,1026.2,Clear
11/25/2023 7:00,11,40,17435,23949,51,41384,SATURDAY,1,0,-2.2,44,13,1026.8,Clear
11/25/2023 8:00,16,65,15878,47175,81,63053,SATURDAY,1,0,-2.2,44,16.6,1027.1,Clear
11/25/2023 9:00,49,142,168541,191702,191,360243,SATURDAY,1,0,-2.2,44,16.6,1027.1,Clear
11/25/2023 10:00,45,178,106500,148233,223,254733,SATURDAY,1,0,-2.2,44,18.4,1028.2,Fair
11/25/2023 11:00,59,224,90417,186650,283,277067,SATURDAY,1,0,-2.8,48,13,1028.9,Fair
11/25/2023 12:00,84,311,234062,188710,395,422772,SATURDAY,1,0,-2.2,44,16.6,1029.5,Fair
11/25/2023 13:00,93,245,155313,180413,338,335726,SATURDAY,1,0,-1.7,41,20.5,1029.7,Fair
11/25/2023 14:00,109,291,269015,226163,400,495178,SATURDAY,1,0,-1.7,41,20.5,1029.7,Fair
11/25/2023 15:00,108,288,135017,294044,396,429061,SATURDAY,1,0,0,38,14.8,1029.7,Fair
11/25/2023 16:00,91,274,147310,206971,365,354281,SATURDAY,1,0,1.7,32,13,1029.2,Fair
11/25/2023 17:00,50,238,64010,159308,288,223318,SATURDAY,1,0,1.7,32,9.4,1028.5,Fair
11/25/2023 18:00,46,221,46858,156003,267,202861,SATURDAY,1,0,2.8,30,13,1027.9,Fair
11/25/2023 19:00,58,220,246196,137862,278,384058,SATURDAY,1,0,2.8,30,13,1027.9,Fair
11/25/2023 20:00,25,137,114410,80278,162,194688,SATURDAY,1,0,1.7,35,14.8,1028.2,Cloudy
11/25/2023 21:00,29,94,104797,110557,123,215354,SATURDAY,1,0,1.7,35,13,1028.2,Cloudy
11/25/2023 22:00,33,90,55489,64597,123,120086,SATURDAY,1,0,1.1,36,11.2,1028.1,Cloudy
11/25/2023 23:00,24,60,22025,47400,84,69425,SATURDAY,1,0,1.1,38,13,1028,Cloudy
11/26/2023 0:00,21,46,149414,27906,67,177320,SUNDAY,1,0,1.1,38,13,1028,Fair
11/26/2023 1:00,32,38,50801,32442,70,83243,SUNDAY,1,0,-0.6,49,14.8,1027.6,Fair
11/26/2023 2:00,15,15,23346,10128,30,33474,SUNDAY,1,0,0,45,13,1027.4,Fair
11/26/2023 3:00,1,2,68331,1774,3,70105,SUNDAY,1,0,-0.6,49,14.8,1027.1,Fair
11/26/2023 4:00,2,8,3450,6028,10,9478,SUNDAY,1,0,-0.6,49,14.8,1027,Fair
11/26/2023 5:00,6,10,8072,5598,16,13670,SUNDAY,1,0,-0.6,49,14.8,1027,Fair
11/26/2023 6:00,3,26,2157,15000,29,17157,SUNDAY,1,0,-1.1,51,14.8,1026.9,Cloudy
11/26/2023 7:00,9,43,9448,33760,52,43208,SUNDAY,1,0,-1.1,55,13,1026.8,Cloudy
11/26/2023 8:00,16,82,14017,79481,98,93498,SUNDAY,1,0,-1.1,55,16.6,1026.9,Cloudy
11/26/2023 9:00,41,157,46858,196517,198,243375,SUNDAY,1,0,-1.1,55,16.6,1026.9,Cloudy
11/26/2023 10:00,63,259,94713,176540,322,271253,SUNDAY,1,0,-1.7,63,13,1026.7,Cloudy
11/26/2023 11:00,61,290,199198,269063,351,468261,SUNDAY,1,0,-1.1,63,14.8,1026.6,Cloudy
11/26/2023 12:00,101,350,148902,234792,451,383694,SUNDAY,1,0,1.1,56,14.8,1026.6,Fair
11/26/2023 13:00,115,357,169866,292905,472,462771,SUNDAY,1,0,3.3,57,11.2,1026.7,Cloudy
11/26/2023 14:00,97,345,320720,366881,442,687601,SUNDAY,1,0,3.3,57,11.2,1026.7,Cloudy
11/26/2023 15:00,110,364,207937,282691,474,490628,SUNDAY,1,0,4.4,55,7.6,1025.2,Cloudy
11/26/2023 16:00,90,355,125516,259891,445,385407,SUNDAY,1,0,5.6,53,11.2,1024,Cloudy
11/26/2023 17:00,74,275,225735,201317,349,427052,SUNDAY,1,0,6.1,57,7.6,1023.5,Cloudy
11/26/2023 18:00,44,288,44793,202584,332,247377,SUNDAY,1,0,7.2,56,9.4,1022.8,Cloudy
11/26/2023 19:00,53,270,65351,148331,323,213682,SUNDAY,1,0,7.2,56,9.4,1022.8,Cloudy
11/26/2023 20:00,45,207,39955,124099,252,164054,SUNDAY,1,0,7.2,65,14.8,1021.6,Cloudy
11/26/2023 21:00,26,153,22661,87347,179,110008,SUNDAY,1,0,6.7,70,16.6,1021.1,Cloudy
11/26/2023 22:00,15,84,290463,50197,99,340660,SUNDAY,1,0,6.1,73,16.6,1020.5,Cloudy
11/26/2023 23:00,10,41,9571,26873,51,36444,SUNDAY,1,0,6.1,73,22.3,1020.5,Cloudy
11/27/2023 0:00,3,21,2952,12220,24,15172,MONDAY,0,0,6.1,79,16.6,1018.4,Rain
11/27/2023 1:00,0,5,0,3686,5,3686,MONDAY,0,0,6.7,82,18.4,1017.4,Rain
11/27/2023 2:00,0,2,0,433,2,433,MONDAY,0,0,6.7,82,18.4,1017.4,Rain
11/27/2023 3:00,1,2,605,861,3,1466,MONDAY,0,0,7.2,90,22.3,1012.4,Rain
11/27/2023 4:00,7,9,4982,8050,16,13032,MONDAY,0,0,7.2,90,27.7,1012.4,Rain
11/27/2023 5:00,6,61,3694,81249,67,84943,MONDAY,0,0,8.9,93,27.7,1007.1,Rain
11/27/2023 6:00,14,173,9210,135193,187,144403,MONDAY,0,0,9.4,93,27.7,1004,Rain
11/27/2023 7:00,59,421,45697,349892,480,395589,MONDAY,0,0,10,93,37.1,1000.3,Rain
11/27/2023 8:00,107,835,110156,762793,942,872949,MONDAY,0,0,11.1,97,40.7,998.4,Rain
11/27/2023 9:00,75,502,108708,376507,577,485215,MONDAY,0,0,11.1,97,31.7,998.4,Rain
11/27/2023 10:00,69,292,310645,284703,361,595348,MONDAY,0,0,10,96,16.6,1000,Rain
11/27/2023 11:00,86,310,213528,275837,396,489365,MONDAY,0,0,8.9,89,29.5,1001.4,Rain
11/27/2023 12:00,92,357,251927,253743,449,505670,MONDAY,0,0,8.3,83,27.7,1003,Rain
11/27/2023 13:00,97,325,303946,255834,422,559780,MONDAY,0,0,8.3,76,25.9,1003.4,Rain
11/27/2023 14:00,85,376,81400,276671,461,358071,MONDAY,0,0,8.3,76,25.9,1003.4,Cloudy
11/27/2023 15:00,90,467,169817,462972,557,632789,MONDAY,0,0,10.6,61,24.1,1003.3,Cloudy
11/27/2023 16:00,123,701,186452,601952,824,788404,MONDAY,0,0,11.7,59,16.6,1002.7,Fair
11/27/2023 17:00,144,915,167620,1159699,1059,1327319,MONDAY,0,0,10.6,56,22.3,1002.7,Fair
11/27/2023 18:00,110,622,105889,552322,732,658211,MONDAY,0,0,10,56,25.9,1003,Cloudy
11/27/2023 19:00,73,458,66374,302134,531,368508,MONDAY,0,0,10,56,25.9,1003,Cloudy
11/27/2023 20:00,43,375,32528,239298,418,271826,MONDAY,0,0,7.8,53,24.1,1004.2,Cloudy
11/27/2023 21:00,27,223,26115,134760,250,160875,MONDAY,0,0,7.8,51,16.6,1005.1,Cloudy
11/27/2023 22:00,33,126,29009,98443,159,127452,MONDAY,0,0,8.3,49,14.8,1005.6,Fair
11/27/2023 23:00,21,66,20199,44777,87,64976,MONDAY,0,0,8.3,49,14.8,1005.6,Fair
11/28/2023 0:00,11,25,12788,14671,36,27459,TUESDAY,0,0,6.1,49,18.4,1005.8,Fair
11/28/2023 1:00,6,12,5721,9724,18,15445,TUESDAY,0,0,5.6,49,22.3,1006.1,Fair
11/28/2023 2:00,1,10,1644,4317,11,5961,TUESDAY,0,0,4.4,51,18.4,1005.8,Fair
11/28/2023 3:00,1,7,348,4084,8,4432,TUESDAY,0,0,3.9,52,13,1005.8,Fair
11/28/2023 4:00,4,11,3382,9500,15,12882,TUESDAY,0,0,3.9,52,13,1005.8,Fair
11/28/2023 5:00,8,53,7646,81696,61,89342,TUESDAY,0,0,3.3,52,24.1,1005.8,Fair
11/28/2023 6:00,23,173,18674,126926,196,145600,TUESDAY,0,0,2.8,57,16.6,1006,Fair
11/28/2023 7:00,57,501,45025,393086,558,438111,TUESDAY,0,0,2.2,62,18.4,1005.6,Fair
11/28/2023 8:00,126,1038,119977,812302,1164,932279,TUESDAY,0,0,2.2,59,14.8,1004.7,Fair
11/28/2023 9:00,59,545,83495,522074,604,605569,TUESDAY,0,0,2.2,59,14.8,1004.7,Fair
11/28/2023 10:00,52,306,53641,331198,358,384839,TUESDAY,0,0,2.2,64,18.4,1005.4,Cloudy
11/28/2023 11:00,76,281,167512,249074,357,416586,TUESDAY,0,0,2.2,62,20.5,1005.8,Cloudy
11/28/2023 12:00,68,324,89839,243223,392,333062,TUESDAY,0,0,2.2,54,22.3,1006.3,Fair
11/28/2023 13:00,76,315,159212,340764,391,499976,TUESDAY,0,0,2.2,54,22.3,1006.3,Fair
11/28/2023 14:00,71,329,61781,263946,400,325727,TUESDAY,0,0,3.3,42,25.9,1005.9,Fair
11/28/2023 15:00,80,433,85987,318841,513,404828,TUESDAY,0,0,3.9,34,33.5,1005.1,Fair
11/28/2023 16:00,97,729,102418,570889,826,673307,TUESDAY,0,0,4.4,33,29.5,1004.9,Fair
11/28/2023 17:00,140,874,421890,849974,1014,1271864,TUESDAY,0,0,3.3,32,29.5,1005,Fair
11/28/2023 18:00,77,654,745588,608627,731,1354215,TUESDAY,0,0,3.3,32,29.5,1005,Fair
11/28/2023 19:00,70,403,89598,302123,473,391721,TUESDAY,0,0,2.8,32,22.3,1005.8,Fair
11/28/2023 20:00,32,256,36591,176713,288,213304,TUESDAY,0,0,2.2,34,22.3,1006.4,Fair
11/28/2023 21:00,33,181,28091,141890,214,169981,TUESDAY,0,0,1.7,36,31.7,1007.4,Fair
11/28/2023 22:00,34,116,23089,116438,150,139527,TUESDAY,0,0,1.1,40,24.1,1007.7,Cloudy
11/28/2023 23:00,16,63,12887,42775,79,55662,TUESDAY,0,0,1.1,40,24.1,1007.7,Fair
11/29/2023 0:00,7,25,7314,13508,32,20822,WEDNESDAY,0,0,0.6,47,24.1,1008.5,Fair
11/29/2023 1:00,4,11,2872,4934,15,7806,WEDNESDAY,0,0,0,49,27.7,1009.1,Fair
11/29/2023 2:00,3,4,2408,2161,7,4569,WEDNESDAY,0,0,0,47,27.7,1009.3,Fair
11/29/2023 3:00,0,7,0,4181,7,4181,WEDNESDAY,0,0,-0.6,51,33.5,1009.8,Fair
11/29/2023 4:00,3,18,1688,15495,21,17183,WEDNESDAY,0,0,-0.6,51,33.5,1009.8,Clear
11/29/2023 5:00,7,57,6665,40131,64,46796,WEDNESDAY,0,0,-0.6,51,24.1,1011.2,Fair
11/29/2023 6:00,13,141,10869,101675,154,112544,WEDNESDAY,0,0,-1.1,53,18.4,1012.3,Clear
11/29/2023 7:00,48,494,41083,427534,542,468617,WEDNESDAY,0,0,-1.1,53,14.8,1012.9,Clear
11/29/2023 8:00,98,898,141980,690622,996,832602,WEDNESDAY,0,0,-1.1,53,16.6,1013.7,Clear
11/29/2023 9:00,63,524,93301,527761,587,621062,WEDNESDAY,0,0,-1.1,53,16.6,1013.7,Clear
11/29/2023 10:00,34,303,38843,224851,337,263694,WEDNESDAY,0,0,-1.7,51,27.7,1015.7,Clear
11/29/2023 11:00,57,319,57301,344042,376,401343,WEDNESDAY,0,0,-1.7,46,24.1,1016.3,Fair
11/29/2023 12:00,66,311,70498,237904,377,308402,WEDNESDAY,0,0,-1.1,43,14.8,1016.9,Fair
11/29/2023 13:00,59,313,77143,305175,372,382318,WEDNESDAY,0,0,-1.1,43,14.8,1016.9,Fair
11/29/2023 14:00,81,326,185187,217620,407,402807,WEDNESDAY,0,0,0.6,39,18.4,1017.3,Fair
11/29/2023 15:00,97,397,204558,391715,494,596273,WEDNESDAY,0,0,1.7,38,27.7,1016.9,Fair
11/29/2023 16:00,98,652,192750,499120,750,691870,WEDNESDAY,0,0,2.2,42,29.5,1016.4,Fair
11/29/2023 17:00,110,864,137352,728097,974,865449,WEDNESDAY,0,0,2.2,42,29.5,1016.3,Fair
11/29/2023 18:00,90,646,90660,561707,736,652367,WEDNESDAY,0,0,2.2,42,20.5,1016.2,Fair
11/29/2023 19:00,60,402,53361,696656,462,750017,WEDNESDAY,0,0,2.2,42,20.5,1016.2,Cloudy
11/29/2023 20:00,38,269,39948,198982,307,238930,WEDNESDAY,0,0,1.7,42,13,1016.1,Cloudy
11/29/2023 21:00,27,209,19695,239337,236,259032,WEDNESDAY,0,0,1.1,43,14.8,1016.5,Cloudy
11/29/2023 22:00,25,146,76611,145865,171,222476,WEDNESDAY,0,0,1.1,43,14.8,1016.6,Cloudy
11/29/2023 23:00,17,55,25599,39653,72,65252,WEDNESDAY,0,0,1.1,43,14.8,1016.6,Cloudy
11/30/2023 0:00,11,28,8650,15020,39,23670,THURSDAY,0,0,-0.6,54,13,1016.9,Fair
11/30/2023 1:00,1,7,66059,4868,8,70927,THURSDAY,0,0,-0.6,54,16.6,1017,Fair
11/30/2023 2:00,0,4,0,2500,4,2500,THURSDAY,0,0,-1.1,58,13,1017.2,Fair
11/30/2023 3:00,2,4,2965,4082,6,7047,THURSDAY,0,0,-1.1,58,13,1017.2,Fair
11/30/2023 4:00,3,10,3416,5712,13,9128,THURSDAY,0,0,-1.1,55,14.8,1017.3,Fair
11/30/2023 5:00,4,61,2353,42302,65,44655,THURSDAY,0,0,-1.1,53,14.8,1016.8,Fair
11/30/2023 6:00,12,158,9941,119509,170,129450,THURSDAY,0,0,-1.1,53,16.6,1017,Fair
11/30/2023 7:00,71,458,165462,381221,529,546683,THURSDAY,0,0,-1.1,53,16.6,1017,Fair
11/30/2023 8:00,110,943,96562,755036,1053,851598,THURSDAY,0,0,-0.6,51,14.8,1016.8,Fair
11/30/2023 9:00,74,555,92614,394464,629,487078,THURSDAY,0,0,0,51,14.8,1017.8,Fair
11/30/2023 10:00,81,318,105257,231756,399,337013,THURSDAY,0,0,-0.6,54,14.8,1018.4,Cloudy
11/30/2023 11:00,67,321,112773,276846,388,389619,THURSDAY,0,0,-0.6,54,13,1019.1,Fair
11/30/2023 12:00,71,376,108837,274250,447,383087,THURSDAY,0,0,-0.6,54,13,1019.1,Fair
11/30/2023 13:00,86,344,109046,269740,430,378786,THURSDAY,0,0,0,51,18.4,1019.6,Fair
11/30/2023 14:00,83,424,92547,312074,507,404621,THURSDAY,0,0,1.7,45,18.4,1020.1,Fair
11/30/2023 15:00,129,497,189143,389158,626,578301,THURSDAY,0,0,3.9,42,20.5,1020.1,Fair
11/30/2023 16:00,134,702,243669,591209,836,834878,THURSDAY,0,0,6.7,41,14.8,1018.8,Fair
11/30/2023 17:00,188,928,247396,776219,1116,1023615,THURSDAY,0,0,7.2,42,18.4,1018.1,Fair
11/30/2023 18:00,158,684,283545,543520,842,827065,THURSDAY,0,0,7.2,42,18.4,1018.1,Fair
11/30/2023 19:00,96,477,139640,456078,573,595718,THURSDAY,0,0,7.8,42,24.1,1017.6,Fair
11/30/2023 20:00,50,348,81755,389328,398,471083,THURSDAY,0,0,7.8,42,24.1,1017.6,Fair
11/30/2023 21:00,69,272,92525,208329,341,300854,THURSDAY,0,0,5.6,53,14.8,1018.5,Fair
11/30/2023 22:00,67,195,129209,150924,262,280133,THURSDAY,0,0,6.1,51,14.8,1018.5,Cloudy
11/30/2023 23:00,36,116,42013,86977,152,128990,THURSDAY,0,0,6.1,51,31.7,1018.5,Cloudy
12/1/2023 0:00,39,48,325198,34992,87,360190,FRIDAY,0,0,5,62,20.5,1019.1,Fair
12/1/2023 1:00,15,23,17988,21622,38,39610,FRIDAY,0,0,5.6,62,20.5,1018.9,Fair
12/1/2023 2:00,7,10,305364,5679,17,311043,FRIDAY,0,0,5,67,16.6,1018.6,Fair
12/1/2023 3:00,4,9,92272,5776,13,98048,FRIDAY,0,0,5,67,16.6,1018.6,Cloudy
12/1/2023 4:00,9,10,301049,7905,19,308954,FRIDAY,0,0,5.6,70,18.4,1018.9,Fair
12/1/2023 5:00,10,52,7075,32874,62,39949,FRIDAY,0,0,5.6,73,25.9,1018.9,Fair
12/1/2023 6:00,25,152,21549,138793,177,160342,FRIDAY,0,0,5,76,18.4,1019.5,Fair
12/1/2023 7:00,58,355,70890,298719,413,369609,FRIDAY,0,0,6.1,73,22.3,1019.3,Fair
12/1/2023 8:00,86,721,91762,621061,807,712823,FRIDAY,0,0,6.1,73,22.3,1019.3,Fair
12/1/2023 9:00,90,558,178348,444527,648,622875,FRIDAY,0,0,6.1,73,25.9,1019.5,Fair
12/1/2023 10:00,81,348,110206,281843,429,392049,FRIDAY,0,0,5.6,76,20.5,1019.8,Fair
12/1/2023 11:00,97,375,128677,454194,472,582871,FRIDAY,0,0,5.6,73,18.4,1020.2,Fair
12/1/2023 12:00,115,406,243295,294240,521,537535,FRIDAY,0,0,6.7,73,18.4,1020.5,Fair
12/1/2023 13:00,137,421,179565,299133,558,478698,FRIDAY,0,0,6.7,73,18.4,1020.5,Fair
12/1/2023 14:00,132,440,1140493,351051,572,1491544,FRIDAY,0,0,10,61,20.5,1020.8,Fair
12/1/2023 15:00,159,540,189474,486892,699,676366,FRIDAY,0,0,10.6,56,16.6,1019.8,Fair
12/1/2023 16:00,120,495,134476,380669,615,515145,FRIDAY,0,0,11.1,54,16.6,1019.4,Cloudy
12/1/2023 17:00,112,624,122626,570995,736,693621,FRIDAY,0,0,11.1,54,16.6,1019.4,Cloudy
12/1/2023 18:00,127,530,155243,508416,657,663659,FRIDAY,0,0,11.1,57,14.8,1019.5,Cloudy
12/1/2023 19:00,100,326,108583,267041,426,375624,FRIDAY,0,0,11.1,57,14.8,1019.1,Cloudy
12/1/2023 20:00,65,220,219359,190295,285,409654,FRIDAY,0,0,10.6,61,13,1018.6,Cloudy
12/1/2023 21:00,41,146,57234,123144,187,180378,FRIDAY,0,0,9.4,69,20.5,1018.9,Cloudy
12/1/2023 22:00,73,168,83772,168264,241,252036,FRIDAY,0,0,9.4,69,20.5,1018.9,Cloudy
12/1/2023 23:00,59,128,61202,142185,187,203387,FRIDAY,0,0,9.4,71,5.4,1019,Cloudy
12/2/2023 0:00,56,117,80151,88398,173,168549,SATURDAY,1,0,8.3,76,11.2,1019.2,Cloudy
12/2/2023 1:00,72,85,779770,85961,157,865731,SATURDAY,1,0,8.3,80,9.4,1018,Cloudy
12/2/2023 2:00,42,33,88411,25646,75,114057,SATURDAY,1,0,8.3,80,9.4,1018,Rain
12/2/2023 3:00,11,15,10261,26800,26,37061,SATURDAY,1,0,7.8,86,9.4,1018.2,Rain
12/2/2023 4:00,7,15,11975,13557,22,25532,SATURDAY,1,0,7.8,93,7.6,1016.7,Rain
12/2/2023 5:00,3,20,3182,16350,23,19532,SATURDAY,1,0,7.8,93,7.6,1016,Rain
12/2/2023 6:00,13,34,11278,34865,47,46143,SATURDAY,1,0,7.2,100,5.4,1015.9,Cloudy
12/2/2023 7:00,25,79,36065,60035,104,96100,SATURDAY,1,0,7.2,100,5.4,1015.9,Cloudy
12/2/2023 8:00,47,151,157140,120216,198,277356,SATURDAY,1,0,8.3,97,7.6,1015.6,Cloudy
12/2/2023 9:00,94,283,2570066,290506,377,2860572,SATURDAY,1,0,8.9,96,9.4,1015,Cloudy
12/2/2023 10:00,118,379,165084,369361,497,534445,SATURDAY,1,0,8.9,89,13,1015.4,Cloudy
12/2/2023 11:00,174,437,439170,336421,611,775591,SATURDAY,1,0,8.9,86,11.2,1015.6,Cloudy
12/2/2023 12:00,189,484,371974,352406,673,724380,SATURDAY,1,0,8.9,86,13,1015.8,Cloudy
12/2/2023 13:00,212,517,385997,423928,729,809925,SATURDAY,1,0,8.9,86,13,1015.8,Cloudy
12/2/2023 14:00,276,532,638383,437377,808,1075760,SATURDAY,1,0,8.9,89,14.8,1015.7,Cloudy
12/2/2023 15:00,255,552,503872,664921,807,1168793,SATURDAY,1,0,9.4,90,9.4,1014.7,Cloudy
12/2/2023 16:00,234,511,8022659,461602,745,8484261,SATURDAY,1,0,9.4,86,16.6,1015,Cloudy
12/2/2023 17:00,166,420,1104779,331518,586,1436297,SATURDAY,1,0,9.4,86,16.6,1015,Cloudy
12/2/2023 18:00,147,440,258213,410245,587,668458,SATURDAY,1,0,10,83,16.6,1014.9,Cloudy
12/2/2023 19:00,165,378,364441,381948,543,746389,SATURDAY,1,0,10,83,13,1015.5,Cloudy
12/2/2023 20:00,110,273,234369,210670,383,445039,SATURDAY,1,0,9.4,83,9.4,1015.8,Cloudy
12/2/2023 21:00,91,240,1402533,176461,331,1578994,SATURDAY,1,0,9.4,83,9.4,1016.2,Cloudy
12/2/2023 22:00,141,179,194091,231861,320,425952,SATURDAY,1,0,9.4,83,9.4,1016.2,Cloudy
12/2/2023 23:00,132,167,255029,196474,299,451503,SATURDAY,1,0,8.9,86,11.2,1016.8,Cloudy
12/3/2023 0:00,111,134,190396,107882,245,298278,SUNDAY,1,0,9.4,83,7.6,1017.2,Cloudy
12/3/2023 1:00,102,93,627893,75041,195,702934,SUNDAY,1,0,6.7,93,5.4,1017.3,Cloudy
12/3/2023 2:00,55,57,69169,59466,112,128635,SUNDAY,1,0,6.7,93,5.4,1017.3,Cloudy
12/3/2023 3:00,7,19,7212,11326,26,18538,SUNDAY,1,0,6.7,96,0,1017.7,Cloudy
12/3/2023 4:00,4,11,2718,10414,15,13132,SUNDAY,1,0,7.2,97,0,1017.9,Cloudy
12/3/2023 5:00,4,14,4704,30919,18,35623,SUNDAY,1,0,6.1,93,9.4,1017.3,Cloudy
12/3/2023 6:00,9,38,4645,44469,47,49114,SUNDAY,1,0,6.1,93,9.4,1017.7,Cloudy
12/3/2023 7:00,12,40,9557,41024,52,50581,SUNDAY,1,0,6.1,93,9.4,1017.7,Cloudy
12/3/2023 8:00,19,75,24957,48867,94,73824,SUNDAY,1,0,6.7,93,13,1017.4,Cloudy
12/3/2023 9:00,21,123,19070,88749,144,107819,SUNDAY,1,0,7.2,90,24.1,1017.1,Cloudy
12/3/2023 10:00,19,135,14088,177854,154,191942,SUNDAY,1,0,7.2,90,24.1,1017.4,Cloudy
12/3/2023 11:00,23,103,25974,72768,126,98742,SUNDAY,1,0,7.2,86,24.1,1016.9,Rain
12/3/2023 12:00,28,151,17991,177161,179,195152,SUNDAY,1,0,7.2,86,24.1,1016.9,Rain
12/3/2023 13:00,29,133,24673,97668,162,122341,SUNDAY,1,0,7.2,90,24.1,1015.9,Rain
12/3/2023 14:00,21,113,19419,80513,134,99932,SUNDAY,1,0,7.2,93,29.5,1015.3,Rain
12/3/2023 15:00,21,110,26551,77577,131,104128,SUNDAY,1,0,6.7,93,25.9,1014.7,Rain
12/3/2023 16:00,37,168,33356,115853,205,149209,SUNDAY,1,0,7.2,90,25.9,1013.1,Rain
12/3/2023 17:00,23,149,21569,99432,172,121001,SUNDAY,1,0,7.2,90,25.9,1013.1,Rain
12/3/2023 18:00,18,134,14020,91863,152,105883,SUNDAY,1,0,7.2,90,29.5,1011.1,Rain
12/3/2023 19:00,20,81,17433,43103,101,60536,SUNDAY,1,0,7.2,90,29.5,1011.1,Rain
12/3/2023 20:00,12,67,101484,47083,79,148567,SUNDAY,1,0,6.7,96,25.9,1010.9,Rain
12/3/2023 21:00,14,55,12014,38485,69,50499,SUNDAY,1,0,6.7,89,33.5,1009.7,Cloudy
12/3/2023 22:00,20,46,14875,29316,66,44191,SUNDAY,1,0,6.7,93,24.1,1008.7,Rain
12/3/2023 23:00,8,40,5205,26135,48,31340,SUNDAY,1,0,7.8,93,27.7,1006.6,Rain
12/4/2023 0:00,5,13,8037,6004,18,14041,MONDAY,0,0,7.8,96,20.5,1006.5,Rain
12/4/2023 1:00,4,9,3077,4999,13,8076,MONDAY,0,0,7.8,96,20.5,1006.5,Rain
12/4/2023 2:00,4,6,3272,3547,10,6819,MONDAY,0,0,7.8,96,27.7,1004.8,Rain
12/4/2023 3:00,3,7,4079,5857,10,9936,MONDAY,0,0,7.8,96,29.5,1004,Rain
12/4/2023 4:00,5,10,2527,5730,15,8257,MONDAY,0,0,7.8,96,29.5,1004,Rain
12/4/2023 5:00,8,53,26223,38781,61,65004,MONDAY,0,0,7.8,96,20.5,1003.8,Rain
12/4/2023 6:00,22,142,21720,146411,164,168131,MONDAY,0,0,7.8,96,14.8,1003.3,Rain
12/4/2023 7:00,60,438,61854,562720,498,624574,MONDAY,0,0,7.8,100,5.4,1003.5,Rain
12/4/2023 8:00,115,829,128278,785820,944,914098,MONDAY,0,0,5,96,18.4,1003.9,Cloudy
12/4/2023 9:00,61,494,99995,498577,555,598572,MONDAY,0,0,5,96,18.4,1003.9,Rain
12/4/2023 10:00,54,300,136424,252603,354,389027,MONDAY,0,0,4.4,100,13,1003.8,Cloudy
12/4/2023 11:00,60,289,64338,200427,349,264765,MONDAY,0,0,3.9,96,14.8,1005.5,Cloudy
12/4/2023 12:00,79,342,104823,226636,421,331459,MONDAY,0,0,3.9,96,14.8,1005.5,Cloudy
12/4/2023 13:00,76,362,106620,436362,438,542982,MONDAY,0,0,4.4,93,13,1006.6,Cloudy
12/4/2023 14:00,100,333,294779,260585,433,555364,MONDAY,0,0,5,93,13,1007,Cloudy
12/4/2023 15:00,100,425,188023,473379,525,661402,MONDAY,0,0,7.2,82,9.4,1006.6,Cloudy
12/4/2023 16:00,122,662,231135,895656,784,1126791,MONDAY,0,0,8.3,76,9.4,1005.3,Cloudy
12/4/2023 17:00,128,846,138600,719565,974,858165,MONDAY,0,0,8.3,76,9.4,1005.3,Cloudy
12/4/2023 18:00,126,652,391903,751414,778,1143317,MONDAY,0,0,7.2,82,11.2,1005.9,Cloudy
12/4/2023 19:00,88,455,106555,344758,543,451313,MONDAY,0,0,7.2,86,9.4,1006.1,Cloudy
12/4/2023 20:00,59,331,51386,348551,390,399937,MONDAY,0,0,7.2,86,9.4,1006.3,Cloudy
12/4/2023 21:00,47,231,53856,258611,278,312467,MONDAY,0,0,6.1,89,14.8,1006.1,Cloudy
12/4/2023 22:00,25,146,61741,191264,171,253005,MONDAY,0,0,6.1,89,14.8,1006.1,Cloudy
12/4/2023 23:00,21,68,35156,46849,89,82005,MONDAY,0,0,6.7,89,7.6,1007.9,Cloudy
12/5/2023 0:00,17,39,35441,26025,56,61466,TUESDAY,0,0,6.1,93,7.6,1008.2,Cloudy
12/5/2023 1:00,7,16,8958,9164,23,18122,TUESDAY,0,0,6.1,97,0,1008.2,Cloudy
12/5/2023 2:00,1,11,1626,5608,12,7234,TUESDAY,0,0,6.1,97,0,1008.2,Cloudy
12/5/2023 3:00,2,3,8942,1303,5,10245,TUESDAY,0,0,6.7,76,14.8,1008.3,Cloudy
12/5/2023 4:00,3,9,1936,8981,12,10917,TUESDAY,0,0,5,86,7.6,1008.3,Cloudy
12/5/2023 5:00,9,67,7243,43182,76,50425,TUESDAY,0,0,5,86,7.6,1008.3,Cloudy
12/5/2023 6:00,16,168,41041,120189,184,161230,TUESDAY,0,0,5.6,76,20.5,1008.4,Cloudy
12/5/2023 7:00,66,503,63188,426974,569,490162,TUESDAY,0,0,4.4,86,16.6,1009.5,Cloudy
12/5/2023 8:00,87,932,86789,780697,1019,867486,TUESDAY,0,0,3.3,86,16.6,1011.1,Cloudy
12/5/2023 9:00,67,517,82121,404903,584,487024,TUESDAY,0,0,2.8,82,18.4,1011.7,Cloudy
12/5/2023 10:00,57,306,130120,216451,363,346571,TUESDAY,0,0,2.8,82,18.4,1013,Cloudy
12/5/2023 11:00,68,297,90312,245265,365,335577,TUESDAY,0,0,2.2,85,16.6,1013.8,Cloudy
12/5/2023 12:00,74,316,83532,229685,390,313217,TUESDAY,0,0,2.2,85,16.6,1013.8,Cloudy
12/5/2023 13:00,78,297,88141,218285,375,306426,TUESDAY,0,0,2.2,67,22.3,1015,Cloudy
12/5/2023 14:00,75,351,561565,337253,426,898818,TUESDAY,0,0,2.8,64,18.4,1015.9,Cloudy
12/5/2023 15:00,82,420,172447,338304,502,510751,TUESDAY,0,0,2.8,64,18.4,1015.9,Cloudy
12/5/2023 16:00,93,651,125220,486217,744,611437,TUESDAY,0,0,2.8,64,13,1015.7,Cloudy
12/5/2023 17:00,144,860,228699,762874,1004,991573,TUESDAY,0,0,2.8,64,11.2,1015.4,Cloudy
12/5/2023 18:00,124,679,118143,647019,803,765162,TUESDAY,0,0,2.8,64,9.4,1016,Cloudy
12/5/2023 19:00,80,431,71369,539763,511,611132,TUESDAY,0,0,2.8,59,11.2,1016.7,Cloudy
12/5/2023 20:00,57,281,49255,250752,338,300007,TUESDAY,0,0,2.8,59,13,1016.8,Cloudy
12/5/2023 21:00,39,216,39016,154341,255,193357,TUESDAY,0,0,2.8,59,13,1016.8,Cloudy
12/5/2023 22:00,30,139,121373,106967,169,228340,TUESDAY,0,0,2.2,67,11.2,1016.9,Cloudy
12/5/2023 23:00,22,75,25274,65575,97,90849,TUESDAY,0,0,1.7,66,14.8,1017.2,Cloudy
12/6/2023 0:00,12,33,9976,51181,45,61157,WEDNESDAY,0,0,1.1,73,13,1017.5,Cloudy
12/6/2023 1:00,9,13,7239,6028,22,13267,WEDNESDAY,0,0,1.1,73,14.8,1017.8,Cloudy
12/6/2023 2:00,2,8,1211,4058,10,5269,WEDNESDAY,0,0,1.1,73,14.8,1017.8,Cloudy
12/6/2023 3:00,3,4,3242,3630,7,6872,WEDNESDAY,0,0,0,69,16.6,1017.4,Cloudy
12/6/2023 4:00,3,13,2505,11874,16,14379,WEDNESDAY,0,0,0,72,9.4,1017.1,Cloudy
12/6/2023 5:00,9,48,32848,67311,57,100159,WEDNESDAY,0,0,-0.6,72,16.6,1016.4,Cloudy
12/6/2023 6:00,15,161,9511,103698,176,113209,WEDNESDAY,0,0,-0.6,72,16.6,1016.4,Cloudy
12/6/2023 7:00,47,376,41281,309492,423,350773,WEDNESDAY,0,0,-1.1,78,13,1016,Cloudy
12/6/2023 8:00,72,723,84725,573317,795,658042,WEDNESDAY,0,0,-1.1,81,14.8,1015.5,Cloudy
12/6/2023 9:00,46,482,47577,350294,528,397871,WEDNESDAY,0,0,-1.1,81,14.8,1015.5,Cloudy
12/6/2023 10:00,38,271,52594,168087,309,220681,WEDNESDAY,0,0,-0.6,82,16.6,1016,Cloudy
12/6/2023 11:00,45,287,39050,206044,332,245094,WEDNESDAY,0,0,-0.6,82,18.4,1015.7,Cloudy
12/6/2023 12:00,53,316,64079,224704,369,288783,WEDNESDAY,0,0,-0.6,82,18.4,1016,Cloudy
12/6/2023 13:00,44,258,41394,184257,302,225651,WEDNESDAY,0,0,-0.6,85,22.3,1015.8,Cloudy
12/6/2023 14:00,64,312,56003,223863,376,279866,WEDNESDAY,0,0,-0.6,82,18.4,1015.8,Cloudy
12/6/2023 15:00,74,409,159431,290762,483,450193,WEDNESDAY,0,0,-0.6,82,18.4,1015.8,Cloudy
12/6/2023 16:00,82,535,103795,792469,617,896264,WEDNESDAY,0,0,0,75,16.6,1015,Cloudy
12/6/2023 17:00,89,787,83714,896999,876,980713,WEDNESDAY,0,0,1.1,69,16.6,1013.9,Cloudy
12/6/2023 18:00,88,577,202214,446499,665,648713,WEDNESDAY,0,0,1.1,69,18.4,1013.6,Cloudy
12/6/2023 19:00,56,400,52273,432351,456,484624,WEDNESDAY,0,0,0.6,69,18.4,1013.7,Cloudy
12/6/2023 20:00,34,240,26257,164444,274,190701,WEDNESDAY,0,0,-0.6,72,18.4,1013.9,Cloudy
12/6/2023 21:00,47,177,41183,168012,224,209195,WEDNESDAY,0,0,-0.6,72,18.4,1013.9,Cloudy
12/6/2023 22:00,28,130,22270,85991,158,108261,WEDNESDAY,0,0,-1.7,72,16.6,1014.3,Cloudy
12/6/2023 23:00,13,70,11830,80838,83,92668,WEDNESDAY,0,0,-2.2,75,14.8,1014.5,Cloudy
12/7/2023 0:00,13,38,8636,20598,51,29234,THURSDAY,0,0,-2.2,71,9.4,1014.5,Fair
12/7/2023 1:00,6,16,4825,8490,22,13315,THURSDAY,0,0,-2.2,71,18.4,1014.7,Fair
12/7/2023 2:00,3,12,1080,6656,15,7736,THURSDAY,0,0,-2.2,71,18.4,1014.7,Fair
12/7/2023 3:00,4,7,2667,7046,11,9713,THURSDAY,0,0,-2.8,63,18.4,1015.2,Fair
12/7/2023 4:00,1,7,427,7553,8,7980,THURSDAY,0,0,-3.3,63,24.1,1015.1,Clear
12/7/2023 5:00,6,45,3912,33206,51,37118,THURSDAY,0,0,-3.9,66,18.4,1015.2,Clear
12/7/2023 6:00,9,118,6744,94591,127,101335,THURSDAY,0,0,-3.9,66,18.4,1015.2,Clear
12/7/2023 7:00,42,371,37347,286612,413,323959,THURSDAY,0,0,-4.4,65,20.5,1015.7,Clear
12/7/2023 8:00,70,749,67194,601309,819,668503,THURSDAY,0,0,-5,65,22.3,1015.5,Clear
12/7/2023 9:00,44,457,41524,336538,501,378062,THURSDAY,0,0,-5.6,68,14.8,1015.5,Fair
12/7/2023 10:00,49,257,141631,177484,306,319115,THURSDAY,0,0,-5.6,65,18.4,1015.7,Clear
12/7/2023 11:00,29,257,27900,221595,286,249495,THURSDAY,0,0,-5.6,65,18.4,1015.7,Cloudy
12/7/2023 12:00,41,284,123267,175230,325,298497,THURSDAY,0,0,-5.6,62,13,1016.1,Cloudy
12/7/2023 13:00,68,267,174154,174690,335,348844,THURSDAY,0,0,-5,59,13,1016.3,Cloudy
12/7/2023 14:00,52,259,146632,185946,311,332578,THURSDAY,0,0,-3.9,57,14.8,1016,Cloudy
12/7/2023 15:00,61,336,62411,564674,397,627085,THURSDAY,0,0,-2.8,53,16.6,1015.2,Cloudy
12/7/2023 16:00,81,521,175990,400172,602,576162,THURSDAY,0,0,-2.8,53,16.6,1015.2,Cloudy
12/7/2023 17:00,96,739,117085,1142457,835,1259542,THURSDAY,0,0,-1.7,45,14.8,1013.4,Cloudy
12/7/2023 18:00,69,511,148273,829960,580,978233,THURSDAY,0,0,-1.1,41,13,1013,Cloudy
12/7/2023 19:00,45,350,39008,325026,395,364034,THURSDAY,0,0,-0.6,47,9.4,1013.1,Fair
12/7/2023 20:00,35,254,28823,189975,289,218798,THURSDAY,0,0,-0.6,47,9.4,1013.1,Fair
12/7/2023 21:00,34,233,117950,440025,267,557975,THURSDAY,0,0,0.6,41,14.8,1013.8,Fair
12/7/2023 22:00,30,126,29844,110171,156,140015,THURSDAY,0,0,0,45,13,1014.2,Cloudy
12/7/2023 23:00,20,86,15769,52046,106,67815,THURSDAY,0,0,0,45,16.6,1014.8,Fair
12/8/2023 0:00,18,41,10500,24768,59,35268,FRIDAY,0,0,0,54,14.8,1015.5,Fair
12/8/2023 1:00,6,24,5865,16366,30,22231,FRIDAY,0,0,-0.6,56,14.8,1015.7,Fair
12/8/2023 2:00,8,7,10580,6393,15,16973,FRIDAY,0,0,-0.6,56,14.8,1015.7,Fair
12/8/2023 3:00,1,4,402,2577,5,2979,FRIDAY,0,0,-1.1,60,16.6,1016.4,Fair
12/8/2023 4:00,2,14,876,9088,16,9964,FRIDAY,0,0,-1.1,66,14.8,1016.5,Fair
12/8/2023 5:00,6,34,4697,28461,40,33158,FRIDAY,0,0,-1.1,66,14.8,1016.9,Fair
12/8/2023 6:00,15,108,14873,74251,123,89124,FRIDAY,0,0,-1.1,66,14.8,1016.9,Clear
12/8/2023 7:00,31,257,23147,211474,288,234621,FRIDAY,0,0,-1.7,72,9.4,1018,Clear
12/8/2023 8:00,40,594,78432,434164,634,512596,FRIDAY,0,0,-1.1,69,11.2,1018.6,Clear
12/8/2023 9:00,54,427,83422,285654,481,369076,FRIDAY,0,0,-1.1,69,5.4,1019.6,Fair
12/8/2023 10:00,47,271,48499,192659,318,241158,FRIDAY,0,0,-1.1,75,0,1020.2,Cloudy
12/8/2023 11:00,66,284,74964,192934,350,267898,FRIDAY,0,0,-1.1,75,0,1020.2,Cloudy
12/8/2023 12:00,68,290,92431,224008,358,316439,FRIDAY,0,0,0,72,7.6,1021.6,Fair
12/8/2023 13:00,72,334,93647,516551,406,610198,FRIDAY,0,0,1.7,64,11.2,1022.3,Fair
12/8/2023 14:00,101,378,197809,273182,479,470991,FRIDAY,0,0,3.3,62,9.4,1022.7,Fair
12/8/2023 15:00,105,468,284526,579961,573,864487,FRIDAY,0,0,3.9,62,0,1022.6,Fair
12/8/2023 16:00,104,557,207154,604389,661,811543,FRIDAY,0,0,3.9,62,0,1022.6,Fair
12/8/2023 17:00,116,558,215960,449539,674,665499,FRIDAY,0,0,5,60,11.2,1021.7,Fair
12/8/2023 18:00,128,519,225910,385156,647,611066,FRIDAY,0,0,4.4,62,11.2,1021.9,Fair
12/8/2023 19:00,100,342,106551,428338,442,534889,FRIDAY,0,0,4.4,65,9.4,1022.2,Cloudy
12/8/2023 20:00,45,216,67265,341689,261,408954,FRIDAY,0,0,4.4,65,9.4,1022.2,Cloudy
12/8/2023 21:00,53,192,75936,468291,245,544227,FRIDAY,0,0,3.9,67,9.4,1023.6,Cloudy
12/8/2023 22:00,102,178,491566,182874,280,674440,FRIDAY,0,0,3.3,73,16.6,1023.9,Cloudy
12/8/2023 23:00,55,126,54778,89650,181,144428,FRIDAY,0,0,3.3,76,14.8,1024.6,Cloudy
12/9/2023 0:00,66,118,188790,261198,184,449988,SATURDAY,1,0,2.8,76,7.6,1024.8,Cloudy
12/9/2023 1:00,52,63,60220,146456,115,206676,SATURDAY,1,0,2.8,76,7.6,1024.8,Fair
12/9/2023 2:00,31,40,172037,126625,71,298662,SATURDAY,1,0,1.7,82,9.4,1024.7,Fair
12/9/2023 3:00,10,14,21882,9135,24,31017,SATURDAY,1,0,1.7,85,9.4,1025,Cloudy
12/9/2023 4:00,2,13,891,7105,15,7996,SATURDAY,1,0,2.2,82,9.4,1025,Fair
12/9/2023 5:00,5,16,10513,12718,21,23231,SATURDAY,1,0,2.2,82,9.4,1025,Cloudy
12/9/2023 6:00,1,27,353,35015,28,35368,SATURDAY,1,0,1.1,88,9.4,1024.9,Cloudy
12/9/2023 7:00,17,75,106607,51265,92,157872,SATURDAY,1,0,2.8,85,7.6,1025.1,Cloudy
12/9/2023 8:00,27,136,27747,120114,163,147861,SATURDAY,1,0,3.3,86,5.4,1025.2,Cloudy
12/9/2023 9:00,62,229,95918,178789,291,274707,SATURDAY,1,0,3.9,86,9.4,1025.5,Cloudy
12/9/2023 10:00,113,340,1184270,343671,453,1527941,SATURDAY,1,0,4.4,86,14.8,1025.3,Cloudy
12/9/2023 11:00,152,423,591329,515417,575,1106746,SATURDAY,1,0,3.9,89,11.2,1025.4,Cloudy
12/9/2023 12:00,204,467,1251030,469002,671,1720032,SATURDAY,1,0,3.9,89,11.2,1025.4,Cloudy
12/9/2023 13:00,175,434,553764,478167,609,1031931,SATURDAY,1,0,6.1,89,9.4,1025.7,Cloudy
12/9/2023 14:00,238,464,1020903,412943,702,1433846,SATURDAY,1,0,7.8,79,5.4,1025.9,Cloudy
12/9/2023 15:00,235,450,1722397,388427,685,2110824,SATURDAY,1,0,7.8,79,5.4,1025.9,Cloudy
12/9/2023 16:00,157,450,338472,386908,607,725380,SATURDAY,1,0,10,71,13,1024.4,Cloudy
12/9/2023 17:00,113,382,940625,274197,495,1214822,SATURDAY,1,0,10,74,9.4,1023.9,Cloudy
12/9/2023 18:00,150,388,1058033,401851,538,1459884,SATURDAY,1,0,8.9,77,11.2,1023.2,Cloudy
12/9/2023 19:00,106,290,1284960,222059,396,1507019,SATURDAY,1,0,8.9,77,11.2,1023.2,Cloudy
12/9/2023 20:00,84,276,89100,198215,360,287315,SATURDAY,1,0,9.4,77,9.4,1023.1,Cloudy
12/9/2023 21:00,88,216,105697,151146,304,256843,SATURDAY,1,0,8.9,80,9.4,1023.1,Cloudy
12/9/2023 22:00,113,161,1034685,143173,274,1177858,SATURDAY,1,0,8.3,83,11.2,1022.5,Cloudy
12/9/2023 23:00,95,122,315108,87412,217,402520,SATURDAY,1,0,7.8,86,11.2,1022.4,Cloudy
12/10/2023 0:00,99,113,259720,99794,212,359514,SUNDAY,1,0,7.8,89,9.4,1021.9,Cloudy
12/10/2023 1:00,119,103,371855,82479,222,454334,SUNDAY,1,0,7.8,89,9.4,1021.9,Cloudy
12/10/2023 2:00,79,70,1276189,76358,149,1352547,SUNDAY,1,0,7.2,93,0,1021.4,Cloudy
12/10/2023 3:00,11,18,9414,12084,29,21498,SUNDAY,1,0,7.2,93,9.4,1020.8,Cloudy
12/10/2023 4:00,8,4,10297,6287,12,16584,SUNDAY,1,0,7.8,93,5.4,1020.1,Cloudy
12/10/2023 5:00,7,12,8011,7492,19,15503,SUNDAY,1,0,8.3,93,9.4,1019.7,Cloudy
12/10/2023 6:00,5,25,7143,21562,30,28705,SUNDAY,1,0,8.3,93,9.4,1019.7,Cloudy
12/10/2023 7:00,25,40,29550,32467,65,62017,SUNDAY,1,0,7.2,100,7.6,1019.3,Cloudy
12/10/2023 8:00,44,110,83548,83889,154,167437,SUNDAY,1,0,7.2,100,7.6,1019.3,Cloudy
12/10/2023 9:00,69,227,94416,233078,296,327494,SUNDAY,1,0,6.7,96,9.4,1018.4,Cloudy
12/10/2023 10:00,95,344,162836,365012,439,527848,SUNDAY,1,0,6.7,100,0,1018.4,Cloudy
12/10/2023 11:00,133,398,220681,314910,531,535591,SUNDAY,1,0,7.8,100,13,1017.2,Cloudy
12/10/2023 12:00,166,464,968253,479646,630,1447899,SUNDAY,1,0,8.9,100,14.8,1017.1,Cloudy
12/10/2023 13:00,145,385,353245,264994,530,618239,SUNDAY,1,0,10,96,16.6,1016.8,Cloudy
12/10/2023 14:00,24,120,82207,104806,144,187013,SUNDAY,1,0,11.1,89,14.8,1016.6,Cloudy
12/10/2023 15:00,35,140,28888,169615,175,198503,SUNDAY,1,0,11.1,89,14.8,1016.6,Cloudy
12/10/2023 16:00,40,199,135838,224932,239,360770,SUNDAY,1,0,13.9,81,18.4,1014.1,Cloudy
12/10/2023 17:00,15,102,12535,112285,117,124820,SUNDAY,1,0,15.6,78,20.5,1013,Rain
12/10/2023 18:00,17,95,28317,161268,112,189585,SUNDAY,1,0,15.6,78,20.5,1013,Rain
12/10/2023 19:00,19,106,12635,74103,125,86738,SUNDAY,1,0,13.9,93,16.6,1012,Rain
12/10/2023 20:00,35,118,99620,80412,153,180032,SUNDAY,1,0,14.4,97,20.5,1011,Rain
12/10/2023 21:00,29,105,95852,74094,134,169946,SUNDAY,1,0,15.6,93,25.9,1010.1,Rain
12/10/2023 22:00,38,88,111726,61132,126,172858,SUNDAY,1,0,15.6,93,27.7,1010.1,Rain
12/10/2023 23:00,2,31,901,18158,33,19059,SUNDAY,1,0,16.1,90,25.9,1008.4,Rain
12/11/2023 0:00,0,12,0,6844,12,6844,MONDAY,0,0,15.6,93,27.7,1007.3,Rain
12/11/2023 1:00,2,7,1785,3855,9,5640,MONDAY,0,0,15.6,93,27.7,1007.3,Rain
12/11/2023 2:00,3,4,52583,1832,7,54415,MONDAY,0,0,15.6,90,25.9,1005.4,Rain
12/11/2023 3:00,0,3,0,1266,3,1266,MONDAY,0,0,15.6,90,25.9,1005.4,Rain
12/11/2023 4:00,1,6,465,2550,7,3015,MONDAY,0,0,16.1,93,40.7,1002.2,Rain
12/11/2023 5:00,2,12,2464,4587,14,7051,MONDAY,0,0,16.1,93,40.7,1002.2,Rain
12/11/2023 6:00,0,44,0,39672,44,39672,MONDAY,0,0,16.7,90,38.9,999.3,Rain
12/11/2023 7:00,12,97,5864,111351,109,117215,MONDAY,0,0,16.7,90,38.9,999.3,Rain
12/11/2023 8:00,12,201,9727,186562,213,196289,MONDAY,0,0,17.8,90,37.1,998,Rain
12/11/2023 9:00,25,256,24478,224688,281,249166,MONDAY,0,0,7.8,93,27.7,999.4,Rain
12/11/2023 10:00,22,214,18417,183641,236,202058,MONDAY,0,0,7.8,93,25.9,999.4,Rain
12/11/2023 11:00,43,231,64771,172235,274,237006,MONDAY,0,0,7.2,97,16.6,998,Rain
12/11/2023 12:00,59,275,456387,321435,334,777822,MONDAY,0,0,7.2,93,13,997.5,Rain
12/11/2023 13:00,51,243,66634,179241,294,245875,MONDAY,0,0,7.2,93,13,997.5,Rain
12/11/2023 14:00,58,314,95519,226967,372,322486,MONDAY,0,0,7.2,93,18.4,998.8,Rain
12/11/2023 15:00,81,381,77616,288017,462,365633,MONDAY,0,0,7.2,82,24.1,999.9,Rain
12/11/2023 16:00,83,530,149739,462432,613,612171,MONDAY,0,0,6.7,73,31.7,1000.8,Rain
12/11/2023 17:00,89,705,95268,542131,794,637399,MONDAY,0,0,6.7,73,31.7,1000.8,Rain
12/11/2023 18:00,84,504,156324,449327,588,605651,MONDAY,0,0,6.7,70,31.7,1002.5,Rain
12/11/2023 19:00,60,343,50605,237805,403,288410,MONDAY,0,0,7.2,65,29.5,1004,Rain
12/11/2023 20:00,38,268,30903,326006,306,356909,MONDAY,0,0,7.2,60,33.5,1004.9,Cloudy
12/11/2023 21:00,22,154,23726,242412,176,266138,MONDAY,0,0,7.2,60,29.5,1006.6,Cloudy
12/11/2023 22:00,27,110,28050,139267,137,167317,MONDAY,0,0,6.7,58,27.7,1008.7,Cloudy
12/11/2023 23:00,14,58,7700,34828,72,42528,MONDAY,0,0,5.6,62,20.5,1010,Cloudy
12/12/2023 0:00,6,37,6513,29053,43,35566,TUESDAY,0,0,5,67,25.9,1011.6,Fair
12/12/2023 1:00,2,26,1595,16270,28,17865,TUESDAY,0,0,5,65,27.7,1013.1,Fair
12/12/2023 2:00,6,8,2111,5426,14,7537,TUESDAY,0,0,4.4,62,27.7,1014.1,Fair
12/12/2023 3:00,5,13,8673,10667,18,19340,TUESDAY,0,0,3.9,62,24.1,1015.2,Fair
12/12/2023 4:00,4,11,20375,7035,15,27410,TUESDAY,0,0,3.3,62,27.7,1016.2,Fair
12/12/2023 5:00,6,47,5259,27615,53,32874,TUESDAY,0,0,2.8,61,24.1,1017.3,Fair
12/12/2023 6:00,17,164,17407,111447,181,128854,TUESDAY,0,0,2.2,59,22.3,1018.4,Fair
12/12/2023 7:00,43,450,112168,330078,493,442246,TUESDAY,0,0,2.2,54,22.3,1019.5,Clear
12/12/2023 8:00,82,828,88807,662995,910,751802,TUESDAY,0,0,1.7,54,20.5,1020.9,Clear
12/12/2023 9:00,59,505,94096,504521,564,598617,TUESDAY,0,0,1.7,54,20.5,1022,Clear
12/12/2023 10:00,49,287,137541,241478,336,379019,TUESDAY,0,0,1.1,59,22.3,1023.3,Cloudy
12/12/2023 11:00,38,262,37326,247229,300,284555,TUESDAY,0,0,1.1,59,13,1024,Fair
12/12/2023 12:00,50,349,103065,295710,399,398775,TUESDAY,0,0,1.1,61,16.6,1024.9,Fair
12/12/2023 13:00,62,290,69627,255768,352,325395,TUESDAY,0,0,2.2,56,18.4,1025.8,Fair
12/12/2023 14:00,68,343,77209,257297,411,334506,TUESDAY,0,0,3.3,55,14.8,1026.6,Fair
12/12/2023 15:00,88,406,98878,348361,494,447239,TUESDAY,0,0,4.4,48,14.8,1027.2,Fair
12/12/2023 16:00,93,646,103831,591251,739,695082,TUESDAY,0,0,4.4,48,14.8,1026.9,Fair
12/12/2023 17:00,117,793,169061,649634,910,818695,TUESDAY,0,0,5.6,49,14.8,1026.7,Fair
12/12/2023 18:00,99,598,100285,449307,697,549592,TUESDAY,0,0,6.7,43,20.5,1026,Fair
12/12/2023 19:00,60,414,52943,306615,474,359558,TUESDAY,0,0,6.7,43,20.5,1026,Fair
12/12/2023 20:00,32,270,119963,194094,302,314057,TUESDAY,0,0,5,45,20.5,1025.9,Fair
12/12/2023 21:00,45,217,138073,161813,262,299886,TUESDAY,0,0,3.9,52,14.8,1025.9,Fair
12/12/2023 22:00,55,147,49750,200586,202,250336,TUESDAY,0,0,3.9,52,16.6,1026.5,Cloudy
12/12/2023 23:00,30,76,29232,104714,106,133946,TUESDAY,0,0,3.9,55,24.1,1026.8,Fair
12/13/2023 0:00,13,40,13706,28374,53,42080,WEDNESDAY,0,0,3.9,55,24.1,1026.8,Fair
12/13/2023 1:00,11,13,158809,7728,24,166537,WEDNESDAY,0,0,2.8,61,20.5,1027.5,Clear
12/13/2023 2:00,9,7,17548,3681,16,21229,WEDNESDAY,0,0,2.2,64,22.3,1027.5,Clear
12/13/2023 3:00,2,5,1384,3438,7,4822,WEDNESDAY,0,0,2.2,67,20.5,1027.1,Clear
12/13/2023 4:00,2,8,1456,6297,10,7753,WEDNESDAY,0,0,2.2,67,20.5,1027.1,Clear
12/13/2023 5:00,5,56,5670,33140,61,38810,WEDNESDAY,0,0,2.8,64,25.9,1026.4,Clear
12/13/2023 6:00,15,151,11286,197049,166,208335,WEDNESDAY,0,0,2.8,64,22.3,1026.6,Clear
12/13/2023 7:00,45,418,56029,333828,463,389857,WEDNESDAY,0,0,3.3,59,24.1,1026.9,Clear
12/13/2023 8:00,81,838,76901,717959,919,794860,WEDNESDAY,0,0,2.8,61,20.5,1026.6,Clear
12/13/2023 9:00,46,517,39781,439983,563,479764,WEDNESDAY,0,0,2.8,61,20.5,1026.6,Fair
12/13/2023 10:00,53,270,50452,191746,323,242198,WEDNESDAY,0,0,3.3,59,22.3,1027.6,Clear
12/13/2023 11:00,60,333,58750,216142,393,274892,WEDNESDAY,0,0,3.9,57,18.4,1027.5,Fair
12/13/2023 12:00,67,305,73720,208432,372,282152,WEDNESDAY,0,0,4.4,55,18.4,1027.9,Fair
12/13/2023 13:00,71,307,170294,236354,378,406648,WEDNESDAY,0,0,5,51,24.1,1028.1,Fair
12/13/2023 14:00,69,331,117602,318961,400,436563,WEDNESDAY,0,0,6.1,45,25.9,1028,Fair
12/13/2023 15:00,89,418,198170,586267,507,784437,WEDNESDAY,0,0,6.1,45,25.9,1028,Fair
12/13/2023 16:00,106,615,388633,550162,721,938795,WEDNESDAY,0,0,6.7,40,18.4,1026.5,Fair
12/13/2023 17:00,103,736,96488,684216,839,780704,WEDNESDAY,0,0,6.1,39,22.3,1026.4,Fair
12/13/2023 18:00,85,543,513581,502373,628,1015954,WEDNESDAY,0,0,6.7,38,18.4,1026.3,Fair
12/13/2023 19:00,59,382,48884,386684,441,435568,WEDNESDAY,0,0,6.7,38,18.4,1026.3,Fair
12/13/2023 20:00,42,267,43309,216670,309,259979,WEDNESDAY,0,0,5,41,24.1,1027.8,Fair
12/13/2023 21:00,38,179,88459,139351,217,227810,WEDNESDAY,0,0,4.4,39,20.5,1028.5,Fair
12/13/2023 22:00,30,108,61276,74323,138,135599,WEDNESDAY,0,0,3.3,44,20.5,1029.4,Cloudy
12/13/2023 23:00,8,85,5997,120115,93,126112,WEDNESDAY,0,0,3.3,44,22.3,1029.8,Fair
12/14/2023 0:00,11,33,12963,19539,44,32502,THURSDAY,0,0,3.3,44,22.3,1029.8,Fair
12/14/2023 1:00,6,30,98329,17542,36,115871,THURSDAY,0,0,1.7,56,18.4,1030,Fair
12/14/2023 2:00,4,8,2483,7030,12,9513,THURSDAY,0,0,1.1,59,18.4,1030.5,Fair
12/14/2023 3:00,2,10,1094,6342,12,7436,THURSDAY,0,0,1.1,50,25.9,1031.3,Clear
12/14/2023 4:00,2,7,1560,7184,9,8744,THURSDAY,0,0,1.1,50,27.7,1031.3,Clear
12/14/2023 5:00,6,44,6102,32552,50,38654,THURSDAY,0,0,0,45,16.6,1031.8,Fair
12/14/2023 6:00,19,125,12789,92980,144,105769,THURSDAY,0,0,-0.6,49,16.6,1032.9,Fair
12/14/2023 7:00,44,382,69969,320514,426,390483,THURSDAY,0,0,-0.6,43,18.4,1033.8,Clear
12/14/2023 8:00,69,692,81626,644801,761,726427,THURSDAY,0,0,-1.1,43,16.6,1034,Clear
12/14/2023 9:00,47,432,49443,342928,479,392371,THURSDAY,0,0,-1.7,45,16.6,1034.4,Clear
12/14/2023 10:00,38,240,40212,279083,278,319295,THURSDAY,0,0,-1.7,45,24.1,1034.4,Clear
12/14/2023 11:00,36,291,49956,297563,327,347519,THURSDAY,0,0,-2.2,48,20.5,1035.8,Cloudy
12/14/2023 12:00,58,267,73172,421350,325,494522,THURSDAY,0,0,-2.2,48,20.5,1035.8,Fair
12/14/2023 13:00,53,253,168368,298518,306,466886,THURSDAY,0,0,-1.1,47,22.3,1036.6,Fair
12/14/2023 14:00,73,291,154562,481824,364,636386,THURSDAY,0,0,-1.1,47,22.3,1036.6,Fair
12/14/2023 15:00,64,384,61327,278373,448,339700,THURSDAY,0,0,0,41,20.5,1036.2,Fair
12/14/2023 16:00,97,529,89859,495245,626,585104,THURSDAY,0,0,1.1,40,24.1,1035.3,Fair
12/14/2023 17:00,132,714,256373,653961,846,910334,THURSDAY,0,0,1.7,36,20.5,1034,Fair
12/14/2023 18:00,129,584,459774,470765,713,930539,THURSDAY,0,0,2.2,32,13,1033.7,Fair
12/14/2023 19:00,91,347,136969,285371,438,422340,THURSDAY,0,0,2.2,32,13,1033.7,Fair
12/14/2023 20:00,52,269,70761,298563,321,369324,THURSDAY,0,0,1.7,30,22.3,1033.2,Fair
12/14/2023 21:00,44,190,129284,138408,234,267692,THURSDAY,0,0,1.1,33,13,1032.8,Fair
12/14/2023 22:00,43,148,131530,110946,191,242476,THURSDAY,0,0,1.1,38,16.6,1032.5,Cloudy
12/14/2023 23:00,29,85,62634,56028,114,118662,THURSDAY,0,0,0,43,14.8,1032.4,Fair
12/15/2023 0:00,19,44,35399,30468,63,65867,FRIDAY,0,0,0,43,14.8,1032.4,Fair
12/15/2023 1:00,10,26,203796,19643,36,223439,FRIDAY,0,0,0,51,18.4,1031.6,Clear
12/15/2023 2:00,10,9,7744,5618,19,13362,FRIDAY,0,0,0,51,18.4,1030.2,Fair
12/15/2023 3:00,2,8,1250,4404,10,5654,FRIDAY,0,0,0,54,22.3,1029.5,Fair
12/15/2023 4:00,7,7,22552,3368,14,25920,FRIDAY,0,0,0,54,22.3,1029.5,Fair
12/15/2023 5:00,9,46,5686,35181,55,40867,FRIDAY,0,0,0.6,58,20.5,1027.2,Fair
12/15/2023 6:00,17,117,16088,85681,134,101769,FRIDAY,0,0,0,64,20.5,1026.8,Fair
12/15/2023 7:00,29,282,38478,219151,311,257629,FRIDAY,0,0,0,64,16.6,1026.1,Fair
12/15/2023 8:00,54,491,51128,359188,545,410316,FRIDAY,0,0,0.6,63,22.3,1025.3,Fair
12/15/2023 9:00,46,411,132863,278588,457,411451,FRIDAY,0,0,0.6,63,22.3,1025.3,Fair
12/15/2023 10:00,74,290,353043,213165,364,566208,FRIDAY,0,0,2.2,59,18.4,1024.2,Clear
12/15/2023 11:00,68,276,447257,202691,344,649948,FRIDAY,0,0,1.7,61,18.4,1023.9,Fair
12/15/2023 12:00,92,329,153309,338371,421,491680,FRIDAY,0,0,2.8,59,22.3,1023.4,Fair
12/15/2023 13:00,122,342,265104,252065,464,517169,FRIDAY,0,0,4.4,55,22.3,1023.4,Fair
12/15/2023 14:00,124,436,454692,323172,560,777864,FRIDAY,0,0,4.4,55,22.3,1023.4,Fair
12/15/2023 15:00,130,474,267203,446219,604,713422,FRIDAY,0,0,7.8,51,16.6,1022.5,Fair
12/15/2023 16:00,150,553,680624,546533,703,1227157,FRIDAY,0,0,8.9,50,13,1021.6,Fair
12/15/2023 17:00,168,628,1770958,523248,796,2294206,FRIDAY,0,0,11.1,48,18.4,1020.8,Fair
12/15/2023 18:00,145,479,365963,378519,624,744482,FRIDAY,0,0,11.7,47,18.4,1020.2,Fair
12/15/2023 19:00,116,365,635407,252800,481,888207,FRIDAY,0,0,11.7,47,18.4,1020.2,Fair
12/15/2023 20:00,71,272,176335,316227,343,492562,FRIDAY,0,0,12.8,49,13,1020.9,Cloudy
12/15/2023 21:00,77,200,110275,163409,277,273684,FRIDAY,0,0,12.2,50,16.6,1021.2,Cloudy
12/15/2023 22:00,79,185,102454,139834,264,242288,FRIDAY,0,0,11.7,54,14.8,1021.6,Fair
12/15/2023 23:00,57,141,178809,199546,198,378355,FRIDAY,0,0,11.7,54,14.8,1021.6,Fair
12/16/2023 0:00,71,110,157008,78120,181,235128,SATURDAY,1,0,10,58,13,1022.5,Fair
12/16/2023 1:00,77,56,104367,50972,133,155339,SATURDAY,1,0,9.4,59,14.8,1023.2,Fair
12/16/2023 2:00,36,39,38952,30505,75,69457,SATURDAY,1,0,10,50,14.8,1023.6,Fair
12/16/2023 3:00,13,13,15969,6839,26,22808,SATURDAY,1,0,8.9,54,9.4,1024.1,Clear
12/16/2023 4:00,4,18,1566,10885,22,12451,SATURDAY,1,0,8.9,54,9.4,1024.1,Clear
12/16/2023 5:00,6,17,6370,16788,23,23158,SATURDAY,1,0,8.3,56,14.8,1024.5,Clear
12/16/2023 6:00,6,23,4108,15333,29,19441,SATURDAY,1,0,7.2,60,11.2,1025.3,Clear
12/16/2023 7:00,13,54,12833,44127,67,56960,SATURDAY,1,0,7.2,60,14.8,1025.8,Clear
12/16/2023 8:00,31,127,41571,170801,158,212372,SATURDAY,1,0,7.2,60,14.8,1025.8,Fair
12/16/2023 9:00,74,245,410624,190544,319,601168,SATURDAY,1,0,6.1,65,13,1027,Fair
12/16/2023 10:00,96,298,117837,219826,394,337663,SATURDAY,1,0,6.7,62,16.6,1028.1,Clear
12/16/2023 11:00,151,366,281777,396041,517,677818,SATURDAY,1,0,6.7,62,13,1029,Fair
12/16/2023 12:00,207,443,468667,372333,650,841000,SATURDAY,1,0,7.2,65,14.8,1029.9,Fair
12/16/2023 13:00,224,431,724415,371271,655,1095686,SATURDAY,1,0,7.2,65,14.8,1029.9,Fair
12/16/2023 14:00,196,423,374882,368070,619,742952,SATURDAY,1,0,9.4,50,18.4,1032,Fair
12/16/2023 15:00,196,399,451348,347437,595,798785,SATURDAY,1,0,10,50,14.8,1032,Fair
12/16/2023 16:00,164,365,1427670,300578,529,1728248,SATURDAY,1,0,10,54,13,1031.7,Fair
12/16/2023 17:00,98,329,176160,265110,427,441270,SATURDAY,1,0,10,54,13,1031.7,Cloudy
12/16/2023 18:00,81,320,119895,468098,401,587993,SATURDAY,1,0,9.4,61,18.4,1031.9,Cloudy
12/16/2023 19:00,89,244,363211,186460,333,549671,SATURDAY,1,0,7.8,71,20.5,1033.8,Cloudy
12/16/2023 20:00,55,162,69736,114478,217,184214,SATURDAY,1,0,7.2,68,18.4,1034.7,Cloudy
12/16/2023 21:00,46,152,132135,112452,198,244587,SATURDAY,1,0,6.1,68,18.4,1035.5,Cloudy
12/16/2023 22:00,58,126,109160,224593,184,333753,SATURDAY,1,0,5.6,73,13,1035.9,Cloudy
12/16/2023 23:00,41,107,50388,87859,148,138247,SATURDAY,1,0,5.6,73,13,1035.9,Cloudy
12/17/2023 0:00,71,81,221627,54734,152,276361,SUNDAY,1,0,5.6,76,18.4,1035.7,Fair
12/17/2023 1:00,56,60,298986,37956,116,336942,SUNDAY,1,0,5,79,16.6,1036.2,Cloudy
12/17/2023 2:00,33,30,131606,26086,63,157692,SUNDAY,1,0,5,79,16.6,1036.2,Cloudy
12/17/2023 3:00,11,12,14752,7801,23,22553,SUNDAY,1,0,5.6,79,20.5,1036.4,Cloudy
12/17/2023 4:00,3,8,6731,5255,11,11986,SUNDAY,1,0,5,82,11.2,1036.1,Cloudy
12/17/2023 5:00,4,12,5699,8939,16,14638,SUNDAY,1,0,5.6,79,14.8,1035.3,Cloudy
12/17/2023 6:00,8,17,7621,9813,25,17434,SUNDAY,1,0,6.1,76,14.8,1035.4,Cloudy
12/17/2023 7:00,10,50,9485,37566,60,47051,SUNDAY,1,0,6.1,76,14.8,1035.1,Cloudy
12/17/2023 8:00,18,121,28957,189067,139,218024,SUNDAY,1,0,6.1,76,14.8,1035.1,Cloudy
12/17/2023 9:00,34,194,30168,132491,228,162659,SUNDAY,1,0,6.1,76,13,1034.4,Cloudy
12/17/2023 10:00,94,258,145035,197691,352,342726,SUNDAY,1,0,5.6,76,13,1034,Cloudy
12/17/2023 11:00,121,284,190012,206020,405,396032,SUNDAY,1,0,5,82,14.8,1032.6,Cloudy
12/17/2023 12:00,128,329,181594,257020,457,438614,SUNDAY,1,0,6.1,82,16.6,1032.3,Cloudy
12/17/2023 13:00,122,331,252087,268459,453,520546,SUNDAY,1,0,6.1,82,16.6,1032.3,Cloudy
12/17/2023 14:00,117,332,167113,300934,449,468047,SUNDAY,1,0,7.8,86,20.5,1031.4,Cloudy
12/17/2023 15:00,120,307,243673,422069,427,665742,SUNDAY,1,0,8.9,83,20.5,1030,Cloudy
12/17/2023 16:00,93,306,194301,338278,399,532579,SUNDAY,1,0,8.9,83,20.5,1030,Cloudy
12/17/2023 17:00,41,194,200544,196566,235,397110,SUNDAY,1,0,8.3,86,14.8,1026.7,Cloudy
12/17/2023 18:00,23,137,26945,86930,160,113875,SUNDAY,1,0,8.3,86,14.8,1026.7,Cloudy
12/17/2023 19:00,8,65,10262,45729,73,55991,SUNDAY,1,0,8.9,86,16.6,1024.4,Cloudy
12/17/2023 20:00,5,51,4777,35988,56,40765,SUNDAY,1,0,8.3,90,16.6,1022.9,Cloudy
12/17/2023 21:00,4,48,2234,74888,52,77122,SUNDAY,1,0,8.3,90,16.6,1022.9,Cloudy
12/17/2023 22:00,10,68,9521,37301,78,46822,SUNDAY,1,0,8.3,93,13,1022.6,Rain
12/17/2023 23:00,4,28,2176,18442,32,20618,SUNDAY,1,0,8.3,93,13,1021.9,Rain
12/18/2023 0:00,1,13,1116,13936,14,15052,MONDAY,0,0,8.3,97,9.4,1018.8,Rain
12/18/2023 1:00,4,7,5831,4325,11,10156,MONDAY,0,0,8.3,97,9.4,1018.8,Rain
12/18/2023 2:00,1,4,1130,2521,5,3651,MONDAY,0,0,10,100,18.4,1014.9,Rain
12/18/2023 3:00,0,4,0,2471,4,2471,MONDAY,0,0,10,100,18.4,1014.9,Rain
12/18/2023 4:00,0,5,0,2711,5,2711,MONDAY,0,0,13.3,93,22.3,1011.6,Rain
12/18/2023 5:00,2,12,4531,5984,14,10515,MONDAY,0,0,11.1,97,18.4,1009.5,Rain
12/18/2023 6:00,2,37,1456,114775,39,116231,MONDAY,0,0,12.2,97,24.1,1007.6,Rain
12/18/2023 7:00,2,56,1422,40418,58,41840,MONDAY,0,0,12.2,97,24.1,1007.6,Rain
12/18/2023 8:00,9,91,7020,67145,100,74165,MONDAY,0,0,11.1,100,20.5,1005.6,Rain
12/18/2023 9:00,9,73,7263,45901,82,53164,MONDAY,0,0,12.2,97,35.3,1000.7,Rain
12/18/2023 10:00,11,51,9294,28771,62,38065,MONDAY,0,0,12.8,93,31.7,997.6,Rain
12/18/2023 11:00,6,49,3393,31403,55,34796,MONDAY,0,0,13.9,93,53.6,995.4,Rain
12/18/2023 12:00,4,60,2549,35852,64,38401,MONDAY,0,0,15,93,50,993.2,Rain
12/18/2023 13:00,11,100,13615,55451,111,69066,MONDAY,0,0,15,93,51.8,993.2,Rain
12/18/2023 14:00,7,67,5022,38362,74,43384,MONDAY,0,0,15.6,93,63,990,Rain
12/18/2023 15:00,15,58,24411,37158,73,61569,MONDAY,0,0,16.7,86,51.8,987.4,Rain
12/18/2023 16:00,28,140,115725,111613,168,227338,MONDAY,0,0,16.1,90,79.6,985.7,Rain
12/18/2023 17:00,54,343,48288,272462,397,320750,MONDAY,0,0,16.1,90,79.6,985.7,Rain
12/18/2023 18:00,60,322,63048,271374,382,334422,MONDAY,0,0,14.4,93,40.7,983.7,Rain
12/18/2023 19:00,53,269,218092,252997,322,471089,MONDAY,0,0,15,93,31.7,980.7,Rain
12/18/2023 20:00,32,213,31636,214504,245,246140,MONDAY,0,0,15,93,29.5,980.7,Rain
12/18/2023 21:00,36,121,1518149,78225,157,1596374,MONDAY,0,0,15.6,93,25.9,980.6,Rain
12/18/2023 22:00,19,88,18242,60326,107,78568,MONDAY,0,0,15.6,93,25.9,986,Rain
12/18/2023 23:00,18,42,18167,29658,60,47825,MONDAY,0,0,11.7,74,35.3,991.6,Cloudy
12/19/2023 0:00,18,25,26506,21290,43,47796,TUESDAY,0,0,10,77,37.1,994.8,Cloudy
12/19/2023 1:00,8,16,10021,8997,24,19018,TUESDAY,0,0,9.4,74,35.3,996.7,Cloudy
12/19/2023 2:00,5,9,17163,7234,14,24397,TUESDAY,0,0,8.9,77,29.5,997.8,Cloudy
12/19/2023 3:00,2,8,662,5083,10,5745,TUESDAY,0,0,8.9,77,29.5,997.8,Cloudy
12/19/2023 4:00,5,13,4637,9554,18,14191,TUESDAY,0,0,7.8,83,22.3,1001.9,Fair
12/19/2023 5:00,10,52,10872,39510,62,50382,TUESDAY,0,0,7.2,82,22.3,1002.5,Fair
12/19/2023 6:00,15,126,10694,98083,141,108777,TUESDAY,0,0,6.7,85,14.8,1003.3,Fair
12/19/2023 7:00,40,314,52810,263152,354,315962,TUESDAY,0,0,5,76,9.4,1003.1,Fair
12/19/2023 8:00,69,645,69358,514958,714,584316,TUESDAY,0,0,5,76,9.4,1003.1,Fair
12/19/2023 9:00,46,371,52179,381003,417,433182,TUESDAY,0,0,5.6,76,14.8,1004.3,Fair
12/19/2023 10:00,45,244,68916,173997,289,242913,TUESDAY,0,0,5.6,76,14.8,1006,Cloudy
12/19/2023 11:00,49,236,57022,156620,285,213642,TUESDAY,0,0,5.6,70,18.4,1007.5,Cloudy
12/19/2023 12:00,80,281,92899,289882,361,382781,TUESDAY,0,0,5,73,20.5,1008.9,Cloudy
12/19/2023 13:00,91,299,178038,201143,390,379181,TUESDAY,0,0,5,73,20.5,1008.9,Fair
12/19/2023 14:00,96,293,211056,225611,389,436667,TUESDAY,0,0,6.1,60,14.8,1009.4,Fair
12/19/2023 15:00,88,367,104052,355600,455,459652,TUESDAY,0,0,7.8,63,14.8,1010.1,Fair
12/19/2023 16:00,92,490,199776,383449,582,583225,TUESDAY,0,0,8.3,58,18.4,1010.6,Fair
12/19/2023 17:00,112,640,152460,494953,752,647413,TUESDAY,0,0,8.3,58,18.4,1010.6,Fair
12/19/2023 18:00,83,477,76852,345051,560,421903,TUESDAY,0,0,7.8,58,16.6,1012.1,Fair
12/19/2023 19:00,32,299,34456,331758,331,366214,TUESDAY,0,0,7.8,58,16.6,1013.4,Fair
12/19/2023 20:00,30,206,1375374,148971,236,1524345,TUESDAY,0,0,7.2,58,16.6,1015,Fair
12/19/2023 21:00,31,131,28042,93539,162,121581,TUESDAY,0,0,6.7,55,24.1,1016.6,Fair
12/19/2023 22:00,28,86,69773,58559,114,128332,TUESDAY,0,0,6.7,55,24.1,1016.6,Cloudy
12/19/2023 23:00,9,50,63691,32787,59,96478,TUESDAY,0,0,4.4,62,20.5,1019.2,Fair
12/20/2023 0:00,17,35,34443,67977,52,102420,WEDNESDAY,0,0,3.9,62,20.5,1020.2,Fair
12/20/2023 1:00,9,16,5708,15491,25,21199,WEDNESDAY,0,0,3.9,59,29.5,1020.6,Fair
12/20/2023 2:00,3,6,2474,6775,9,9249,WEDNESDAY,0,0,2.8,64,20.5,1021.6,Fair
12/20/2023 3:00,5,7,6163,3943,12,10106,WEDNESDAY,0,0,2.8,64,20.5,1021.6,Fair
12/20/2023 4:00,3,6,1144,1683,9,2827,WEDNESDAY,0,0,1.7,69,24.1,1021.9,Clear
12/20/2023 5:00,6,39,7778,25861,45,33639,WEDNESDAY,0,0,1.1,73,20.5,1022.3,Clear
12/20/2023 6:00,5,118,3329,80127,123,83456,WEDNESDAY,0,0,0.6,72,20.5,1022.8,Clear
12/20/2023 7:00,28,286,26763,315500,314,342263,WEDNESDAY,0,0,0.6,72,20.5,1022.8,Clear
12/20/2023 8:00,40,532,56852,383966,572,440818,WEDNESDAY,0,0,0,72,18.4,1023.6,Clear
12/20/2023 9:00,47,327,141038,330409,374,471447,WEDNESDAY,0,0,-0.6,76,20.5,1024.3,Clear
12/20/2023 10:00,32,249,38074,169843,281,207917,WEDNESDAY,0,0,-0.6,76,18.4,1024.9,Clear
12/20/2023 11:00,64,272,109858,186300,336,296158,WEDNESDAY,0,0,-0.6,76,18.4,1025.4,Fair
12/20/2023 12:00,71,289,78337,176040,360,254377,WEDNESDAY,0,0,-0.6,76,22.3,1025.4,Fair
12/20/2023 13:00,66,288,75792,216610,354,292402,WEDNESDAY,0,0,0.6,63,16.6,1026.2,Fair
12/20/2023 14:00,74,355,101954,340588,429,442542,WEDNESDAY,0,0,1.7,58,9.4,1026.8,Fair
12/20/2023 15:00,103,378,1517352,307578,481,1824930,WEDNESDAY,0,0,2.8,52,9.4,1026.1,Fair
12/20/2023 16:00,72,518,94080,568700,590,662780,WEDNESDAY,0,0,3.9,46,9.4,1025.3,Fair
12/20/2023 17:00,101,595,121480,475721,696,597201,WEDNESDAY,0,0,3.9,46,9.4,1025.3,Fair
12/20/2023 18:00,60,438,57657,329937,498,387594,WEDNESDAY,0,0,5.6,38,16.6,1024.1,Fair
12/20/2023 19:00,35,264,120614,193653,299,314267,WEDNESDAY,0,0,6.7,33,18.4,1023.8,Fair
12/20/2023 20:00,33,204,28222,134838,237,163060,WEDNESDAY,0,0,6.1,32,20.5,1024.2,Fair
12/20/2023 21:00,25,120,18224,75572,145,93796,WEDNESDAY,0,0,5.6,34,11.2,1024.8,Fair
12/20/2023 22:00,26,77,65261,64118,103,129379,WEDNESDAY,0,0,5.6,34,11.2,1024.8,Fair
12/20/2023 23:00,15,55,14021,35758,70,49779,WEDNESDAY,0,0,3.9,46,16.6,1025.2,Fair
12/21/2023 0:00,11,24,8836,14931,35,23767,THURSDAY,0,0,3.3,55,20.5,1025,Clear
12/21/2023 1:00,5,20,3487,15837,25,19324,THURSDAY,0,0,2.8,61,20.5,1024.7,Clear
12/21/2023 2:00,4,8,3183,7175,12,10358,THURSDAY,0,0,2.8,61,20.5,1024.7,Clear
12/21/2023 3:00,2,10,2499,5044,12,7543,THURSDAY,0,0,2.2,70,22.3,1025,Clear
12/21/2023 4:00,2,7,663,4520,9,5183,THURSDAY,0,0,1.7,72,18.4,1025.2,Clear
12/21/2023 5:00,7,35,1669716,54608,42,1724324,THURSDAY,0,0,1.1,75,14.8,1025.7,Clear
12/21/2023 6:00,17,90,18778,81715,107,100493,THURSDAY,0,0,0.6,75,14.8,1025.9,Clear
12/21/2023 7:00,20,232,14604,280211,252,294815,THURSDAY,0,0,0.6,75,14.8,1025.9,Fair
12/21/2023 8:00,41,472,61003,567872,513,628875,THURSDAY,0,0,0,69,14.8,1026.6,Fair
12/21/2023 9:00,26,288,32734,193345,314,226079,THURSDAY,0,0,0,66,18.4,1026.9,Fair
12/21/2023 10:00,34,198,27930,179812,232,207742,THURSDAY,0,0,0,64,18.4,1027.3,Cloudy
12/21/2023 11:00,42,231,46258,139031,273,185289,THURSDAY,0,0,-0.6,66,18.4,1027.9,Cloudy
12/21/2023 12:00,42,224,60052,148960,266,209012,THURSDAY,0,0,-0.6,66,18.4,1027.9,Fair
12/21/2023 13:00,48,259,82129,161591,307,243720,THURSDAY,0,0,0.6,53,22.3,1029.1,Fair
12/21/2023 14:00,54,255,71322,172131,309,243453,THURSDAY,0,0,1.1,50,22.3,1029.3,Fair
12/21/2023 15:00,55,306,63949,204771,361,268720,THURSDAY,0,0,1.1,46,22.3,1028.8,Fair
12/21/2023 16:00,54,388,142493,437661,442,580154,THURSDAY,0,0,1.7,44,22.3,1028.1,Fair
12/21/2023 17:00,53,431,51686,453932,484,505618,THURSDAY,0,0,1.7,44,27.7,1028.1,Fair
12/21/2023 18:00,36,318,37149,233912,354,271061,THURSDAY,0,0,1.7,38,22.3,1027.7,Fair
12/21/2023 19:00,32,206,189451,129203,238,318654,THURSDAY,0,0,1.1,33,22.3,1028,Fair
12/21/2023 20:00,19,132,20839,96269,151,117108,THURSDAY,0,0,0.6,38,18.4,1028.5,Fair
12/21/2023 21:00,14,88,12337,49225,102,61562,THURSDAY,0,0,-0.6,38,14.8,1029,Fair
12/21/2023 22:00,18,81,22436,55947,99,78383,THURSDAY,0,0,-0.6,38,14.8,1029,Cloudy
12/21/2023 23:00,11,50,9201,28388,61,37589,THURSDAY,0,0,-1.1,39,20.5,1029.8,Clear
12/22/2023 0:00,6,24,2687,18213,30,20900,FRIDAY,0,0,-1.7,41,16.6,1030.2,Clear
12/22/2023 1:00,5,22,5870,13108,27,18978,FRIDAY,0,0,-2.2,44,18.4,1030.4,Clear
12/22/2023 2:00,2,10,2592,11967,12,14559,FRIDAY,0,0,-2.2,44,18.4,1030.4,Clear
12/22/2023 3:00,1,4,913,1598,5,2511,FRIDAY,0,0,-3.3,50,18.4,1030.6,Clear
12/22/2023 4:00,3,7,2409,3345,10,5754,FRIDAY,0,0,-3.3,50,18.4,1030.6,Clear
12/22/2023 5:00,6,30,4338,26297,36,30635,FRIDAY,0,0,-4.4,57,18.4,1030.2,Clear
12/22/2023 6:00,6,51,3215,26129,57,29344,FRIDAY,0,0,-5,59,18.4,1030.5,Clear
12/22/2023 7:00,11,113,9597,88848,124,98445,FRIDAY,0,0,-5,59,18.4,1030.5,Clear
12/22/2023 8:00,20,211,18901,188861,231,207762,FRIDAY,0,0,-5.6,62,16.6,1030.1,Clear
12/22/2023 9:00,28,179,42984,126808,207,169792,FRIDAY,0,0,-5.6,62,18.4,1030.3,Clear
12/22/2023 10:00,32,206,33890,232057,238,265947,FRIDAY,0,0,-5.6,62,16.6,1030.8,Clear
12/22/2023 11:00,39,205,127642,170900,244,298542,FRIDAY,0,0,-5.6,62,16.6,1030.8,Cloudy
12/22/2023 12:00,66,212,98786,148480,278,247266,FRIDAY,0,0,-5.6,62,18.4,1031.6,Fair
12/22/2023 13:00,63,251,93868,264801,314,358669,FRIDAY,0,0,-3.9,55,14.8,1031.9,Fair
12/22/2023 14:00,49,269,74218,303526,318,377744,FRIDAY,0,0,-2.8,50,7.6,1032.3,Fair
12/22/2023 15:00,71,255,464752,211902,326,676654,FRIDAY,0,0,-1.1,44,5.4,1031.8,Fair
12/22/2023 16:00,43,281,46388,263918,324,310306,FRIDAY,0,0,0,44,0,1031.2,Fair
12/22/2023 17:00,40,246,68689,183822,286,252511,FRIDAY,0,0,0,29,0,1031.2,Fair
12/22/2023 18:00,41,175,106931,124289,216,231220,FRIDAY,0,0,1.7,26,0,1030.4,Fair
12/22/2023 19:00,22,154,28742,103985,176,132727,FRIDAY,0,0,1.1,38,7.6,1030.6,Fair
12/22/2023 20:00,34,85,1649097,69111,119,1718208,FRIDAY,0,0,0.6,41,7.6,1031.1,Fair
12/22/2023 21:00,19,59,66380,42271,78,108651,FRIDAY,0,0,0.6,41,7.6,1031.1,Fair
12/22/2023 22:00,15,60,12024,43225,75,55249,FRIDAY,0,0,0,45,5.4,1032,Cloudy
12/22/2023 23:00,14,37,14217,24627,51,38844,FRIDAY,0,0,0.6,39,5.4,1032.6,Fair
12/23/2023 0:00,10,19,8274,14247,29,22521,SATURDAY,1,0,-1.7,63,11.2,1032.8,Clear
12/23/2023 1:00,20,23,27322,24007,43,51329,SATURDAY,1,0,-1.7,58,9.4,1033.1,Clear
12/23/2023 2:00,18,7,74873,4538,25,79411,SATURDAY,1,0,-1.7,58,9.4,1033.1,Clear
12/23/2023 3:00,0,3,0,2575,3,2575,SATURDAY,1,0,-1.1,41,7.6,1033,Clear
12/23/2023 4:00,1,7,1046,4602,8,5648,SATURDAY,1,0,-1.7,41,7.6,1032.8,Clear
12/23/2023 5:00,1,12,1037,9244,13,10281,SATURDAY,1,0,-1.7,43,7.6,1032.9,Clear
12/23/2023 6:00,1,20,856,12617,21,13473,SATURDAY,1,0,-3.3,63,0,1033.4,Fair
12/23/2023 7:00,11,36,10593,26314,47,36907,SATURDAY,1,0,-3.3,63,0,1033.4,Fair
12/23/2023 8:00,8,70,8540,48817,78,57357,SATURDAY,1,0,-2.8,60,0,1033.2,Fair
12/23/2023 9:00,28,118,115671,74080,146,189751,SATURDAY,1,0,-4.4,71,0,1033.3,Fair
12/23/2023 10:00,35,153,40967,93957,188,134924,SATURDAY,1,0,-2.8,58,0,1033.7,Cloudy
12/23/2023 11:00,47,206,58577,153376,253,211953,SATURDAY,1,0,-1.7,58,0,1033.9,Cloudy
12/23/2023 12:00,74,209,539619,331189,283,870808,SATURDAY,1,0,-1.7,58,0,1033.9,Cloudy
12/23/2023 13:00,65,185,195472,310760,250,506232,SATURDAY,1,0,0,66,0,1034.3,Cloudy
12/23/2023 14:00,63,232,420155,204199,295,624354,SATURDAY,1,0,1.7,64,7.6,1034.3,Cloudy
12/23/2023 15:00,62,185,687586,151917,247,839503,SATURDAY,1,0,3.3,55,9.4,1033.7,Cloudy
12/23/2023 16:00,48,189,74107,141648,237,215755,SATURDAY,1,0,3.3,55,9.4,1033.7,Cloudy
12/23/2023 17:00,26,175,32249,137000,201,169249,SATURDAY,1,0,5,53,13,1032.2,Cloudy
12/23/2023 18:00,35,131,288753,88757,166,377510,SATURDAY,1,0,5.6,55,14.8,1031.9,Cloudy
12/23/2023 19:00,27,93,37687,159770,120,197457,SATURDAY,1,0,5,60,14.8,1032,Cloudy
12/23/2023 20:00,19,71,86338,52983,90,139321,SATURDAY,1,0,4.4,68,11.2,1031.8,Cloudy
12/23/2023 21:00,20,49,22230,33926,69,56156,SATURDAY,1,0,4.4,68,11.2,1031.8,Cloudy
12/23/2023 22:00,22,46,25168,33181,68,58349,SATURDAY,1,0,3.9,76,13,1032.1,Cloudy
12/23/2023 23:00,12,32,191935,19089,44,211024,SATURDAY,1,0,3.9,79,13,1032.6,Cloudy
12/24/2023 0:00,11,15,28630,10515,26,39145,SUNDAY,1,0,3.9,82,11.2,1032.7,Cloudy
12/24/2023 1:00,10,13,10905,10019,23,20924,SUNDAY,1,0,3.9,86,7.6,1032.5,Cloudy
12/24/2023 2:00,19,5,17707,6501,24,24208,SUNDAY,1,0,3.9,86,7.6,1032.5,Cloudy
12/24/2023 3:00,1,2,927,1549,3,2476,SUNDAY,1,0,3.3,89,9.4,1032,Cloudy
12/24/2023 4:00,1,4,1372,2611,5,3983,SUNDAY,1,0,3.3,93,13,1031.5,Cloudy
12/24/2023 5:00,2,3,3356,1500,5,4856,SUNDAY,1,0,3.3,93,13,1031.2,Cloudy
12/24/2023 6:00,2,19,7155,12000,21,19155,SUNDAY,1,0,3.3,93,7.6,1031.4,Cloudy
12/24/2023 7:00,5,42,3647,33664,47,37311,SUNDAY,1,0,3.3,93,7.6,1031.4,Cloudy
12/24/2023 8:00,8,55,12481,47412,63,59893,SUNDAY,1,0,3.3,93,0,1030.7,Cloudy
12/24/2023 9:00,19,70,668791,133141,89,801932,SUNDAY,1,0,3.3,97,0,1030.4,Cloudy
12/24/2023 10:00,19,126,46748,91755,145,138503,SUNDAY,1,0,3.3,97,0,1030.8,Cloudy
12/24/2023 11:00,31,142,68823,108862,173,177685,SUNDAY,1,0,3.3,97,0,1030.8,Cloudy
12/24/2023 12:00,50,143,89324,116097,193,205421,SUNDAY,1,0,3.3,100,0,1030.9,Cloudy
12/24/2023 13:00,63,142,298851,118484,205,417335,SUNDAY,1,0,5,100,0,1031.1,Cloudy
12/24/2023 14:00,50,155,86524,125694,205,212218,SUNDAY,1,0,6.1,97,0,1031.7,Cloudy
12/24/2023 15:00,47,156,72472,221824,203,294296,SUNDAY,1,0,6.7,93,0,1031.2,Cloudy
12/24/2023 16:00,16,90,18468,80376,106,98844,SUNDAY,1,0,6.7,93,0,1031.2,Cloudy
12/24/2023 17:00,16,68,21565,70411,84,91976,SUNDAY,1,0,6.7,100,7.6,1029.9,Cloudy
12/24/2023 18:00,9,75,38627,51819,84,90446,SUNDAY,1,0,7.2,100,5.4,1029.6,Cloudy
12/24/2023 19:00,9,53,6370,33493,62,39863,SUNDAY,1,0,7.2,100,5.4,1029.6,Cloudy
12/24/2023 20:00,8,44,97892,28999,52,126891,SUNDAY,1,0,7.2,100,5.4,1029.6,Cloudy
12/24/2023 21:00,10,35,18752,126286,45,145038,SUNDAY,1,0,7.2,100,5.4,1029.9,Cloudy
12/24/2023 22:00,7,24,6741,20666,31,27407,SUNDAY,1,0,7.2,100,5.4,1030.4,Cloudy
12/24/2023 23:00,8,22,9202,16469,30,25671,SUNDAY,1,0,7.2,100,5.4,1030.4,Cloudy
12/25/2023 0:00,6,18,6181,13820,24,20001,MONDAY,0,1,6.7,96,5.4,1030.4,Cloudy
12/25/2023 1:00,12,15,15435,49170,27,64605,MONDAY,0,1,6.7,96,5.4,1030.4,Cloudy
12/25/2023 2:00,0,11,0,6925,11,6925,MONDAY,0,1,6.7,96,0,1030.4,Cloudy
12/25/2023 3:00,0,7,0,10415,7,10415,MONDAY,0,1,6.7,100,0,1030.5,Cloudy
12/25/2023 4:00,2,3,2305,1044,5,3349,MONDAY,0,1,6.7,96,0,1030.3,Cloudy
12/25/2023 5:00,2,8,2193,10861,10,13054,MONDAY,0,1,7,96,5.4,1030.2,Cloudy
12/25/2023 6:00,8,17,7110,11247,25,18357,MONDAY,0,1,6.7,62,5.4,1030.2,Cloudy
12/25/2023 7:00,2,44,2519,21021,46,23540,MONDAY,0,1,6.7,96,5.4,1030.8,Cloudy
12/25/2023 8:00,11,37,15910,21008,48,36918,MONDAY,0,1,7,96,7.6,1030.7,Cloudy
12/25/2023 9:00,15,50,26463,29488,65,55951,MONDAY,0,1,6.7,96,0,1030.9,Cloudy
12/25/2023 10:00,25,67,72211,50939,92,123150,MONDAY,0,1,6.7,96,5.4,1031.2,Cloudy
12/25/2023 11:00,41,65,188672,77512,106,266184,MONDAY,0,1,6.7,96,5.4,1031.2,Cloudy
12/25/2023 12:00,107,75,1271732,72621,182,1344353,MONDAY,0,1,7.2,97,5.4,1031.9,Cloudy
12/25/2023 13:00,91,94,1221533,144439,185,1365972,MONDAY,0,1,7.8,100,5.4,1032.3,Cloudy
12/25/2023 14:00,87,122,308559,126745,209,435304,MONDAY,0,1,8.9,100,9.4,1032.3,Cloudy
12/25/2023 15:00,105,137,464071,143023,242,607094,MONDAY,0,1,9.4,100,9.4,1031.9,Cloudy
12/25/2023 16:00,71,92,3029356,96349,163,3125705,MONDAY,0,1,9.4,100,9.4,1031.9,Cloudy
12/25/2023 17:00,37,69,2230653,49214,106,2279867,MONDAY,0,1,8.9,83,13,1030.5,Cloudy
12/25/2023 18:00,32,58,50814,42744,90,93558,MONDAY,0,1,8.9,83,9.4,1030.3,Cloudy
12/25/2023 19:00,15,50,17480,147381,65,164861,MONDAY,0,1,8.9,100,13,1030.2,Cloudy
12/25/2023 20:00,20,39,40699,27915,59,68614,MONDAY,0,1,8.3,100,5.4,1030.2,Cloudy
12/25/2023 21:00,7,26,24791,99990,33,124781,MONDAY,0,1,8.3,100,5.4,1030.2,Cloudy
12/25/2023 22:00,15,19,18616,12068,34,30684,MONDAY,0,1,6.7,100,7.6,1030.7,Cloudy
12/25/2023 23:00,10,19,14084,93758,29,107842,MONDAY,0,1,7.2,97,5.4,1030.7,Fair
12/26/2023 0:00,5,10,7397,9384,15,16781,TUESDAY,0,0,5,100,5.4,1030.8,Fair
12/26/2023 1:00,6,10,7771,10219,16,17990,TUESDAY,0,0,5,100,5.4,1030.8,Cloudy
12/26/2023 2:00,0,5,0,5170,5,5170,TUESDAY,0,0,3.9,100,0,1029.8,Cloudy
12/26/2023 3:00,1,1,1209,462,2,1671,TUESDAY,0,0,3.3,100,5.4,1029.2,Cloudy
12/26/2023 4:00,0,5,0,2324,5,2324,TUESDAY,0,0,3.9,100,11.2,1029.2,Cloudy
12/26/2023 5:00,2,14,1759,9000,16,10759,TUESDAY,0,0,3.3,100,14.8,1028.8,Cloudy
12/26/2023 6:00,5,37,8239,35134,42,43373,TUESDAY,0,0,3.3,100,14.8,1028.8,Cloudy
12/26/2023 7:00,7,47,4522,44819,54,49341,TUESDAY,0,0,3.9,100,7.6,1028.4,Cloudy
12/26/2023 8:00,13,81,18584,52952,94,71536,TUESDAY,0,0,3.3,100,0,1028,Cloudy
12/26/2023 9:00,25,121,33567,78518,146,112085,TUESDAY,0,0,3.3,100,0,1027.6,Cloudy
12/26/2023 10:00,42,81,57809,66949,123,124758,TUESDAY,0,0,3.3,100,0,1027.6,Cloudy
12/26/2023 11:00,73,110,660959,68092,183,729051,TUESDAY,0,0,2.8,100,7.6,1027.6,Cloudy
12/26/2023 12:00,60,153,199470,110407,213,309877,TUESDAY,0,0,3.3,100,5.4,1027.6,Cloudy
12/26/2023 13:00,92,144,183241,141951,236,325192,TUESDAY,0,0,3.3,100,5.4,1027.6,Cloudy
12/26/2023 14:00,130,182,283916,152035,312,435951,TUESDAY,0,0,4.4,100,5.4,1027.5,Cloudy
12/26/2023 15:00,125,200,1240671,181692,325,1422363,TUESDAY,0,0,3.9,100,9.4,1026.7,Cloudy
12/26/2023 16:00,87,215,292116,352633,302,644749,TUESDAY,0,0,3.9,100,9.4,1026.7,Cloudy
12/26/2023 17:00,67,206,95543,239407,273,334950,TUESDAY,0,0,5.6,100,9.4,1026,Cloudy
12/26/2023 18:00,32,141,37393,104462,173,141855,TUESDAY,0,0,6.1,100,7.6,1024.9,Cloudy
12/26/2023 19:00,39,106,42170,170469,145,212639,TUESDAY,0,0,8.3,100,11.2,1023.4,Cloudy
12/26/2023 20:00,27,77,26845,61595,104,88440,TUESDAY,0,0,8.3,100,11.2,1023.4,Cloudy
12/26/2023 21:00,23,48,42421,39299,71,81720,TUESDAY,0,0,5.6,100,9.4,1023.7,Cloudy
12/26/2023 22:00,32,44,85010,36665,76,121675,TUESDAY,0,0,5,100,0,1024,Cloudy
12/26/2023 23:00,18,26,89513,19611,44,109124,TUESDAY,0,0,5,100,0,1024,Cloudy
12/27/2023 0:00,10,10,27865,66866,20,94731,WEDNESDAY,0,0,6.1,100,9.4,1023.7,Cloudy
12/27/2023 1:00,6,10,7152,8973,16,16125,WEDNESDAY,0,0,6.1,100,7.6,1023.3,Cloudy
12/27/2023 2:00,4,11,6045,9844,15,15889,WEDNESDAY,0,0,6.1,100,11.2,1023.3,Cloudy
12/27/2023 3:00,0,7,0,5741,7,5741,WEDNESDAY,0,0,5,100,14.8,1022.8,Cloudy
12/27/2023 4:00,1,7,391,3764,8,4155,WEDNESDAY,0,0,5,100,14.8,1022.8,Cloudy
12/27/2023 5:00,2,22,1722,11313,24,13035,WEDNESDAY,0,0,5,100,9.4,1022,Cloudy
12/27/2023 6:00,8,47,10868,30512,55,41380,WEDNESDAY,0,0,5.6,100,7.6,1021.9,Cloudy
12/27/2023 7:00,12,93,10416,241307,105,251723,WEDNESDAY,0,0,5.6,100,7.6,1021.9,Cloudy
12/27/2023 8:00,23,137,38025,88251,160,126276,WEDNESDAY,0,0,5,100,13,1021.7,Cloudy
12/27/2023 9:00,30,125,43683,91844,155,135527,WEDNESDAY,0,0,6.1,100,0,1020.9,Cloudy
12/27/2023 10:00,48,135,88683,99545,183,188228,WEDNESDAY,0,0,6.1,100,0,1021.1,Cloudy
12/27/2023 11:00,69,134,151026,94561,203,245587,WEDNESDAY,0,0,5.6,100,5.4,1021.1,Cloudy
12/27/2023 12:00,66,200,173286,156026,266,329312,WEDNESDAY,0,0,6.1,100,5.4,1021,Cloudy
12/27/2023 13:00,93,199,172250,177702,292,349952,WEDNESDAY,0,0,6.1,100,5.4,1021,Cloudy
12/27/2023 14:00,114,207,463829,181875,321,645704,WEDNESDAY,0,0,7.2,100,0,1020.9,Cloudy
12/27/2023 15:00,118,227,1082731,185314,345,1268045,WEDNESDAY,0,0,7.2,100,0,1020.9,Cloudy
12/27/2023 16:00,66,267,89446,203757,333,293203,WEDNESDAY,0,0,8.3,100,5.4,1020.2,Cloudy
12/27/2023 17:00,64,227,63288,154479,291,217767,WEDNESDAY,0,0,10.6,96,9.4,1019.2,Cloudy
12/27/2023 18:00,41,171,234191,194955,212,429146,WEDNESDAY,0,0,10.6,96,7.6,1018.4,Cloudy
12/27/2023 19:00,30,80,31215,59664,110,90879,WEDNESDAY,0,0,8.9,100,9.4,1017.9,Cloudy
12/27/2023 20:00,20,99,201761,94952,119,296713,WEDNESDAY,0,0,8.9,100,7.6,1017.7,Cloudy
12/27/2023 21:00,19,69,23519,58193,88,81712,WEDNESDAY,0,0,8.3,100,7.6,1017.4,Cloudy
12/27/2023 22:00,12,46,8837,32178,58,41015,WEDNESDAY,0,0,7.8,100,13,1017.3,Cloudy
12/27/2023 23:00,9,32,7991,31719,41,39710,WEDNESDAY,0,0,7.8,100,7.6,1017.8,Cloudy
12/28/2023 0:00,6,15,5620,9534,21,15154,THURSDAY,0,0,7.8,100,13,1017.3,Cloudy
12/28/2023 1:00,5,11,3710,12864,16,16574,THURSDAY,0,0,7.8,100,9.4,1016.5,Cloudy
12/28/2023 2:00,2,5,3976,5105,7,9081,THURSDAY,0,0,7.8,100,13,1016,Cloudy
12/28/2023 3:00,1,7,1214,4196,8,5410,THURSDAY,0,0,7.8,100,11.2,1015.3,Cloudy
12/28/2023 4:00,3,9,3703,7080,12,10783,THURSDAY,0,0,7.8,100,11.2,1015.5,Cloudy
12/28/2023 5:00,1,10,1265,6739,11,8004,THURSDAY,0,0,7.2,100,13,1014.7,Rain
12/28/2023 6:00,2,18,1957,10964,20,12921,THURSDAY,0,0,7.2,100,14.8,1013.8,Rain
12/28/2023 7:00,4,36,3231,21810,40,25041,THURSDAY,0,0,6.7,100,14.8,1013.5,Rain
12/28/2023 8:00,7,46,7106,30528,53,37634,THURSDAY,0,0,6.7,100,16.6,1012.5,Cloudy
12/28/2023 9:00,6,41,6499,29518,47,36017,THURSDAY,0,0,6.7,100,20.5,1011.9,Rain
12/28/2023 10:00,7,44,5799,27237,51,33036,THURSDAY,0,0,6.7,100,16.6,1011.7,Rain
12/28/2023 11:00,6,41,6247,27766,47,34013,THURSDAY,0,0,6.7,100,18.4,1011.6,Rain
12/28/2023 12:00,8,43,7390,23806,51,31196,THURSDAY,0,0,7.2,100,18.4,1011.2,Rain
12/28/2023 13:00,8,71,7622,39942,79,47564,THURSDAY,0,0,6.7,100,20.5,1011.3,Rain
12/28/2023 14:00,21,88,25819,53943,109,79762,THURSDAY,0,0,6.7,100,27.7,1011.1,Rain
12/28/2023 15:00,22,75,20698,46024,97,66722,THURSDAY,0,0,6.7,100,33.5,1010.1,Rain
12/28/2023 16:00,19,94,27666,135571,113,163237,THURSDAY,0,0,7.2,100,31.7,1008.8,Rain
12/28/2023 17:00,23,107,31095,82868,130,113963,THURSDAY,0,0,7.2,100,35.3,1007.4,Rain
12/28/2023 18:00,19,95,27941,275137,114,303078,THURSDAY,0,0,7.2,100,27.7,1006.7,Rain
12/28/2023 19:00,6,79,8096,65027,85,73123,THURSDAY,0,0,7.2,100,35.3,1006,Rain
12/28/2023 20:00,7,55,99241,37390,62,136631,THURSDAY,0,0,7.2,100,33.5,1006.3,Rain
12/28/2023 21:00,6,40,6091,23535,46,29626,THURSDAY,0,0,7.2,100,35.3,1005.9,Cloudy
12/28/2023 22:00,3,50,4920,39870,53,44790,THURSDAY,0,0,7.2,100,35.3,1005.9,Rain
12/28/2023 23:00,13,23,16849,22545,36,39394,THURSDAY,0,0,6.7,100,27.7,1006.2,Rain
12/29/2023 0:00,5,13,9973,15719,18,25692,FRIDAY,0,0,6.7,100,20.5,1005.9,Rain
12/29/2023 1:00,7,6,10214,2422,13,12636,FRIDAY,0,0,6.1,100,24.1,1005.2,Rain
12/29/2023 2:00,4,9,6183,7251,13,13434,FRIDAY,0,0,6.1,100,16.6,1005.8,Rain
12/29/2023 3:00,4,3,97353,3570,7,100923,FRIDAY,0,0,5.6,100,13,1005.6,Rain
12/29/2023 4:00,1,9,548,5956,10,6504,FRIDAY,0,0,5.6,100,22.3,1004.7,Rain
12/29/2023 5:00,2,25,9171,15983,27,25154,FRIDAY,0,0,5.6,100,13,1004.5,Rain
12/29/2023 6:00,8,32,20611,25217,40,45828,FRIDAY,0,0,5.6,100,11.2,1004.1,Cloudy
12/29/2023 7:00,15,58,53813,38248,73,92061,FRIDAY,0,0,5.6,100,13,1004.2,Rain
12/29/2023 8:00,7,88,6109,65723,95,71832,FRIDAY,0,0,5,100,11.2,1004.1,Rain
12/29/2023 9:00,12,99,7694,136797,111,144491,FRIDAY,0,0,5,100,11.2,1004.2,Rain
12/29/2023 10:00,29,103,51460,74121,132,125581,FRIDAY,0,0,5,100,11.2,1003.7,Cloudy
12/29/2023 11:00,30,131,67496,93523,161,161019,FRIDAY,0,0,5,100,9.4,1004.3,Cloudy
12/29/2023 12:00,37,146,72698,106610,183,179308,FRIDAY,0,0,5,100,9.4,1004.2,Rain
12/29/2023 13:00,39,131,95322,107345,170,202667,FRIDAY,0,0,5,100,7.6,1004.4,Cloudy
12/29/2023 14:00,47,172,83025,149768,219,232793,FRIDAY,0,0,5,100,5.4,1004.5,Cloudy
12/29/2023 15:00,102,179,248239,156248,281,404487,FRIDAY,0,0,4.4,100,7.6,1004.7,Rain
12/29/2023 16:00,76,194,146014,145243,270,291257,FRIDAY,0,0,5,100,7.6,1004.4,Cloudy
12/29/2023 17:00,53,195,95547,140066,248,235613,FRIDAY,0,0,5.6,100,7.6,1003.4,Rain
12/29/2023 18:00,55,174,71984,136324,229,208308,FRIDAY,0,0,5.6,100,7.6,1002.8,Cloudy
12/29/2023 19:00,38,105,986184,85347,143,1071531,FRIDAY,0,0,6.1,100,9.4,1002.4,Rain
12/29/2023 20:00,26,109,37116,76651,135,113767,FRIDAY,0,0,6.7,100,11.2,1002.5,Cloudy
12/29/2023 21:00,35,74,53109,54489,109,107598,FRIDAY,0,0,7.2,100,9.4,1002.6,Cloudy
12/29/2023 22:00,38,62,174365,47649,100,222014,FRIDAY,0,0,7.2,100,11.2,1002.7,Cloudy
12/29/2023 23:00,21,44,31043,60686,65,91729,FRIDAY,0,0,7.2,100,9.4,1002.9,Cloudy
12/30/2023 0:00,32,29,128653,27033,61,155686,SATURDAY,1,0,7.2,100,9.4,1002.8,Cloudy
12/30/2023 1:00,31,22,127554,18019,53,145573,SATURDAY,1,0,7.2,100,7.6,1002.6,Cloudy
12/30/2023 2:00,21,23,42863,23116,44,65979,SATURDAY,1,0,7.8,100,11.2,1002.5,Cloudy
12/30/2023 3:00,8,12,11063,9003,20,20066,SATURDAY,1,0,7.8,100,13,1002.4,Cloudy
12/30/2023 4:00,2,6,3682,3676,8,7358,SATURDAY,1,0,7.8,100,14.8,1002.1,Cloudy
12/30/2023 5:00,3,16,2896,13781,19,16677,SATURDAY,1,0,7.8,100,11.2,1001.6,Cloudy
12/30/2023 6:00,0,14,0,8909,14,8909,SATURDAY,1,0,7.2,100,13,1000.7,Cloudy
12/30/2023 7:00,5,29,4048,19108,34,23156,SATURDAY,1,0,6.7,100,11.2,1000.4,Cloudy
12/30/2023 8:00,8,64,7597,56024,72,63621,SATURDAY,1,0,7.2,100,9.4,1000.3,Cloudy
12/30/2023 9:00,19,90,21817,55480,109,77297,SATURDAY,1,0,7.2,97,7.6,999.7,Cloudy
12/30/2023 10:00,22,87,36666,156689,109,193355,SATURDAY,1,0,7.2,93,11.2,999.7,Cloudy
12/30/2023 11:00,9,62,10086,48989,71,59075,SATURDAY,1,0,6.7,96,16.6,999.2,Cloudy
12/30/2023 12:00,10,52,12047,36046,62,48093,SATURDAY,1,0,6.1,100,14.8,999,Cloudy
12/30/2023 13:00,36,82,72356,58993,118,131349,SATURDAY,1,0,6.1,100,13,999,Cloudy
12/30/2023 14:00,18,89,26201,66621,107,92822,SATURDAY,1,0,6.7,100,13,999.1,Cloudy
12/30/2023 15:00,41,120,739054,154126,161,893180,SATURDAY,1,0,6.7,96,16.6,999.4,Cloudy
12/30/2023 16:00,35,181,52522,158008,216,210530,SATURDAY,1,0,6.1,100,14.8,999.1,Rain
12/30/2023 17:00,40,125,83619,247361,165,330980,SATURDAY,1,0,6.1,97,14.8,998.6,Rain
12/30/2023 18:00,39,115,44947,142556,154,187503,SATURDAY,1,0,6.1,100,20.5,998.4,Rain
12/30/2023 19:00,26,90,35331,68736,116,104067,SATURDAY,1,0,6.1,97,22.3,998.5,Rain
12/30/2023 20:00,24,74,79964,48602,98,128566,SATURDAY,1,0,5.6,96,16.6,999.4,Cloudy
12/30/2023 21:00,18,49,27017,36094,67,63111,SATURDAY,1,0,5,89,14.8,1000.4,Cloudy
12/30/2023 22:00,27,49,31092,30429,76,61521,SATURDAY,1,0,5,89,20.5,1001.3,Cloudy
12/30/2023 23:00,20,27,29142,16792,47,45934,SATURDAY,1,0,4.4,86,14.8,1002.4,Cloudy
12/31/2023 0:00,17,22,9711,49154,39,58865,SUNDAY,1,0,4.4,73,18.4,1003.2,Cloudy
12/31/2023 1:00,21,12,88890,10246,33,99136,SUNDAY,1,0,4.4,70,22.3,1004,Cloudy
12/31/2023 2:00,8,9,5768,7303,17,13071,SUNDAY,1,0,3.9,64,25.9,1004.7,Cloudy
12/31/2023 3:00,1,5,1220,3729,6,4949,SUNDAY,1,0,2.8,70,13,1005.6,Cloudy
12/31/2023 4:00,0,7,0,3612,7,3612,SUNDAY,1,0,2.2,73,18.4,1006.5,Fair
12/31/2023 5:00,2,6,2846,7029,8,9875,SUNDAY,1,0,1.7,72,13,1007.1,Cloudy
12/31/2023 6:00,5,22,3842,39697,27,43539,SUNDAY,1,0,2.2,70,13,1007.8,Cloudy
12/31/2023 7:00,9,29,23375,66901,38,90276,SUNDAY,1,0,1.7,69,16.6,1008.6,Fair
12/31/2023 8:00,15,62,21156,30911,77,52067,SUNDAY,1,0,1.7,69,13,1009.5,Fair
12/31/2023 9:00,41,90,262512,71235,131,333747,SUNDAY,1,0,1.7,69,14.8,1010.1,Fair
12/31/2023 10:00,45,150,116247,111172,195,227419,SUNDAY,1,0,1.7,69,9.4,1010.6,Cloudy
12/31/2023 11:00,62,143,93476,130586,205,224062,SUNDAY,1,0,1.7,72,9.4,1011.2,Cloudy
12/31/2023 12:00,83,174,168638,138776,257,307414,SUNDAY,1,0,1.7,69,13,1011.9,Fair
12/31/2023 13:00,105,173,187431,240749,278,428180,SUNDAY,1,0,2.2,67,13,1012.2,Fair
12/31/2023 14:00,94,187,535590,154789,281,690379,SUNDAY,1,0,2.2,67,11.2,1013,Fair
12/31/2023 15:00,108,187,590939,189099,295,780038,SUNDAY,1,0,2.2,67,13,1013.6,Fair
12/31/2023 16:00,91,183,240479,138916,274,379395,SUNDAY,1,0,2.2,62,13,1013.4,Cloudy
12/31/2023 17:00,41,155,79275,128145,196,207420,SUNDAY,1,0,2.8,61,16.6,1013,Cloudy
12/31/2023 18:00,46,142,42933,111025,188,153958,SUNDAY,1,0,2.8,59,13,1012.5,Cloudy
12/31/2023 19:00,51,115,522688,179416,166,702104,SUNDAY,1,0,3.3,59,11.2,1012.8,Fair
12/31/2023 20:00,41,76,51555,57712,117,109267,SUNDAY,1,0,3.9,57,18.4,1012.9,Fair
12/31/2023 21:00,37,51,378120,40309,88,418429,SUNDAY,1,0,3.3,59,13,1013.2,Fair
12/31/2023 22:00,28,51,29750,50799,79,80549,SUNDAY,1,0,3.3,57,11.2,1013.6,Cloudy
12/31/2023 23:00,59,52,123525,39500,111,163025,SUNDAY,1,0,2.8,61,16.6,1014.4,Cloudy
1/1/2024 0:00,101,84,335905,124095,185,460000,MONDAY,0,1,1.7,61,16.6,1014.8,Cloudy
1/1/2024 1:00,128,80,304566,61690,208,366256,MONDAY,0,1,1.1,64,16.6,1014.8,Cloudy
1/1/2024 2:00,51,41,589678,37508,92,627186,MONDAY,0,1,0.6,63,13,1015,Cloudy
1/1/2024 3:00,16,16,21380,11123,32,32503,MONDAY,0,1,0.6,66,13,1015.1,Cloudy
1/1/2024 4:00,1,5,219,11956,6,12175,MONDAY,0,1,0.6,66,9.4,1015.1,Cloudy
1/1/2024 5:00,4,10,3558,6510,14,10068,MONDAY,0,1,0.6,66,5.4,1014.8,Cloudy
1/1/2024 6:00,4,21,3056,12137,25,15193,MONDAY,0,1,0.6,66,13,1014.8,Cloudy
1/1/2024 7:00,6,24,10432,16730,30,27162,MONDAY,0,1,0.6,66,11.2,1015.2,Cloudy
1/1/2024 8:00,13,36,8637,19821,49,28458,MONDAY,0,1,0.6,66,13,1015.2,Cloudy
1/1/2024 9:00,15,90,19828,56140,105,75968,MONDAY,0,1,0.6,66,7.6,1015.1,Cloudy
1/1/2024 10:00,14,80,20167,59373,94,79540,MONDAY,0,1,0,72,7.6,1014.9,Cloudy
1/1/2024 11:00,49,90,75970,78975,139,154945,MONDAY,0,1,0,72,9.4,1015.5,Cloudy
1/1/2024 12:00,62,121,308868,97811,183,406679,MONDAY,0,1,0,69,9.4,1016,Cloudy
1/1/2024 13:00,44,143,281945,197073,187,479018,MONDAY,0,1,0,66,7.6,1016.5,Cloudy
1/1/2024 14:00,77,174,143380,133887,251,277267,MONDAY,0,1,0,69,13,1017,Fair
1/1/2024 15:00,89,196,331900,230595,285,562495,MONDAY,0,1,0.6,63,13,1017.4,Fair
1/1/2024 16:00,42,171,286525,116474,213,402999,MONDAY,0,1,1.7,61,9.4,1017.4,Fair
1/1/2024 17:00,41,134,396042,95718,175,491760,MONDAY,0,1,2.2,62,9.4,1017,Fair
1/1/2024 18:00,28,98,35313,138415,126,173728,MONDAY,0,1,2.2,59,11.2,1016.3,Fair
1/1/2024 19:00,21,65,20765,42348,86,63113,MONDAY,0,1,3.3,55,9.4,1016,Fair
1/1/2024 20:00,15,61,19976,48760,76,68736,MONDAY,0,1,3.3,57,9.4,1016.4,Fair
1/1/2024 21:00,12,55,13776,40049,67,53825,MONDAY,0,1,2.8,59,5.4,1016.7,Fair
1/1/2024 22:00,4,24,3610,12478,28,16088,MONDAY,0,1,1.7,64,11.2,1017.3,Cloudy
1/1/2024 23:00,4,16,3326,10065,20,13391,MONDAY,0,1,0.6,78,11.2,1017.6,Cloudy
1/2/2024 0:00,4,13,1532,11433,17,12965,TUESDAY,0,0,0,79,5.4,1018,Fair
1/2/2024 1:00,2,10,1747,5784,12,7531,TUESDAY,0,0,-0.6,78,11.2,1018.2,Fair
1/2/2024 2:00,3,4,2987,2720,7,5707,TUESDAY,0,0,-0.6,66,11.2,1018.4,Clear
1/2/2024 3:00,0,4,0,3389,4,3389,TUESDAY,0,0,-1.7,69,9.4,1018.4,Clear
1/2/2024 4:00,0,5,0,3951,5,3951,TUESDAY,0,0,-1.7,66,9.4,1018.2,Clear
1/2/2024 5:00,3,35,3496,109800,38,113296,TUESDAY,0,0,-2.2,66,14.8,1017.9,Clear
1/2/2024 6:00,15,89,37014,152971,104,189985,TUESDAY,0,0,-2.8,69,13,1017.7,Clear
1/2/2024 7:00,24,228,25662,232685,252,258347,TUESDAY,0,0,-3.3,71,7.6,1017.8,Clear
1/2/2024 8:00,33,429,55157,359520,462,414677,TUESDAY,0,0,-3.9,74,16.6,1017.8,Clear
1/2/2024 9:00,26,236,44073,191459,262,235532,TUESDAY,0,0,-4.4,77,9.4,1017.6,Clear
1/2/2024 10:00,19,144,20118,100604,163,120722,TUESDAY,0,0,-4.4,77,14.8,1017.4,Clear
1/2/2024 11:00,39,145,51809,83373,184,135182,TUESDAY,0,0,-3.9,74,9.4,1017.8,Fair
1/2/2024 12:00,43,171,72739,124692,214,197431,TUESDAY,0,0,-3.9,74,11.2,1018.1,Fair
1/2/2024 13:00,45,181,177864,134104,226,311968,TUESDAY,0,0,-3.3,77,11.2,1018,Fair
1/2/2024 14:00,52,197,74796,224173,249,298969,TUESDAY,0,0,-1.7,66,11.2,1018,Fair
1/2/2024 15:00,67,272,96008,288894,339,384902,TUESDAY,0,0,-0.6,61,13,1018,Fair
1/2/2024 16:00,80,413,2368854,387924,493,2756778,TUESDAY,0,0,0,56,9.4,1016.9,Fair
1/2/2024 17:00,57,526,76226,581048,583,657274,TUESDAY,0,0,1.7,52,9.4,1015.9,Fair
1/2/2024 18:00,57,363,151344,264408,420,415752,TUESDAY,0,0,2.8,50,9.4,1015,Fair
1/2/2024 19:00,38,198,59925,118352,236,178277,TUESDAY,0,0,5,38,7.6,1014.3,Fair
1/2/2024 20:00,20,132,14830,76014,152,90844,TUESDAY,0,0,3.9,44,0,1014.2,Fair
1/2/2024 21:00,13,82,28769,50150,95,78919,TUESDAY,0,0,3.9,44,0,1014.2,Fair
1/2/2024 22:00,6,34,5515,22579,40,28094,TUESDAY,0,0,2.8,50,13,1014.3,Cloudy
1/2/2024 23:00,11,29,35050,24457,40,59507,TUESDAY,0,0,3.3,48,9.4,1014.2,Fair
1/3/2024 0:00,1,13,349,11312,14,11661,WEDNESDAY,0,0,2.2,56,11.2,1013.8,Fair
1/3/2024 1:00,4,5,7251,4631,9,11882,WEDNESDAY,0,0,0.6,69,13,1013.5,Clear
1/3/2024 2:00,3,4,1179,1586,7,2765,WEDNESDAY,0,0,0.6,69,13,1013.5,Clear
1/3/2024 3:00,0,3,0,2437,3,2437,WEDNESDAY,0,0,1.1,67,11.2,1013.7,Clear
1/3/2024 4:00,1,7,376,5853,8,6229,WEDNESDAY,0,0,1.1,67,13,1013.1,Clear
1/3/2024 5:00,9,44,11781,111146,53,122927,WEDNESDAY,0,0,0.6,69,18.4,1013,Clear
1/3/2024 6:00,13,115,23589,163426,128,187015,WEDNESDAY,0,0,0.6,69,18.4,1013,Clear
1/3/2024 7:00,34,318,48138,267136,352,315274,WEDNESDAY,0,0,-0.6,76,13,1013.4,Clear
1/3/2024 8:00,68,577,87303,473073,645,560376,WEDNESDAY,0,0,-0.6,76,9.4,1013.4,Fair
1/3/2024 9:00,36,332,38281,246220,368,284501,WEDNESDAY,0,0,-0.6,76,16.6,1013.7,Fair
1/3/2024 10:00,37,185,58381,132938,222,191319,WEDNESDAY,0,0,-0.6,78,9.4,1013.9,Clear
1/3/2024 11:00,39,175,167629,309323,214,476952,WEDNESDAY,0,0,-0.6,78,9.4,1013.9,Cloudy
1/3/2024 12:00,40,214,48779,225607,254,274386,WEDNESDAY,0,0,0,75,13,1014.7,Cloudy
1/3/2024 13:00,52,183,68911,126898,235,195809,WEDNESDAY,0,0,1.1,75,14.8,1015.1,Cloudy
1/3/2024 14:00,49,223,77573,147175,272,224748,WEDNESDAY,0,0,1.1,75,14.8,1015.1,Cloudy
1/3/2024 15:00,75,298,192309,240863,373,433172,WEDNESDAY,0,0,4.4,62,13,1014.9,Cloudy
1/3/2024 16:00,92,524,199069,505007,616,704076,WEDNESDAY,0,0,4.4,62,13,1014.9,Cloudy
1/3/2024 17:00,105,659,143198,494960,764,638158,WEDNESDAY,0,0,5.6,57,9.4,1013.5,Cloudy
1/3/2024 18:00,59,418,59514,289335,477,348849,WEDNESDAY,0,0,5,60,5.4,1013.5,Fair
1/3/2024 19:00,42,237,47793,166508,279,214301,WEDNESDAY,0,0,5.6,57,5.4,1013.8,Fair
1/3/2024 20:00,16,169,14944,106812,185,121756,WEDNESDAY,0,0,5,60,7.6,1013.9,Fair
1/3/2024 21:00,18,90,19288,62512,108,81800,WEDNESDAY,0,0,5,60,7.6,1013.9,Fair
1/3/2024 22:00,16,54,17767,39687,70,57454,WEDNESDAY,0,0,5,62,14.8,1013.8,Cloudy
1/3/2024 23:00,10,24,15775,21549,34,37324,WEDNESDAY,0,0,4.4,65,13,1014.8,Cloudy
1/4/2024 0:00,2,16,1846,12106,18,13952,THURSDAY,0,0,4.4,68,13,1015,Fair
1/4/2024 1:00,1,9,544,6336,10,6880,THURSDAY,0,0,4.4,68,13,1015,Fair
1/4/2024 2:00,2,5,3001,2394,7,5395,THURSDAY,0,0,3.9,70,9.4,1014.4,Fair
1/4/2024 3:00,2,4,1377,3206,6,4583,THURSDAY,0,0,3.9,70,11.2,1014,Cloudy
1/4/2024 4:00,1,9,659,6212,10,6871,THURSDAY,0,0,3.9,73,7.6,1013.8,Cloudy
1/4/2024 5:00,6,43,5051,30310,49,35361,THURSDAY,0,0,3.3,76,7.6,1013.6,Cloudy
1/4/2024 6:00,16,122,10606,114892,138,125498,THURSDAY,0,0,3.3,76,7.6,1013.6,Cloudy
1/4/2024 7:00,31,327,23510,330616,358,354126,THURSDAY,0,0,3.3,73,9.4,1013.3,Cloudy
1/4/2024 8:00,58,620,74957,524438,678,599395,THURSDAY,0,0,3.3,73,9.4,1013,Cloudy
1/4/2024 9:00,39,348,124287,253432,387,377719,THURSDAY,0,0,3.3,73,9.4,1012.6,Cloudy
1/4/2024 10:00,32,193,41978,150561,225,192539,THURSDAY,0,0,3.3,73,18.4,1012.5,Cloudy
1/4/2024 11:00,49,211,64688,165779,260,230467,THURSDAY,0,0,3.3,73,18.4,1012.5,Cloudy
1/4/2024 12:00,53,251,90603,156097,304,246700,THURSDAY,0,0,2.8,78,14.8,1012.1,Cloudy
1/4/2024 13:00,47,230,62721,168145,277,230866,THURSDAY,0,0,2.8,82,16.6,1012.5,Cloudy
1/4/2024 14:00,88,236,111148,199088,324,310236,THURSDAY,0,0,3.9,79,16.6,1012.5,Cloudy
1/4/2024 15:00,80,294,106081,303886,374,409967,THURSDAY,0,0,5,70,18.4,1012.2,Cloudy
1/4/2024 16:00,76,481,106104,379725,557,485829,THURSDAY,0,0,5,70,18.4,1012.2,Cloudy
1/4/2024 17:00,76,632,90663,629319,708,719982,THURSDAY,0,0,7.2,58,11.2,1010.4,Cloudy
1/4/2024 18:00,52,418,99463,282504,470,381967,THURSDAY,0,0,6.1,57,11.2,1010.4,Cloudy
1/4/2024 19:00,37,255,31545,173054,292,204599,THURSDAY,0,0,6.1,55,20.5,1010.7,Cloudy
1/4/2024 20:00,27,145,16577,97658,172,114235,THURSDAY,0,0,3.9,52,20.5,1011.9,Cloudy
1/4/2024 21:00,20,90,15802,57095,110,72897,THURSDAY,0,0,3.9,52,33.5,1011.9,Cloudy
1/4/2024 22:00,15,46,14752,65852,61,80604,THURSDAY,0,0,1.7,52,22.3,1014.3,Cloudy
1/4/2024 23:00,6,31,4301,81818,37,86119,THURSDAY,0,0,0,33,27.7,1015.8,Fair
1/5/2024 0:00,1,14,1588,8023,15,9611,FRIDAY,0,0,-1.1,36,27.7,1016.7,Fair
1/5/2024 1:00,1,7,318,3772,8,4090,FRIDAY,0,0,-1.1,32,31.7,1016.7,Clear
1/5/2024 2:00,1,5,506,3002,6,3508,FRIDAY,0,0,-3.3,35,29.5,1018.4,Clear
1/5/2024 3:00,0,1,0,482,1,482,FRIDAY,0,0,-4.4,43,35.3,1018.8,Clear
1/5/2024 4:00,4,6,2713,2925,10,5638,FRIDAY,0,0,-5,50,25.9,1018.9,Clear
1/5/2024 5:00,6,29,8697,17531,35,26228,FRIDAY,0,0,-5,48,25.9,1019.5,Clear
1/5/2024 6:00,6,91,25465,59941,97,85406,FRIDAY,0,0,-5,48,31.7,1019.5,Clear
1/5/2024 7:00,21,203,15456,155780,224,171236,FRIDAY,0,0,-5.6,50,33.5,1020.1,Clear
1/5/2024 8:00,28,434,174585,294935,462,469520,FRIDAY,0,0,-5.6,48,27.7,1020.7,Clear
1/5/2024 9:00,29,261,25289,170330,290,195619,FRIDAY,0,0,-6.1,52,27.7,1021.2,Clear
1/5/2024 10:00,22,154,36214,91249,176,127463,FRIDAY,0,0,-6.1,54,24.1,1021.7,Fair
1/5/2024 11:00,29,172,45991,110536,201,156527,FRIDAY,0,0,-6.1,54,24.1,1021.7,Cloudy
1/5/2024 12:00,39,220,46930,131782,259,178712,FRIDAY,0,0,-6.1,54,27.7,1022.7,Fair
1/5/2024 13:00,40,187,50084,114560,227,164644,FRIDAY,0,0,-5,48,29.5,1023.1,Fair
1/5/2024 14:00,53,254,71635,153702,307,225337,FRIDAY,0,0,-3.3,42,33.5,1023,Fair
1/5/2024 15:00,68,283,69302,182642,351,251944,FRIDAY,0,0,-3.3,42,29.5,1023,Fair
1/5/2024 16:00,51,392,56093,308997,443,365090,FRIDAY,0,0,-0.6,39,18.4,1021.3,Fair
1/5/2024 17:00,54,424,60565,366726,478,427291,FRIDAY,0,0,0.6,38,24.1,1020.6,Fair
1/5/2024 18:00,58,331,165767,294744,389,460511,FRIDAY,0,0,0.6,41,29.5,1020.4,Fair
1/5/2024 19:00,35,192,205165,128340,227,333505,FRIDAY,0,0,1.1,41,20.5,1020.6,Fair
1/5/2024 20:00,32,120,26451,78372,152,104823,FRIDAY,0,0,1.1,41,20.5,1020.6,Fair
1/5/2024 21:00,24,93,24008,111982,117,135990,FRIDAY,0,0,0,47,16.6,1021.2,Fair
1/5/2024 22:00,25,62,24858,44149,87,69007,FRIDAY,0,0,-0.6,49,16.6,1021.4,Cloudy
1/5/2024 23:00,16,50,12788,30708,66,43496,FRIDAY,0,0,-1.1,53,13,1021.8,Fair
1/6/2024 0:00,17,27,24380,20943,44,45323,SATURDAY,1,0,-0.6,56,14.8,1022.2,Fair
1/6/2024 1:00,6,17,6089,11546,23,17635,SATURDAY,1,0,-0.6,56,14.8,1022.2,Fair
1/6/2024 2:00,5,10,23370,7126,15,30496,SATURDAY,1,0,0,61,14.8,1021.8,Fair
1/6/2024 3:00,1,5,2473,7110,6,9583,SATURDAY,1,0,0,64,16.6,1021.4,Fair
1/6/2024 4:00,2,6,3271,3505,8,6776,SATURDAY,1,0,0,64,20.5,1022,Fair
1/6/2024 5:00,2,23,1082,16205,25,17287,SATURDAY,1,0,-0.6,61,20.5,1021.4,Fair
1/6/2024 6:00,6,27,15819,14968,33,30787,SATURDAY,1,0,-0.6,61,20.5,1021.4,Fair
1/6/2024 7:00,12,53,6862,34691,65,41553,SATURDAY,1,0,-0.6,61,11.2,1021.9,Fair
1/6/2024 8:00,11,115,10875,80990,126,91865,SATURDAY,1,0,0,61,13,1022.3,Fair
1/6/2024 9:00,29,183,27970,116882,212,144852,SATURDAY,1,0,-0.6,66,14.8,1022.6,Fair
1/6/2024 10:00,57,224,55780,160989,281,216769,SATURDAY,1,0,-0.6,66,14.8,1022.6,Cloudy
1/6/2024 11:00,65,262,76249,195751,327,272000,SATURDAY,1,0,-0.6,72,9.4,1023.1,Cloudy
1/6/2024 12:00,63,288,98716,298278,351,396994,SATURDAY,1,0,0,69,9.4,1023.3,Cloudy
1/6/2024 13:00,77,270,84525,188435,347,272960,SATURDAY,1,0,0.6,66,7.6,1023.5,Cloudy
1/6/2024 14:00,86,332,228530,244205,418,472735,SATURDAY,1,0,2.2,56,7.6,1024.1,Cloudy
1/6/2024 15:00,88,293,148642,302674,381,451316,SATURDAY,1,0,2.2,56,7.6,1024.1,Cloudy
1/6/2024 16:00,85,305,318039,243908,390,561947,SATURDAY,1,0,2.2,56,13,1022.4,Cloudy
1/6/2024 17:00,65,270,66687,210635,335,277322,SATURDAY,1,0,1.7,64,9.4,1021.7,Cloudy
1/6/2024 18:00,63,233,249697,147555,296,397252,SATURDAY,1,0,1.7,69,11.2,1021.1,Cloudy
1/6/2024 19:00,40,194,38863,212261,234,251124,SATURDAY,1,0,1.7,69,11.2,1021.1,Cloudy
1/6/2024 20:00,38,121,36677,76332,159,113009,SATURDAY,1,0,1.7,72,13,1020.2,Cloudy
1/6/2024 21:00,16,69,104805,49771,85,154576,SATURDAY,1,0,2.2,79,9.4,1019.6,Cloudy
1/6/2024 22:00,9,44,12021,28326,53,40347,SATURDAY,1,0,2.2,73,7.6,1019.6,Cloudy
1/6/2024 23:00,8,33,3119,18822,41,21941,SATURDAY,1,0,2.2,75,9.4,1018.3,Snow
1/7/2024 0:00,2,12,1187,8167,14,9354,SUNDAY,1,0,2.2,75,9.4,1018.3,Snow
1/7/2024 1:00,8,8,6158,4895,16,11053,SUNDAY,1,0,1.7,100,18.4,1018.3,Snow
1/7/2024 2:00,1,3,1731,1668,4,3399,SUNDAY,1,0,2.8,100,16.6,1014.6,Snow
1/7/2024 3:00,0,1,0,509,1,509,SUNDAY,1,0,2.8,100,46.4,1012.9,Snow
1/7/2024 5:00,0,5,0,3939,5,3939,SUNDAY,1,0,2.8,100,42.5,1011.1,Snow
1/7/2024 6:00,0,3,0,990,3,990,SUNDAY,1,0,1.7,100,40.7,1010.9,Snow
1/7/2024 7:00,0,13,0,5980,13,5980,SUNDAY,1,0,1.1,100,44.6,1009.2,Snow
1/7/2024 8:00,3,29,1047,15277,32,16324,SUNDAY,1,0,1.1,100,42.5,1009.2,Snow
1/7/2024 9:00,5,38,3885,16454,43,20339,SUNDAY,1,0,1.1,100,42.5,1009.2,Snow
1/7/2024 10:00,7,58,4051,28909,65,32960,SUNDAY,1,0,1.7,100,38.9,1008.3,Snow
1/7/2024 11:00,10,66,6541,30395,76,36936,SUNDAY,1,0,1.7,100,40.7,1007,Snow
1/7/2024 12:00,4,51,1890,30323,55,32213,SUNDAY,1,0,1.7,100,38.9,1006.3,Snow
1/7/2024 13:00,3,32,6119,18833,35,24952,SUNDAY,1,0,1.7,100,38.9,1005.6,Snow
1/7/2024 14:00,4,21,3017,12341,25,15358,SUNDAY,1,0,1.7,100,44.6,1005.6,Snow
1/7/2024 15:00,3,22,1416,16105,25,17521,SUNDAY,1,0,1.7,100,42.5,1004.4,Snow
1/7/2024 16:00,6,43,11174,23716,49,34890,SUNDAY,1,0,1.1,100,46.4,1000.7,Snow
1/7/2024 17:00,8,43,4931,39399,51,44330,SUNDAY,1,0,1.1,100,33.5,1000.7,Snow
1/7/2024 18:00,6,41,5926,30276,47,36202,SUNDAY,1,0,0.6,100,29.5,1000,Snow
1/7/2024 19:00,2,40,2457,20891,42,23348,SUNDAY,1,0,-1.7,100,29.5,1000.7,Snow
1/7/2024 20:00,1,18,2386,18358,19,20744,SUNDAY,1,0,-3.3,100,27.7,1001.9,Snow
1/7/2024 21:00,6,18,8117,18111,24,26228,SUNDAY,1,0,-3.3,96,37.1,1003.5,Snow
1/7/2024 22:00,2,15,1989,13349,17,15338,SUNDAY,1,0,-3.9,92,31.7,1005.1,Snow
1/7/2024 23:00,2,16,1674,10182,18,11856,SUNDAY,1,0,-3.9,92,31.7,1005.1,Snow
1/8/2024 0:00,2,9,2318,4789,11,7107,MONDAY,0,0,-4.4,91,18.4,1008.4,Snow
1/8/2024 1:00,3,3,1700,1405,6,3105,MONDAY,0,0,-4.4,91,22.3,1008.4,Snow
1/8/2024 2:00,0,1,0,166,1,166,MONDAY,0,0,-3.9,92,22.3,1010.7,Snow
1/8/2024 3:00,0,3,0,2633,3,2633,MONDAY,0,0,-3.9,88,20.5,1011.5,Snow
1/8/2024 4:00,1,3,390,2074,4,2464,MONDAY,0,0,-3.3,88,14.8,1012.5,Cloudy
1/8/2024 5:00,4,23,3245,14579,27,17824,MONDAY,0,0,-3.3,88,14.8,1012.5,Cloudy
1/8/2024 6:00,4,56,3057,38232,60,41289,MONDAY,0,0,-2.8,85,13,1014.8,Cloudy
1/8/2024 7:00,13,171,13355,189067,184,202422,MONDAY,0,0,-2.8,89,11.2,1016,Cloudy
1/8/2024 8:00,25,344,34420,267014,369,301434,MONDAY,0,0,-2.8,85,9.4,1016.6,Cloudy
1/8/2024 9:00,14,194,10752,226503,208,237255,MONDAY,0,0,-2.2,85,13,1018.3,Cloudy
1/8/2024 10:00,11,140,11842,133726,151,145568,MONDAY,0,0,-2.2,85,13,1018.3,Cloudy
1/8/2024 11:00,18,150,23112,96005,168,119117,MONDAY,0,0,-2.2,85,16.6,1020.7,Cloudy
1/8/2024 12:00,17,164,14784,121842,181,136626,MONDAY,0,0,-2.2,78,20.5,1022.5,Fair
1/8/2024 13:00,27,132,33720,86505,159,120225,MONDAY,0,0,-2.2,78,18.4,1024.4,Fair
1/8/2024 14:00,19,147,20566,102209,166,122775,MONDAY,0,0,-1.7,82,14.8,1024.7,Fair
1/8/2024 15:00,41,237,47887,160365,278,208252,MONDAY,0,0,-1.7,82,14.8,1024.7,Fair
1/8/2024 16:00,60,322,68746,228428,382,297174,MONDAY,0,0,0.6,69,25.9,1024.9,Fair
1/8/2024 17:00,67,456,68118,368042,523,436160,MONDAY,0,0,1.1,67,18.4,1025.1,Fair
1/8/2024 18:00,58,347,59620,237601,405,297221,MONDAY,0,0,1.1,69,20.5,1025.8,Fair
1/8/2024 19:00,46,247,56548,169921,293,226469,MONDAY,0,0,1.1,69,20.5,1025.8,Fair
1/8/2024 20:00,14,148,12329,112478,162,124807,MONDAY,0,0,1.7,66,11.2,1027.2,Fair
1/8/2024 21:00,12,89,10177,65290,101,75467,MONDAY,0,0,1.7,66,13,1027.6,Fair
1/8/2024 22:00,12,60,16076,40873,72,56949,MONDAY,0,0,1.7,69,9.4,1028.4,Cloudy
1/8/2024 23:00,7,47,3839,26300,54,30139,MONDAY,0,0,1.1,69,14.8,1028.9,Fair
1/9/2024 0:00,3,17,9636,10075,20,19711,TUESDAY,0,0,1.1,69,14.8,1028.9,Fair
1/9/2024 1:00,3,8,974,6338,11,7312,TUESDAY,0,0,0.6,69,7.6,1029.9,Fair
1/9/2024 2:00,0,2,0,1126,2,1126,TUESDAY,0,0,-0.6,82,9.4,1029.7,Clear
1/9/2024 3:00,0,4,0,2016,4,2016,TUESDAY,0,0,0,75,11.2,1029.4,Clear
1/9/2024 4:00,1,8,237,5871,9,6108,TUESDAY,0,0,-1.1,81,11.2,1029.6,Clear
1/9/2024 5:00,6,35,6425,21874,41,28299,TUESDAY,0,0,-1.1,81,11.2,1029.6,Clear
1/9/2024 6:00,3,105,16437,74837,108,91274,TUESDAY,0,0,-1.7,85,9.4,1030.2,Clear
1/9/2024 7:00,33,285,25923,191755,318,217678,TUESDAY,0,0,-1.1,81,9.4,1031.4,Clear
1/9/2024 8:00,48,645,147169,502198,693,649367,TUESDAY,0,0,-2.8,92,9.4,1029.9,Clear
1/9/2024 9:00,35,389,65887,357201,424,423088,TUESDAY,0,0,-2.8,92,7.6,1029.9,Fair
1/9/2024 10:00,23,200,22696,141504,223,164200,TUESDAY,0,0,-2.8,92,7.6,1029.9,Cloudy
1/9/2024 11:00,37,178,41690,121983,215,163673,TUESDAY,0,0,-1.7,72,5.4,1031,Cloudy
1/9/2024 12:00,31,235,35199,135868,266,171067,TUESDAY,0,0,-1.1,72,0,1030.6,Cloudy
1/9/2024 13:00,34,213,38905,135848,247,174753,TUESDAY,0,0,-1.1,75,7.6,1029.7,Cloudy
1/9/2024 14:00,37,230,65614,154315,267,219929,TUESDAY,0,0,-1.1,75,7.6,1029.7,Cloudy
1/9/2024 15:00,46,363,49180,294599,409,343779,TUESDAY,0,0,0,75,0,1029,Cloudy
1/9/2024 16:00,85,500,96070,371521,585,467591,TUESDAY,0,0,0.6,72,7.6,1028.1,Cloudy
1/9/2024 17:00,66,545,171388,418410,611,589798,TUESDAY,0,0,0.6,78,9.4,1026.5,Cloudy
1/9/2024 18:00,20,178,19362,123411,198,142773,TUESDAY,0,0,1.7,85,14.8,1025.3,Cloudy
1/9/2024 19:00,13,124,10124,79721,137,89845,TUESDAY,0,0,1.7,85,14.8,1025.3,Cloudy
1/9/2024 20:00,5,70,6947,95521,75,102468,TUESDAY,0,0,2.8,89,24.1,1021.3,Snow
1/9/2024 21:00,6,54,16813,41799,60,58612,TUESDAY,0,0,3.3,86,24.1,1020.2,Rain
1/9/2024 22:00,3,26,2456,17684,29,20140,TUESDAY,0,0,3.3,86,24.1,1020.2,Rain
1/9/2024 23:00,2,9,1933,18042,11,19975,TUESDAY,0,0,3.3,100,33.5,1018.7,Rain
1/10/2024 0:00,0,13,0,9616,13,9616,WEDNESDAY,0,0,4.4,100,37.1,1016.7,Rain
1/10/2024 1:00,1,1,344,1739,2,2083,WEDNESDAY,0,0,5,100,40.7,1011,Rain
1/10/2024 2:00,1,1,901,640,2,1541,WEDNESDAY,0,0,5.6,100,50,1008.7,Rain
1/10/2024 4:00,2,3,1037,1422,5,2459,WEDNESDAY,0,0,5.6,100,50,1005.5,Rain
1/10/2024 5:00,4,28,208662,20369,32,229031,WEDNESDAY,0,0,7.8,100,48.2,998.1,Rain
1/10/2024 6:00,5,68,2681,88055,73,90736,WEDNESDAY,0,0,7.8,100,51.8,998.1,Rain
1/10/2024 7:00,30,277,26319,228734,307,255053,WEDNESDAY,0,0,8.9,100,53.6,989.6,Rain
1/10/2024 8:00,75,787,66118,609866,862,675984,WEDNESDAY,0,0,8.9,100,53.6,989.6,Rain
1/10/2024 9:00,51,395,44025,296407,446,340432,WEDNESDAY,0,0,10,100,0,986.2,Cloudy
1/10/2024 10:00,36,249,65774,170640,285,236414,WEDNESDAY,0,0,9.4,100,20.5,986.2,Cloudy
1/10/2024 11:00,53,258,54075,183525,311,237600,WEDNESDAY,0,0,11.7,100,24.1,980.3,Rain
1/10/2024 12:00,50,283,213695,180099,333,393794,WEDNESDAY,0,0,11.7,100,37.1,980.3,Rain
1/10/2024 13:00,55,260,51371,173967,315,225338,WEDNESDAY,0,0,12.8,100,25.9,980.2,Rain
1/10/2024 14:00,56,297,50762,312423,353,363185,WEDNESDAY,0,0,13.3,97,31.7,981.9,Rain
1/10/2024 15:00,70,362,63632,251599,432,315231,WEDNESDAY,0,0,11.1,80,22.3,983.6,Cloudy
1/10/2024 16:00,102,608,168066,557605,710,725671,WEDNESDAY,0,0,11.1,77,27.7,984.6,Cloudy
1/10/2024 17:00,131,818,223592,813993,949,1037585,WEDNESDAY,0,0,10.6,77,27.7,985.8,Cloudy
1/10/2024 18:00,89,600,170117,455425,689,625542,WEDNESDAY,0,0,10,66,31.7,987.3,Cloudy
1/10/2024 19:00,62,376,69869,254698,438,324567,WEDNESDAY,0,0,10,66,31.7,987.3,Cloudy
1/10/2024 20:00,62,264,49602,189657,326,239259,WEDNESDAY,0,0,9.4,59,29.5,991,Cloudy
1/10/2024 21:00,34,170,28646,120414,204,149060,WEDNESDAY,0,0,8.3,52,35.3,992.6,Fair
1/10/2024 22:00,32,97,23877,100091,129,123968,WEDNESDAY,0,0,7.8,55,35.3,994.2,Cloudy
1/10/2024 23:00,19,88,70554,57848,107,128402,WEDNESDAY,0,0,7.8,55,27.7,995.5,Fair
1/11/2024 0:00,5,19,1009856,10301,24,1020157,THURSDAY,0,0,7.8,55,27.7,995.5,Fair
1/11/2024 1:00,4,11,2212,7239,15,9451,THURSDAY,0,0,7.2,60,25.9,997.6,Fair
1/11/2024 2:00,1,6,436,3377,7,3813,THURSDAY,0,0,7.2,60,29.5,998.2,Fair
1/11/2024 3:00,0,5,0,1301,5,1301,THURSDAY,0,0,7.2,63,27.7,999.2,Fair
1/11/2024 4:00,1,8,290,4350,9,4640,THURSDAY,0,0,6.7,62,24.1,1000.1,Fair
1/11/2024 5:00,6,44,5488,32993,50,38481,THURSDAY,0,0,6.7,62,24.1,1000.1,Fair
1/11/2024 6:00,11,137,5294,88089,148,93383,THURSDAY,0,0,5.6,57,22.3,1002.3,Fair
1/11/2024 7:00,39,430,32236,399492,469,431728,THURSDAY,0,0,5.6,57,22.3,1003.2,Fair
1/11/2024 8:00,76,782,62086,581696,858,643782,THURSDAY,0,0,5,57,25.9,1004.1,Fair
1/11/2024 9:00,52,447,30528,368280,499,398808,THURSDAY,0,0,5,57,25.9,1004.1,Fair
1/11/2024 10:00,34,254,27807,178997,288,206804,THURSDAY,0,0,4.4,60,18.4,1006,Cloudy
1/11/2024 11:00,37,280,40883,370610,317,411493,THURSDAY,0,0,4.4,55,24.1,1007.2,Cloudy
1/11/2024 12:00,56,303,153970,315154,359,469124,THURSDAY,0,0,4.4,55,24.1,1007.2,Fair
1/11/2024 13:00,48,297,57459,175463,345,232922,THURSDAY,0,0,4.4,57,22.3,1008.6,Fair
1/11/2024 14:00,69,309,88991,211195,378,300186,THURSDAY,0,0,4.4,57,22.3,1008.6,Fair
1/11/2024 15:00,93,424,397927,320380,517,718307,THURSDAY,0,0,5,55,25.9,1008.7,Fair
1/11/2024 16:00,115,612,134573,611133,727,745706,THURSDAY,0,0,6.1,53,20.5,1007.7,Fair
1/11/2024 17:00,117,817,200639,722434,934,923073,THURSDAY,0,0,6.7,51,20.5,1007.6,Fair
1/11/2024 18:00,95,628,101173,524943,723,626116,THURSDAY,0,0,6.7,49,18.4,1008.1,Cloudy
1/11/2024 19:00,63,391,54786,310447,454,365233,THURSDAY,0,0,6.7,49,18.4,1008.1,Cloudy
1/11/2024 20:00,49,269,38685,180340,318,219025,THURSDAY,0,0,6.1,55,16.6,1008.8,Cloudy
1/11/2024 21:00,71,213,55559,141315,284,196874,THURSDAY,0,0,6.1,55,14.8,1009.6,Cloudy
1/11/2024 22:00,35,160,41184,184833,195,226017,THURSDAY,0,0,6.1,57,11.2,1010.1,Cloudy
1/11/2024 23:00,23,60,26056,39331,83,65387,THURSDAY,0,0,6.1,57,11.2,1010.1,Cloudy
1/12/2024 0:00,11,33,14361,13010,44,27371,FRIDAY,0,0,5,65,16.6,1011.3,Cloudy
1/12/2024 1:00,6,12,92615,5124,18,97739,FRIDAY,0,0,4.4,65,16.6,1012.2,Cloudy
1/12/2024 2:00,4,9,2822,5058,13,7880,FRIDAY,0,0,4.4,68,20.5,1012.8,Cloudy
1/12/2024 3:00,4,2,5925,2066,6,7991,FRIDAY,0,0,4.4,68,14.8,1013.3,Cloudy
1/12/2024 4:00,2,9,1534,5843,11,7377,FRIDAY,0,0,3.9,70,16.6,1013.6,Cloudy
1/12/2024 5:00,7,59,5067,36159,66,41226,FRIDAY,0,0,3.9,70,16.6,1013.6,Fair
1/12/2024 6:00,18,124,11637,84890,142,96527,FRIDAY,0,0,3.3,73,18.4,1015.8,Fair
1/12/2024 7:00,38,317,35609,228935,355,264544,FRIDAY,0,0,2.2,82,14.8,1016.3,Fair
1/12/2024 8:00,68,598,67790,417980,666,485770,FRIDAY,0,0,3.3,76,20.5,1017.5,Fair
1/12/2024 9:00,61,450,100637,268610,511,369247,FRIDAY,0,0,3.3,76,20.5,1017.5,Fair
1/12/2024 10:00,51,286,55685,175153,337,230838,FRIDAY,0,0,4.4,70,16.6,1018.7,Cloudy
1/12/2024 11:00,67,303,106211,204976,370,311187,FRIDAY,0,0,4.4,70,16.6,1018.7,Cloudy
1/12/2024 12:00,71,345,76716,216042,416,292758,FRIDAY,0,0,5,70,16.6,1020.6,Fair
1/12/2024 13:00,104,339,109598,228857,443,338455,FRIDAY,0,0,5.6,67,20.5,1021.4,Fair
1/12/2024 14:00,110,357,177338,255715,467,433053,FRIDAY,0,0,5.6,67,20.5,1021.4,Fair
1/12/2024 15:00,150,439,378759,310486,589,689245,FRIDAY,0,0,7.2,53,11.2,1022.2,Fair
1/12/2024 16:00,145,578,193784,433670,723,627454,FRIDAY,0,0,7.2,51,0,1021.8,Fair
1/12/2024 17:00,128,639,128971,560917,767,689888,FRIDAY,0,0,8.3,52,0,1021.7,Fair
1/12/2024 18:00,106,498,143394,356963,604,500357,FRIDAY,0,0,6.7,62,0,1020.9,Fair
1/12/2024 19:00,80,328,73381,226765,408,300146,FRIDAY,0,0,6.7,62,16.6,1020.9,Fair
1/12/2024 20:00,74,250,76389,180040,324,256429,FRIDAY,0,0,5,89,9.4,1021.2,Cloudy
1/12/2024 21:00,68,200,240146,162576,268,402722,FRIDAY,0,0,4.4,89,14.8,1021.2,Cloudy
1/12/2024 22:00,59,163,819147,100910,222,920057,FRIDAY,0,0,3.9,89,16.6,1020.3,Cloudy
1/12/2024 23:00,42,121,37292,77322,163,114614,FRIDAY,0,0,3.9,93,20.5,1019.7,Cloudy
1/13/2024 0:00,57,60,114721,44949,117,159670,SATURDAY,1,0,3.9,93,20.5,1019.7,Cloudy
1/13/2024 1:00,36,55,64248,47895,91,112143,SATURDAY,1,0,4.4,93,18.4,1019.1,Cloudy
1/13/2024 2:00,14,21,35261,11416,35,46677,SATURDAY,1,0,5,93,18.4,1020.1,Cloudy
1/13/2024 3:00,2,1,6110,1240,3,7350,SATURDAY,1,0,5,96,18.4,1017.9,Cloudy
1/13/2024 4:00,1,3,298,1895,4,2193,SATURDAY,1,0,5,96,25.9,1017.9,Rain
1/13/2024 5:00,1,3,369,2864,4,3233,SATURDAY,1,0,5.6,92,22.3,1017.2,Rain
1/13/2024 6:00,1,6,1085,3895,7,4980,SATURDAY,1,0,6.1,89,33.5,1012.2,Rain
1/13/2024 7:00,2,14,1258,15026,16,16284,SATURDAY,1,0,5.6,100,40.7,1009.9,Rain
1/13/2024 8:00,6,44,7035,27888,50,34923,SATURDAY,1,0,5.6,100,44.6,1006.2,Rain
1/13/2024 9:00,18,80,18391,57412,98,75803,SATURDAY,1,0,5.6,100,50,1006.2,Rain
1/13/2024 10:00,30,177,23729,129849,207,153578,SATURDAY,1,0,6.1,100,46.4,1002.2,Rain
1/13/2024 11:00,54,245,67030,176267,299,243297,SATURDAY,1,0,6.1,100,42.5,1002.2,Rain
1/13/2024 12:00,96,315,136992,216979,411,353971,SATURDAY,1,0,6.7,100,38.9,999.2,Rain
1/13/2024 13:00,151,347,301146,487402,498,788548,SATURDAY,1,0,8.3,100,24.1,996.9,Rain
1/13/2024 14:00,256,478,1108712,418671,734,1527383,SATURDAY,1,0,10,100,29.5,991.1,Rain
1/13/2024 15:00,227,443,1664924,433140,670,2098064,SATURDAY,1,0,8.9,100,20.5,989.1,Rain
1/13/2024 16:00,102,305,168613,232862,407,401475,SATURDAY,1,0,10,100,16.6,986.4,Cloudy
1/13/2024 17:00,106,280,128577,228436,386,357013,SATURDAY,1,0,13.9,100,16.6,985.2,Rain
1/13/2024 18:00,89,281,179810,201532,370,381342,SATURDAY,1,0,15,87,27.7,984.4,Rain
1/13/2024 19:00,55,224,60744,211412,279,272156,SATURDAY,1,0,15,87,27.7,984.4,Rain
1/13/2024 20:00,69,188,156786,201461,257,358247,SATURDAY,1,0,13.9,69,35.3,985.4,Rain
1/13/2024 21:00,64,128,125094,145133,192,270227,SATURDAY,1,0,13.9,69,38.9,985.4,Cloudy
1/13/2024 22:00,41,117,33621,85419,158,119040,SATURDAY,1,0,10.6,83,27.7,987.6,Cloudy
1/13/2024 23:00,45,98,95307,61216,143,156523,SATURDAY,1,0,7.2,76,33.5,990.1,Cloudy
1/14/2024 0:00,45,61,52436,37290,106,89726,SUNDAY,1,0,6.1,70,29.5,994.1,Fair
1/14/2024 1:00,33,44,44106,59379,77,103485,SUNDAY,1,0,6.1,68,16.6,995.5,Fair
1/14/2024 2:00,24,27,31117,25183,51,56300,SUNDAY,1,0,5.6,55,16.6,996.7,Fair
1/14/2024 3:00,11,12,19050,6600,23,25650,SUNDAY,1,0,4.4,53,35.3,998.2,Fair
1/14/2024 4:00,3,8,1577,5089,11,6666,SUNDAY,1,0,4.4,53,37.1,998.2,Fair
1/14/2024 5:00,1,17,2746,9496,18,12242,SUNDAY,1,0,3.3,48,22.3,1001.8,Fair
1/14/2024 6:00,3,23,1700,11074,26,12774,SUNDAY,1,0,2.8,46,31.7,1003.4,Fair
1/14/2024 7:00,3,52,1247,32362,55,33609,SUNDAY,1,0,2.8,50,25.9,1004.6,Fair
1/14/2024 8:00,19,104,24153,62748,123,86901,SUNDAY,1,0,1.7,54,25.9,1005.6,Fair
1/14/2024 9:00,44,186,47479,128763,230,176242,SUNDAY,1,0,1.7,54,31.7,1005.6,Fair
1/14/2024 10:00,65,249,199922,174171,314,374093,SUNDAY,1,0,0.6,56,29.5,1007,Cloudy
1/14/2024 11:00,106,247,131359,179205,353,310564,SUNDAY,1,0,0,58,29.5,1008,Fair
1/14/2024 12:00,108,326,264065,242017,434,506082,SUNDAY,1,0,0.6,56,29.5,1008.4,Fair
1/14/2024 13:00,114,336,258431,235458,450,493889,SUNDAY,1,0,0.6,56,29.5,1008.4,Fair
1/14/2024 14:00,100,320,127416,220507,420,347923,SUNDAY,1,0,2.2,50,33.5,1008.5,Fair
1/14/2024 15:00,79,231,103096,152925,310,256021,SUNDAY,1,0,3.3,48,42.5,1007.7,Fair
1/14/2024 16:00,68,274,68377,186418,342,254795,SUNDAY,1,0,3.9,50,38.9,1006.6,Fair
1/14/2024 17:00,56,256,49091,181834,312,230925,SUNDAY,1,0,5,46,38.9,1005.8,Cloudy
1/14/2024 18:00,25,186,16379,110631,211,127010,SUNDAY,1,0,5,46,46.4,1005.8,Cloudy
1/14/2024 19:00,27,160,23127,98584,187,121711,SUNDAY,1,0,4.4,51,38.9,1005.3,Cloudy
1/14/2024 20:00,28,109,22112,65962,137,88074,SUNDAY,1,0,2.2,82,35.3,1005,Cloudy
1/14/2024 21:00,22,83,23844,52396,105,76240,SUNDAY,1,0,3.3,59,48.2,1005.4,Cloudy
1/14/2024 22:00,14,51,10586,29228,65,39814,SUNDAY,1,0,2.2,44,37.1,1006.9,Fair
1/14/2024 23:00,16,44,190990,25049,60,216039,SUNDAY,1,0,-0.6,56,35.3,1010.2,Fair
1/15/2024 0:00,8,37,8617,19732,45,28349,MONDAY,0,1,-1.7,45,31.7,1014.7,Fair
1/15/2024 1:00,7,19,52714,10898,26,63612,MONDAY,0,1,-2.2,46,29.5,1015.8,Fair
1/15/2024 2:00,0,11,0,5206,11,5206,MONDAY,0,1,-2.2,42,31.7,1016.8,Clear
1/15/2024 3:00,3,6,2534,5045,9,7579,MONDAY,0,1,-2.8,41,25.9,1017.2,Clear
1/15/2024 4:00,0,5,0,3531,5,3531,MONDAY,0,1,-2.8,41,25.9,1017.2,Clear
1/15/2024 5:00,3,20,1221,13419,23,14640,MONDAY,0,1,-3.3,40,18.4,1018.1,Clear
1/15/2024 6:00,4,42,4376,21106,46,25482,MONDAY,0,1,-3.3,40,27.7,1019.2,Clear
1/15/2024 7:00,13,86,20162,60112,99,80274,MONDAY,0,1,-3.9,40,24.1,1020.2,Clear
1/15/2024 8:00,25,145,21422,97563,170,118985,MONDAY,0,1,-4.4,46,18.4,1020.9,Clear
1/15/2024 9:00,21,185,28376,119553,206,147929,MONDAY,0,1,-4.4,46,18.4,1020.9,Clear
1/15/2024 10:00,50,236,95075,140778,286,235853,MONDAY,0,1,-4.4,46,20.5,1021.6,Clear
1/15/2024 11:00,59,242,70411,152584,301,222995,MONDAY,0,1,-5,48,16.6,1022,Fair
1/15/2024 12:00,69,290,82368,323890,359,406258,MONDAY,0,1,-5,48,22.3,1022.7,Fair
1/15/2024 13:00,63,279,85001,204336,342,289337,MONDAY,0,1,-5,48,22.3,1022.7,Fair
1/15/2024 14:00,101,290,122601,329525,391,452126,MONDAY,0,1,-2.8,44,11.2,1023.2,Fair
1/15/2024 15:00,76,323,104295,239624,399,343919,MONDAY,0,1,-1.7,39,14.8,1022.4,Fair
1/15/2024 16:00,62,335,96282,341031,397,437313,MONDAY,0,1,-1.7,39,14.8,1022.4,Fair
1/15/2024 17:00,57,303,65897,218724,360,284621,MONDAY,0,1,-0.6,36,18.4,1021.7,Fair
1/15/2024 18:00,41,318,37142,191584,359,228726,MONDAY,0,1,-0.6,36,18.4,1021.7,Fair
1/15/2024 19:00,43,253,29655,149984,296,179639,MONDAY,0,1,0,31,14.8,1021.6,Fair
1/15/2024 20:00,30,177,28815,104530,207,133345,MONDAY,0,1,-0.6,34,16.6,1021.9,Fair
1/15/2024 21:00,25,135,20827,72866,160,93693,MONDAY,0,1,-0.6,34,14.8,1021.6,Fair
1/15/2024 22:00,19,79,17436,134027,98,151463,MONDAY,0,1,-0.6,34,14.8,1022.1,Cloudy
1/15/2024 23:00,17,32,14513,14318,49,28831,MONDAY,0,1,-0.6,34,14.8,1022.1,Cloudy
1/16/2024 0:00,1,16,276,11300,17,11576,TUESDAY,0,0,-0.6,36,0,1022,Cloudy
1/16/2024 1:00,6,14,6933,218455,20,225388,TUESDAY,0,0,-1.1,37,11.2,1022.1,Cloudy
1/16/2024 2:00,2,4,2278,1673,6,3951,TUESDAY,0,0,-1.1,37,13,1022,Cloudy
1/16/2024 3:00,2,6,4056,5595,8,9651,TUESDAY,0,0,-1.1,44,13,1022.2,Cloudy
1/16/2024 4:00,2,7,656,3092,9,3748,TUESDAY,0,0,-1.1,44,13,1022.2,Cloudy
1/16/2024 5:00,3,31,3052,28455,34,31507,TUESDAY,0,0,-1.7,53,9.4,1021.2,Cloudy
1/16/2024 6:00,7,77,4599,48857,84,53456,TUESDAY,0,0,-1.7,53,9.4,1021.2,Cloudy
1/16/2024 7:00,19,191,36244,138213,210,174457,TUESDAY,0,0,-3.3,81,0,1021.4,Cloudy
1/16/2024 8:00,61,400,58715,333170,461,391885,TUESDAY,0,0,-3.9,96,0,1020.7,Snow
1/16/2024 9:00,40,239,44304,187343,279,231647,TUESDAY,0,0,-3.9,100,9.4,1019.7,Snow
1/16/2024 10:00,16,86,18180,51549,102,69729,TUESDAY,0,0,-3.9,100,9.4,1019.7,Snow
1/16/2024 11:00,5,70,5557,52973,75,58530,TUESDAY,0,0,-3.9,100,11.2,1019.1,Snow
1/16/2024 12:00,8,64,5817,55663,72,61480,TUESDAY,0,0,-3.3,100,13,1018.3,Cloudy
1/16/2024 13:00,11,73,16836,42642,84,59478,TUESDAY,0,0,-2.8,100,13,1016.2,Snow
1/16/2024 14:00,13,72,8687,50042,85,58729,TUESDAY,0,0,-2.2,100,14.8,1015.2,Snow
1/16/2024 15:00,12,133,9544,86645,145,96189,TUESDAY,0,0,-2.2,100,14.8,1015.2,Snow
1/16/2024 16:00,10,214,13485,149048,224,162533,TUESDAY,0,0,0.6,100,16.6,1013.2,Snow
1/16/2024 17:00,25,258,26338,196320,283,222658,TUESDAY,0,0,0.6,100,11.2,1007.4,Rain
1/16/2024 18:00,18,189,13752,142759,207,156511,TUESDAY,0,0,0.6,100,11.2,1007.4,Rain
1/16/2024 19:00,14,151,13828,111469,165,125297,TUESDAY,0,0,1.1,100,14.8,1003.2,Rain
1/16/2024 20:00,8,127,6521,83219,135,89740,TUESDAY,0,0,1.1,100,14.8,1003.2,Rain
1/16/2024 21:00,11,69,17514,203119,80,220633,TUESDAY,0,0,0,100,18.4,1001.7,Rain
1/16/2024 22:00,6,58,3873,33062,64,36935,TUESDAY,0,0,-1.1,100,25.9,1001.1,Rain
1/16/2024 23:00,8,39,7513,20462,47,27975,TUESDAY,0,0,-3.3,92,31.7,1002.6,Snow
1/17/2024 0:00,1,9,392,4725,10,5117,WEDNESDAY,0,0,-2.8,92,20.5,1002.1,Snow
1/17/2024 1:00,3,4,1911,2831,7,4742,WEDNESDAY,0,0,-2.2,85,25.9,1002.3,Cloudy
1/17/2024 2:00,3,3,3653,1558,6,5211,WEDNESDAY,0,0,-2.2,85,25.9,1002.3,Cloudy
1/17/2024 3:00,1,6,1374,4840,7,6214,WEDNESDAY,0,0,-2.8,72,29.5,1003.1,Cloudy
1/17/2024 4:00,1,3,488,1532,4,2020,WEDNESDAY,0,0,-3.9,72,37.1,1003.9,Cloudy
1/17/2024 5:00,3,31,5515,47862,34,53377,WEDNESDAY,0,0,-4.4,65,25.9,1004.6,Cloudy
1/17/2024 6:00,5,111,4491,127246,116,131737,WEDNESDAY,0,0,-5,71,25.9,1004.9,Fair
1/17/2024 7:00,18,256,20921,236366,274,257287,WEDNESDAY,0,0,-6.1,68,25.9,1006.2,Fair
1/17/2024 8:00,38,516,36625,566227,554,602852,WEDNESDAY,0,0,-6.1,68,25.9,1006.2,Fair
1/17/2024 9:00,22,315,19321,259731,337,279052,WEDNESDAY,0,0,-6.7,65,31.7,1007.2,Fair
1/17/2024 10:00,16,191,12642,131971,207,144613,WEDNESDAY,0,0,-6.7,65,20.5,1007.6,Cloudy
1/17/2024 11:00,22,180,24621,121647,202,146268,WEDNESDAY,0,0,-7.2,64,22.3,1008.6,Cloudy
1/17/2024 12:00,21,191,35162,198942,212,234104,WEDNESDAY,0,0,-7.2,64,22.3,1008.6,Fair
1/17/2024 13:00,19,163,23434,180204,182,203638,WEDNESDAY,0,0,-6.7,62,24.1,1010.1,Fair
1/17/2024 14:00,30,193,37540,129208,223,166748,WEDNESDAY,0,0,-5.6,57,27.7,1010.8,Fair
1/17/2024 15:00,24,269,22509,272947,293,295456,WEDNESDAY,0,0,-4.4,57,27.7,1010.6,Fair
1/17/2024 16:00,55,419,47411,425155,474,472566,WEDNESDAY,0,0,-3.9,57,25.9,1010.2,Fair
1/17/2024 17:00,63,566,71779,480836,629,552615,WEDNESDAY,0,0,-3.9,57,24.1,1010.2,Fair
1/17/2024 18:00,57,421,273500,450206,478,723706,WEDNESDAY,0,0,-2.8,53,24.1,1009.6,Fair
1/17/2024 19:00,29,292,22618,274787,321,297405,WEDNESDAY,0,0,-3.3,50,25.9,1009.6,Fair
1/17/2024 20:00,23,170,16604,111976,193,128580,WEDNESDAY,0,0,-3.3,50,25.9,1009.6,Fair
1/17/2024 21:00,24,148,19548,189996,172,209544,WEDNESDAY,0,0,-4.4,52,25.9,1011.2,Fair
1/17/2024 22:00,12,94,6613,54499,106,61112,WEDNESDAY,0,0,-4.4,52,25.9,1011.2,Cloudy
1/17/2024 23:00,2,29,2435,17156,31,19591,WEDNESDAY,0,0,-5,48,16.6,1013.2,Fair
1/18/2024 0:00,4,24,1172,12743,28,13915,THURSDAY,0,0,-5.6,48,25.9,1014.3,Fair
1/18/2024 1:00,3,0,4036,0,3,4036,THURSDAY,0,0,-6.1,45,22.3,1015,Fair
1/18/2024 2:00,2,4,3399,3703,6,7102,THURSDAY,0,0,-6.1,45,22.3,1015,Clear
1/18/2024 4:00,2,7,598,4092,9,4690,THURSDAY,0,0,-7.2,51,20.5,1016,Clear
1/18/2024 5:00,1,36,863,23051,37,23914,THURSDAY,0,0,-7.2,51,24.1,1016.3,Clear
1/18/2024 6:00,12,101,9061,96682,113,105743,THURSDAY,0,0,-7.8,54,22.3,1017,Clear
1/18/2024 7:00,27,279,201148,227651,306,428799,THURSDAY,0,0,-7.8,54,22.3,1017,Clear
1/18/2024 8:00,49,603,52567,434583,652,487150,THURSDAY,0,0,-7.2,49,27.7,1017.8,Clear
1/18/2024 9:00,37,364,25936,266513,401,292449,THURSDAY,0,0,-7.2,51,25.9,1018.5,Clear
1/18/2024 10:00,27,193,19660,116730,220,136390,THURSDAY,0,0,-7.8,56,27.7,1018.8,Clear
1/18/2024 11:00,35,171,63723,99239,206,162962,THURSDAY,0,0,-6.7,52,29.5,1018.8,Cloudy
1/18/2024 12:00,21,199,17245,125478,220,142723,THURSDAY,0,0,-6.7,52,29.5,1018.8,Cloudy
1/18/2024 13:00,35,194,32193,297947,229,330140,THURSDAY,0,0,-6.7,54,20.5,1019.6,Cloudy
1/18/2024 14:00,29,232,32805,139548,261,172353,THURSDAY,0,0,-6.1,54,20.5,1019.8,Cloudy
1/18/2024 15:00,62,276,141319,178311,338,319630,THURSDAY,0,0,-5,54,22.3,1019.6,Cloudy
1/18/2024 16:00,61,434,48859,306148,495,355007,THURSDAY,0,0,-5,54,22.3,1019.6,Cloudy
1/18/2024 17:00,79,641,73968,476003,720,549971,THURSDAY,0,0,-2.8,53,16.6,1017.7,Cloudy
1/18/2024 18:00,66,455,55068,408506,521,463574,THURSDAY,0,0,-1.7,53,25.9,1017.2,Cloudy
1/18/2024 19:00,44,310,48480,427197,354,475677,THURSDAY,0,0,-2.2,55,25.9,1017,Cloudy
1/18/2024 20:00,19,219,12799,155987,238,168786,THURSDAY,0,0,-2.2,58,18.4,1016.8,Cloudy
1/18/2024 21:00,17,175,18634,117743,192,136377,THURSDAY,0,0,-2.2,58,18.4,1016.8,Cloudy
1/18/2024 22:00,19,111,15163,73828,130,88991,THURSDAY,0,0,-2.2,60,22.3,1017.4,Cloudy
1/18/2024 23:00,13,52,20726,26513,65,47239,THURSDAY,0,0,-2.2,60,18.4,1017.2,Cloudy
1/19/2024 0:00,4,27,92875,12633,31,105508,FRIDAY,0,0,-2.8,69,18.4,1017.3,Cloudy
1/19/2024 1:00,2,8,1061,5198,10,6259,FRIDAY,0,0,-2.8,72,22.3,1017.4,Cloudy
1/19/2024 2:00,1,9,237,6707,10,6944,FRIDAY,0,0,-2.8,72,22.3,1017.4,Cloudy
1/19/2024 3:00,0,1,0,481,1,481,FRIDAY,0,0,-2.2,69,13,1017.5,Cloudy
1/19/2024 4:00,0,4,0,1769,4,1769,FRIDAY,0,0,-2.8,69,13,1016.7,Cloudy
1/19/2024 5:00,7,26,6581,19140,33,25721,FRIDAY,0,0,-2.8,69,14.8,1015.9,Cloudy
1/19/2024 6:00,7,99,3665,174709,106,178374,FRIDAY,0,0,-3.3,71,9.4,1015,Cloudy
1/19/2024 7:00,22,221,18843,153333,243,172176,FRIDAY,0,0,-3.3,71,9.4,1015,Cloudy
1/19/2024 8:00,38,435,38523,392983,473,431506,FRIDAY,0,0,-3.9,72,7.6,1014.3,Cloudy
1/19/2024 9:00,45,326,50473,194267,371,244740,FRIDAY,0,0,-3.9,72,11.2,1014.2,Cloudy
1/19/2024 10:00,27,232,33656,130054,259,163710,FRIDAY,0,0,-3.9,72,11.2,1014.2,Cloudy
1/19/2024 11:00,40,199,38473,128870,239,167343,FRIDAY,0,0,-4.4,74,5.4,1013.5,Cloudy
1/19/2024 12:00,32,260,34467,158718,292,193185,FRIDAY,0,0,-4.4,74,11.2,1013,Cloudy
1/19/2024 13:00,36,260,44897,246182,296,291079,FRIDAY,0,0,-3.9,72,11.2,1012.8,Cloudy
1/19/2024 14:00,45,248,62024,193579,293,255603,FRIDAY,0,0,-3.9,74,16.6,1011.8,Cloudy
1/19/2024 15:00,34,300,28181,216438,334,244619,FRIDAY,0,0,-2.8,63,14.8,1011.4,Cloudy
1/19/2024 16:00,65,356,49925,253739,421,303664,FRIDAY,0,0,-2.8,63,14.8,1011.4,Cloudy
1/19/2024 17:00,66,483,58685,512737,549,571422,FRIDAY,0,0,-1.7,51,18.4,1008.5,Cloudy
1/19/2024 18:00,66,398,51245,261236,464,312481,FRIDAY,0,0,-2.2,51,11.2,1007.5,Cloudy
1/19/2024 19:00,44,238,119076,266312,282,385388,FRIDAY,0,0,-2.2,48,18.4,1006.8,Cloudy
1/19/2024 20:00,32,163,31447,109115,195,140562,FRIDAY,0,0,-2.8,50,14.8,1006.6,Cloudy
1/19/2024 21:00,20,127,15812,76069,147,91881,FRIDAY,0,0,-2.8,50,14.8,1006.6,Cloudy
1/19/2024 22:00,23,102,21411,56664,125,78075,FRIDAY,0,0,-3.3,52,20.5,1006.4,Cloudy
1/19/2024 23:00,25,77,29347,41989,102,71336,FRIDAY,0,0,-3.9,50,20.5,1006.6,Cloudy
1/20/2024 0:00,11,49,6640,35530,60,42170,SATURDAY,1,0,-4.4,50,22.3,1006.7,Cloudy
1/20/2024 1:00,26,29,65126,17511,55,82637,SATURDAY,1,0,-5.6,55,22.3,1007.1,Cloudy
1/20/2024 2:00,12,32,32989,20400,44,53389,SATURDAY,1,0,-5.6,55,24.1,1007.1,Cloudy
1/20/2024 3:00,2,3,756,1704,5,2460,SATURDAY,1,0,-6.7,43,22.3,1006.9,Cloudy
1/20/2024 4:00,0,3,0,1863,3,1863,SATURDAY,1,0,-6.7,47,20.5,1006.7,Cloudy
1/20/2024 5:00,2,6,2892,9445,8,12337,SATURDAY,1,0,-7.8,47,18.4,1006.8,Cloudy
1/20/2024 6:00,7,23,3592,11409,30,15001,SATURDAY,1,0,-8.9,49,18.4,1007.3,Cloudy
1/20/2024 7:00,11,32,4471,17249,43,21720,SATURDAY,1,0,-8.9,49,27.7,1007.3,Cloudy
1/20/2024 8:00,9,82,6081,145678,91,151759,SATURDAY,1,0,-9.4,51,24.1,1007.7,Cloudy
1/20/2024 9:00,11,122,9747,85287,133,95034,SATURDAY,1,0,-9.4,51,20.5,1008.2,Cloudy
1/20/2024 10:00,19,172,24985,99601,191,124586,SATURDAY,1,0,-10,53,20.5,1008.7,Cloudy
1/20/2024 11:00,39,212,60834,284717,251,345551,SATURDAY,1,0,-10,53,29.5,1008.7,Cloudy
1/20/2024 12:00,33,207,27786,217801,240,245587,SATURDAY,1,0,-10,56,27.7,1009.7,Cloudy
1/20/2024 13:00,41,227,39660,237898,268,277558,SATURDAY,1,0,-9.4,55,24.1,1009.9,Cloudy
1/20/2024 14:00,45,239,48986,286811,284,335797,SATURDAY,1,0,-9.4,55,27.7,1009.9,Cloudy
1/20/2024 15:00,44,216,37946,205298,260,243244,SATURDAY,1,0,-8.9,56,22.3,1009.5,Cloudy
1/20/2024 16:00,41,187,163414,118774,228,282188,SATURDAY,1,0,-8.9,56,22.3,1009.5,Cloudy
1/20/2024 17:00,17,132,18679,163717,149,182396,SATURDAY,1,0,-7.8,54,22.3,1008.6,Cloudy
1/20/2024 18:00,31,123,132577,149929,154,282506,SATURDAY,1,0,-7.2,51,22.3,1008.8,Cloudy
1/20/2024 19:00,17,108,75190,76949,125,152139,SATURDAY,1,0,-7.2,51,22.3,1008.8,Cloudy
1/20/2024 20:00,13,73,12080,51203,86,63283,SATURDAY,1,0,-6.7,52,18.4,1009.3,Cloudy
1/20/2024 21:00,6,59,2397,38866,65,41263,SATURDAY,1,0,-8.3,80,27.7,1009.9,Cloudy
1/20/2024 22:00,8,49,19795,32477,57,52272,SATURDAY,1,0,-8.9,84,20.5,1011.6,Cloudy
1/20/2024 23:00,7,44,4946,104692,51,109638,SATURDAY,1,0,-8.9,84,20.5,1011.6,Cloudy
1/21/2024 0:00,10,35,59837,29051,45,88888,SUNDAY,1,0,-8.9,80,22.3,1012.1,Cloudy
1/21/2024 1:00,13,23,10961,48721,36,59682,SUNDAY,1,0,-8.9,70,24.1,1012.4,Cloudy
1/21/2024 2:00,5,15,5288,39111,20,44399,SUNDAY,1,0,-9.4,70,27.7,1013,Cloudy
1/21/2024 3:00,0,4,0,1492,4,1492,SUNDAY,1,0,-10,70,25.9,1014.2,Snow
1/21/2024 4:00,1,2,2600,977,3,3577,SUNDAY,1,0,-9.4,61,25.9,1014.5,Cloudy
1/21/2024 5:00,4,12,5736,8009,16,13745,SUNDAY,1,0,-9.4,64,25.9,1015.1,Cloudy
1/21/2024 6:00,1,13,854,7026,14,7880,SUNDAY,1,0,-9.4,64,25.9,1015.1,Cloudy
1/21/2024 7:00,3,24,1706,18664,27,20370,SUNDAY,1,0,-8.9,61,24.1,1016.7,Cloudy
1/21/2024 8:00,8,56,9113,121289,64,130402,SUNDAY,1,0,-9.4,61,29.5,1017,Cloudy
1/21/2024 9:00,23,80,17516,63296,103,80812,SUNDAY,1,0,-9.4,61,25.9,1017.8,Cloudy
1/21/2024 10:00,29,143,30307,84684,172,114991,SUNDAY,1,0,-9.4,61,25.9,1018.7,Fair
1/21/2024 11:00,33,175,36503,119506,208,156009,SUNDAY,1,0,-9.4,61,35.3,1018.7,Fair
1/21/2024 12:00,38,200,32674,139943,238,172617,SUNDAY,1,0,-9.4,58,24.1,1021,Fair
1/21/2024 13:00,40,224,53223,149463,264,202686,SUNDAY,1,0,-8.9,56,25.9,1021.8,Fair
1/21/2024 14:00,52,260,50047,327456,312,377503,SUNDAY,1,0,-7.8,54,25.9,1022.2,Fair
1/21/2024 15:00,53,209,60759,125442,262,186201,SUNDAY,1,0,-7.2,51,25.9,1022.3,Fair
1/21/2024 16:00,42,255,46635,197799,297,244434,SUNDAY,1,0,-7.2,51,25.9,1022.3,Fair
1/21/2024 17:00,29,249,28375,245861,278,274236,SUNDAY,1,0,-5,45,27.7,1021.3,Fair
1/21/2024 18:00,24,187,19187,117358,211,136545,SUNDAY,1,0,-3.3,40,20.5,1021.4,Fair
1/21/2024 19:00,17,137,12440,76800,154,89240,SUNDAY,1,0,-2.8,41,24.1,1021.9,Fair
1/21/2024 20:00,13,132,9241,83360,145,92601,SUNDAY,1,0,-2.2,37,29.5,1022.9,Fair
1/21/2024 21:00,17,81,10476,47865,98,58341,SUNDAY,1,0,-2.2,37,29.5,1022.9,Fair
1/21/2024 22:00,8,73,5663,32462,81,38125,SUNDAY,1,0,-3.3,38,29.5,1024.9,Cloudy
1/21/2024 23:00,1,44,545,26932,45,27477,SUNDAY,1,0,-3.9,40,25.9,1026.2,Fair
1/22/2024 0:00,1,23,263,15650,24,15913,MONDAY,0,0,-5,42,24.1,1026.7,Clear
1/22/2024 1:00,0,5,0,1594,5,1594,MONDAY,0,0,-5,42,24.1,1026.7,Clear
1/22/2024 2:00,2,5,1419,3475,7,4894,MONDAY,0,0,-5.6,45,20.5,1028,Clear
1/22/2024 3:00,0,1,0,730,1,730,MONDAY,0,0,-6.1,49,20.5,1028.5,Clear
1/22/2024 4:00,1,6,241,4464,7,4705,MONDAY,0,0,-6.1,49,20.5,1029,Clear
1/22/2024 5:00,4,31,1505,16342,35,17847,MONDAY,0,0,-6.1,49,14.8,1029.5,Clear
1/22/2024 6:00,8,103,9700,71369,111,81069,MONDAY,0,0,-6.1,49,14.8,1029.5,Clear
1/22/2024 7:00,18,266,14183,265758,284,279941,MONDAY,0,0,-6.7,52,14.8,1030.5,Clear
1/22/2024 8:00,33,586,113171,464194,619,577365,MONDAY,0,0,-6.7,52,9.4,1030.2,Clear
1/22/2024 9:00,42,347,33071,331426,389,364497,MONDAY,0,0,-7.2,54,16.6,1030.6,Clear
1/22/2024 10:00,25,202,33786,135026,227,168812,MONDAY,0,0,-6.1,45,14.8,1030.9,Clear
1/22/2024 11:00,28,218,23132,161654,246,184786,MONDAY,0,0,-6.1,45,14.8,1030.9,Fair
1/22/2024 12:00,34,236,34635,143772,270,178407,MONDAY,0,0,-5.6,50,13,1031.9,Fair
1/22/2024 13:00,28,247,25156,154422,275,179578,MONDAY,0,0,-3.9,50,11.2,1031.9,Fair
1/22/2024 14:00,39,253,43651,172043,292,215694,MONDAY,0,0,-2.2,51,13,1031.9,Fair
1/22/2024 15:00,58,286,67768,193575,344,261343,MONDAY,0,0,-1.7,43,11.2,1031.1,Fair
1/22/2024 16:00,77,528,76317,382718,605,459035,MONDAY,0,0,-1.7,43,11.2,1031.1,Fair
1/22/2024 17:00,81,551,80731,389118,632,469849,MONDAY,0,0,1.7,44,18.4,1028.9,Cloudy
1/22/2024 18:00,61,536,116285,510831,597,627116,MONDAY,0,0,2.8,44,18.4,1028.4,Cloudy
1/22/2024 19:00,46,322,192956,218706,368,411662,MONDAY,0,0,3.3,42,20.5,1028.3,Cloudy
1/22/2024 20:00,24,248,23162,152908,272,176070,MONDAY,0,0,3.3,42,20.5,1028.3,Cloudy
1/22/2024 21:00,34,163,29010,151427,197,180437,MONDAY,0,0,2.8,44,18.4,1028.4,Cloudy
1/22/2024 22:00,14,97,14254,57765,111,72019,MONDAY,0,0,2.2,46,20.5,1028.5,Cloudy
1/22/2024 23:00,6,55,3499,34701,61,38200,MONDAY,0,0,2.2,46,20.5,1027.7,Cloudy
1/23/2024 0:00,3,15,2102,6338,18,8440,TUESDAY,0,0,1.7,49,20.5,1027.1,Cloudy
1/23/2024 1:00,5,15,3600,10558,20,14158,TUESDAY,0,0,1.7,49,24.1,1027.1,Cloudy
1/23/2024 2:00,2,3,1186,890,5,2076,TUESDAY,0,0,1.7,52,20.5,1026.2,Cloudy
1/23/2024 3:00,0,5,0,4286,5,4286,TUESDAY,0,0,1.7,49,27.7,1025.6,Cloudy
1/23/2024 4:00,3,7,8863,3512,10,12375,TUESDAY,0,0,2.2,48,31.7,1025.6,Cloudy
1/23/2024 5:00,4,45,2107,28446,49,30553,TUESDAY,0,0,2.2,48,27.7,1025.4,Cloudy
1/23/2024 6:00,17,179,13066,118730,196,131796,TUESDAY,0,0,2.2,48,27.7,1025.4,Cloudy
1/23/2024 7:00,33,432,28342,318907,465,347249,TUESDAY,0,0,2.2,46,18.4,1025.5,Cloudy
1/23/2024 8:00,85,828,85276,619501,913,704777,TUESDAY,0,0,2.2,46,16.6,1026.1,Cloudy
1/23/2024 9:00,57,470,131681,418541,527,550222,TUESDAY,0,0,1.1,52,11.2,1026.7,Cloudy
1/23/2024 10:00,43,237,66121,159321,280,225442,TUESDAY,0,0,2.2,44,18.4,1026.7,Cloudy
1/23/2024 11:00,41,245,46470,156829,286,203299,TUESDAY,0,0,2.2,44,18.4,1026.7,Cloudy
1/23/2024 12:00,48,246,46375,172017,294,218392,TUESDAY,0,0,2.8,50,16.6,1028.5,Cloudy
1/23/2024 13:00,37,243,27871,163108,280,190979,TUESDAY,0,0,3.3,55,16.6,1029.2,Cloudy
1/23/2024 14:00,37,250,45770,185932,287,231702,TUESDAY,0,0,3.9,57,14.8,1029.9,Cloudy
1/23/2024 15:00,63,390,57014,257495,453,314509,TUESDAY,0,0,3.9,57,14.8,1029.9,Cloudy
1/23/2024 16:00,86,638,79511,510194,724,589705,TUESDAY,0,0,3.9,62,18.4,1030.6,Cloudy
1/23/2024 17:00,126,868,123032,625071,994,748103,TUESDAY,0,0,4.4,62,16.6,1030.7,Cloudy
1/23/2024 18:00,81,606,137465,402805,687,540270,TUESDAY,0,0,3.9,62,11.2,1031,Cloudy
1/23/2024 19:00,63,429,57226,290255,492,347481,TUESDAY,0,0,3.9,62,14.8,1031.4,Cloudy
1/23/2024 20:00,56,306,52317,204430,362,256747,TUESDAY,0,0,3.9,62,14.8,1031.4,Cloudy
1/23/2024 21:00,42,214,528715,125400,256,654115,TUESDAY,0,0,3.9,62,11.2,1032.9,Cloudy
1/23/2024 22:00,27,120,19944,86707,147,106651,TUESDAY,0,0,3.9,62,11.2,1032.9,Snow
1/23/2024 23:00,15,41,96124,24818,56,120942,TUESDAY,0,0,2.8,67,9.4,1034.2,Rain
1/24/2024 0:00,0,16,0,8866,16,8866,WEDNESDAY,0,0,2.2,70,7.6,1034.5,Rain
1/24/2024 1:00,0,12,0,8695,12,8695,WEDNESDAY,0,0,2.2,70,7.6,1034.5,Snow
1/24/2024 2:00,3,3,3452,2313,6,5765,WEDNESDAY,0,0,1.7,78,0,1035.7,Snow
1/24/2024 3:00,0,4,0,1579,4,1579,WEDNESDAY,0,0,1.1,88,5.4,1035.9,Snow
1/24/2024 4:00,4,8,7841,3808,12,11649,WEDNESDAY,0,0,0,100,13,1036,Snow
1/24/2024 5:00,5,41,6648,36524,46,43172,WEDNESDAY,0,0,0,100,13,1036,Cloudy
1/24/2024 6:00,8,137,8554,85548,145,94102,WEDNESDAY,0,0,0,100,9.4,1035.9,Snow
1/24/2024 7:00,27,333,26963,239082,360,266045,WEDNESDAY,0,0,0,100,9.4,1036.3,Snow
1/24/2024 8:00,77,700,93750,519126,777,612876,WEDNESDAY,0,0,0,100,5.4,1035.9,Snow
1/24/2024 9:00,47,447,36189,282310,494,318499,WEDNESDAY,0,0,0,100,7.6,1035.9,Snow
1/24/2024 10:00,27,244,24061,153460,271,177521,WEDNESDAY,0,0,0.6,100,0,1035.9,Snow
1/24/2024 11:00,34,228,34322,140423,262,174745,WEDNESDAY,0,0,1.1,100,11.2,1035.4,Snow
1/24/2024 12:00,34,253,28502,149142,287,177644,WEDNESDAY,0,0,1.1,100,13,1035.4,Cloudy
1/24/2024 13:00,30,239,33809,173491,269,207300,WEDNESDAY,0,0,1.1,100,9.4,1035.4,Cloudy
1/24/2024 14:00,53,241,44804,248793,294,293597,WEDNESDAY,0,0,1.1,100,9.4,1035.4,Cloudy
1/24/2024 15:00,45,299,38512,356355,344,394867,WEDNESDAY,0,0,1.1,100,11.2,1035.6,Snow
1/24/2024 16:00,66,516,67498,431783,582,499281,WEDNESDAY,0,0,1.7,100,9.4,1033.9,Snow
1/24/2024 17:00,97,678,105026,516559,775,621585,WEDNESDAY,0,0,1.7,100,7.6,1032.9,Cloudy
1/24/2024 18:00,49,411,94037,357624,460,451661,WEDNESDAY,0,0,2.2,100,7.6,1032.4,Rain
1/24/2024 19:00,32,256,23192,161519,288,184711,WEDNESDAY,0,0,2.2,100,7.6,1032.4,Rain
1/24/2024 20:00,25,190,64994,187129,215,252123,WEDNESDAY,0,0,2.8,100,7.6,1031.6,Cloudy
1/24/2024 21:00,13,120,11097,75154,133,86251,WEDNESDAY,0,0,2.8,100,7.6,1030.7,Cloudy
1/24/2024 22:00,19,80,104471,64076,99,168547,WEDNESDAY,0,0,2.8,100,11.2,1029.8,Cloudy
1/24/2024 23:00,4,30,1363,25291,34,26654,WEDNESDAY,0,0,3.3,100,11.2,1029.1,Rain
1/25/2024 0:00,1,29,772,20619,30,21391,THURSDAY,0,0,3.3,100,9.4,1028,Rain
1/25/2024 1:00,3,12,2480,5812,15,8292,THURSDAY,0,0,3.3,100,9.4,1028,Rain
1/25/2024 2:00,3,4,1338,2255,7,3593,THURSDAY,0,0,3.3,100,9.4,1025.9,Rain
1/25/2024 3:00,1,2,1972,1230,3,3202,THURSDAY,0,0,3.3,100,9.4,1025.9,Rain
1/25/2024 4:00,3,5,1278,2623,8,3901,THURSDAY,0,0,3.9,100,0,1024.6,Rain
1/25/2024 5:00,4,40,3174,30031,44,33205,THURSDAY,0,0,3.9,100,9.4,1021.2,Rain
1/25/2024 6:00,14,136,9888,88368,150,98256,THURSDAY,0,0,3.9,100,7.6,1021.2,Rain
1/25/2024 7:00,41,340,35551,319013,381,354564,THURSDAY,0,0,7.8,100,18.4,1018.5,Rain
1/25/2024 8:00,81,795,64690,738547,876,803237,THURSDAY,0,0,8.3,100,22.3,1017.4,Rain
1/25/2024 9:00,65,557,83437,452031,622,535468,THURSDAY,0,0,8.9,100,22.3,1016.2,Rain
1/25/2024 10:00,56,300,71927,313710,356,385637,THURSDAY,0,0,8.9,100,22.3,1016.2,Rain
1/25/2024 11:00,58,293,58717,200408,351,259125,THURSDAY,0,0,10,100,11.2,1017.5,Rain
1/25/2024 12:00,70,333,163413,238150,403,401563,THURSDAY,0,0,10.6,96,14.8,1017.8,Rain
1/25/2024 13:00,111,329,321990,225504,440,547494,THURSDAY,0,0,10.6,96,9.4,1018.6,Rain
1/25/2024 14:00,89,370,177700,249163,459,426863,THURSDAY,0,0,8.3,100,11.2,1019.6,Cloudy
1/25/2024 15:00,129,453,120645,301287,582,421932,THURSDAY,0,0,8.3,100,11.2,1019.6,Cloudy
1/25/2024 16:00,157,662,167940,483586,819,651526,THURSDAY,0,0,9.4,93,11.2,1019.9,Cloudy
1/25/2024 17:00,179,924,296543,790116,1103,1086659,THURSDAY,0,0,10,86,13,1019.7,Cloudy
1/25/2024 18:00,133,693,281517,661528,826,943045,THURSDAY,0,0,6.1,100,16.6,1020.3,Cloudy
1/25/2024 19:00,95,494,83004,336679,589,419683,THURSDAY,0,0,6.1,97,16.6,1021,Cloudy
1/25/2024 20:00,72,358,71128,238187,430,309315,THURSDAY,0,0,6.1,97,16.6,1021,Cloudy
1/25/2024 21:00,62,247,228768,179813,309,408581,THURSDAY,0,0,4.4,100,9.4,1022.7,Cloudy
1/25/2024 22:00,50,162,56154,110416,212,166570,THURSDAY,0,0,4.4,97,9.4,1023.4,Cloudy
1/25/2024 23:00,33,91,24953,65194,124,90147,THURSDAY,0,0,4.4,93,9.4,1024.5,Cloudy
1/26/2024 0:00,18,48,15514,27633,66,43147,FRIDAY,0,0,4.4,93,9.4,1024.5,Cloudy
1/26/2024 1:00,14,25,8757,113274,39,122031,FRIDAY,0,0,4.4,93,14.8,1025.4,Cloudy
1/26/2024 2:00,8,17,18925,12715,25,31640,FRIDAY,0,0,4.4,97,14.8,1025.9,Cloudy
1/26/2024 3:00,0,9,0,5036,9,5036,FRIDAY,0,0,4.4,100,13,1026.5,Cloudy
1/26/2024 4:00,1,7,358,9056,8,9414,FRIDAY,0,0,4.4,100,13,1026.2,Cloudy
1/26/2024 5:00,1,12,346,5870,13,6216,FRIDAY,0,0,4.4,100,13,1026.2,Rain
1/26/2024 6:00,2,52,611,50024,54,50635,FRIDAY,0,0,3.9,96,24.1,1025.3,Rain
1/26/2024 7:00,10,86,9558,54266,96,63824,FRIDAY,0,0,3.9,93,20.5,1024.8,Rain
1/26/2024 8:00,16,226,10667,150634,242,161301,FRIDAY,0,0,3.9,93,20.5,1023.8,Rain
1/26/2024 9:00,33,189,106466,145866,222,252332,FRIDAY,0,0,3.3,97,22.3,1022.9,Rain
1/26/2024 10:00,16,166,10585,112788,182,123373,FRIDAY,0,0,3.3,97,22.3,1022.9,Rain
1/26/2024 11:00,23,181,16081,118845,204,134926,FRIDAY,0,0,3.3,100,20.5,1022.7,Rain
1/26/2024 12:00,47,255,49794,165901,302,215695,FRIDAY,0,0,3.3,100,16.6,1022.5,Rain
1/26/2024 13:00,44,248,35986,158108,292,194094,FRIDAY,0,0,3.9,100,14.8,1021.8,Rain
1/26/2024 14:00,65,308,90540,274467,373,365007,FRIDAY,0,0,3.9,100,14.8,1021.8,Rain
1/26/2024 15:00,72,377,136216,512617,449,648833,FRIDAY,0,0,3.9,100,18.4,1021.9,Cloudy
1/26/2024 16:00,88,400,86321,469540,488,555861,FRIDAY,0,0,4.4,100,16.6,1018.7,Rain
1/26/2024 17:00,134,569,146565,715530,703,862095,FRIDAY,0,0,4.4,100,16.6,1016.8,Cloudy
1/26/2024 18:00,108,465,141978,397573,573,539551,FRIDAY,0,0,4.4,100,16.6,1016.8,Cloudy
1/26/2024 19:00,80,332,79865,226144,412,306009,FRIDAY,0,0,5,100,11.2,1016.5,Rain
1/26/2024 20:00,88,261,77996,271197,349,349193,FRIDAY,0,0,5,100,9.4,1015.9,Cloudy
1/26/2024 21:00,58,220,114087,244977,278,359064,FRIDAY,0,0,4.4,100,14.8,1016.1,Cloudy
1/26/2024 22:00,52,148,58999,104738,200,163737,FRIDAY,0,0,4.4,100,14.8,1016.1,Cloudy
1/26/2024 23:00,65,107,76101,66851,172,142952,FRIDAY,0,0,4.4,100,14.8,1017.6,Cloudy
1/27/2024 0:00,47,82,55213,58494,129,113707,SATURDAY,1,0,4.4,100,14.8,1017.6,Cloudy
1/27/2024 1:00,50,68,47931,50545,118,98476,SATURDAY,1,0,4.4,100,9.4,1018.8,Cloudy
1/27/2024 2:00,32,43,42072,29319,75,71391,SATURDAY,1,0,4.4,100,9.4,1018.8,Cloudy
1/27/2024 3:00,6,14,7598,17943,20,25541,SATURDAY,1,0,3.9,100,16.6,1019.1,Cloudy
1/27/2024 4:00,6,5,12493,2142,11,14635,SATURDAY,1,0,2.8,100,14.8,1019.6,Cloudy
1/27/2024 5:00,4,15,4909,12367,19,17276,SATURDAY,1,0,2.8,100,13,1019.7,Cloudy
1/27/2024 6:00,10,35,9709,23798,45,33507,SATURDAY,1,0,2.8,100,13,1019.7,Cloudy
1/27/2024 7:00,14,56,53116,37746,70,90862,SATURDAY,1,0,2.2,100,13,1020,Cloudy
1/27/2024 8:00,28,135,19158,87822,163,106980,SATURDAY,1,0,2.2,100,14.8,1020.6,Rain
1/27/2024 9:00,56,199,114817,239295,255,354112,SATURDAY,1,0,2.2,100,14.8,1020.6,Rain
1/27/2024 10:00,80,302,319905,212461,382,532366,SATURDAY,1,0,1.7,100,11.2,1020.9,Cloudy
1/27/2024 11:00,103,379,236140,284851,482,520991,SATURDAY,1,0,1.7,100,16.6,1022.2,Cloudy
1/27/2024 12:00,129,432,172218,332735,561,504953,SATURDAY,1,0,1.7,100,14.8,1023.1,Snow
1/27/2024 13:00,189,460,381076,333373,649,714449,SATURDAY,1,0,1.7,100,16.6,1023.8,Cloudy
1/27/2024 14:00,193,422,227299,328656,615,555955,SATURDAY,1,0,1.7,100,16.6,1023.8,Cloudy
1/27/2024 15:00,200,467,289899,344995,667,634894,SATURDAY,1,0,2.8,93,11.2,1023.8,Cloudy
1/27/2024 16:00,162,452,194487,330166,614,524653,SATURDAY,1,0,2.8,93,9.4,1023.6,Cloudy
1/27/2024 17:00,113,468,221265,440924,581,662189,SATURDAY,1,0,2.8,93,9.4,1023.6,Cloudy
1/27/2024 18:00,98,374,106861,283058,472,389919,SATURDAY,1,0,3.3,86,11.2,1023,Cloudy
1/27/2024 19:00,86,254,703480,188936,340,892416,SATURDAY,1,0,3.3,86,11.2,1023,Cloudy
1/27/2024 20:00,61,209,132135,144715,270,276850,SATURDAY,1,0,2.8,93,11.2,1022.7,Cloudy
1/27/2024 21:00,77,194,205074,213685,271,418759,SATURDAY,1,0,2.8,93,11.2,1023,Cloudy
1/27/2024 22:00,92,155,112170,111519,247,223689,SATURDAY,1,0,2.8,89,11.2,1023.6,Cloudy
1/27/2024 23:00,48,111,44404,75750,159,120154,SATURDAY,1,0,2.8,89,11.2,1023.6,Cloudy
1/28/2024 0:00,46,72,54708,80789,118,135497,SUNDAY,1,0,2.8,93,11.2,1023.5,Cloudy
1/28/2024 1:00,69,75,117145,58960,144,176105,SUNDAY,1,0,2.8,93,9.4,1023.8,Cloudy
1/28/2024 2:00,44,49,51016,38935,93,89951,SUNDAY,1,0,2.8,93,7.6,1023,Cloudy
1/28/2024 3:00,8,6,9072,4283,14,13355,SUNDAY,1,0,2.2,97,7.6,1022.6,Cloudy
1/28/2024 4:00,5,9,1929,3784,14,5713,SUNDAY,1,0,2.2,97,11.2,1022.4,Cloudy
1/28/2024 5:00,7,18,364200,16293,25,380493,SUNDAY,1,0,2.2,97,11.2,1022.4,Cloudy
1/28/2024 6:00,9,18,7871,10455,27,18326,SUNDAY,1,0,2.8,89,11.2,1021.2,Cloudy
1/28/2024 7:00,12,42,11069,27951,54,39020,SUNDAY,1,0,2.2,92,11.2,1020.7,Cloudy
1/28/2024 8:00,30,108,39917,62789,138,102706,SUNDAY,1,0,2.2,92,7.6,1020.1,Cloudy
1/28/2024 9:00,25,163,26856,80392,188,107248,SUNDAY,1,0,2.2,92,7.6,1020.1,Cloudy
1/28/2024 10:00,31,119,52020,75917,150,127937,SUNDAY,1,0,2.2,92,9.4,1019,Cloudy
1/28/2024 11:00,29,108,67562,86332,137,153894,SUNDAY,1,0,2.2,92,7.6,1018.2,Rain
1/28/2024 12:00,26,139,21671,96084,165,117755,SUNDAY,1,0,2.2,97,9.4,1017.2,Rain
1/28/2024 13:00,31,181,40032,196286,212,236318,SUNDAY,1,0,2.8,96,9.4,1017.3,Rain
1/28/2024 14:00,30,192,48547,121334,222,169881,SUNDAY,1,0,2.8,96,9.4,1017.3,Rain
1/28/2024 15:00,34,176,42996,117352,210,160348,SUNDAY,1,0,1.7,100,13,1015.9,Rain
1/28/2024 16:00,20,146,12010,110513,166,122523,SUNDAY,1,0,1.7,100,16.6,1014.5,Rain
1/28/2024 17:00,17,106,15209,81760,123,96969,SUNDAY,1,0,2.8,100,24.1,1012.9,Rain
1/28/2024 18:00,20,158,11041,107783,178,118824,SUNDAY,1,0,2.8,100,24.1,1012.9,Rain
1/28/2024 19:00,13,98,8642,52436,111,61078,SUNDAY,1,0,2.8,100,22.3,1011.1,Rain
1/28/2024 20:00,10,64,8985,36896,74,45881,SUNDAY,1,0,2.8,100,27.7,1008.9,Rain
1/28/2024 21:00,5,49,2411,22426,54,24837,SUNDAY,1,0,2.8,100,27.7,1008,Rain
1/28/2024 22:00,5,47,3486,22400,52,25886,SUNDAY,1,0,2.8,100,33.5,1008,Rain
1/28/2024 23:00,3,19,1807,10762,22,12569,SUNDAY,1,0,2.8,100,33.5,1007,Rain
1/29/2024 0:00,5,17,6788,9744,22,16532,MONDAY,0,0,1.7,100,24.1,1006.5,Snow
1/29/2024 1:00,1,2,402,1383,3,1785,MONDAY,0,0,1.1,100,24.1,1005.3,Snow
1/29/2024 2:00,1,4,644,1985,5,2629,MONDAY,0,0,1.1,100,27.7,1004.6,Snow
1/29/2024 3:00,2,6,1298,2100,8,3398,MONDAY,0,0,1.1,100,27.7,1003.9,Snow
1/29/2024 4:00,3,7,2204,4661,10,6865,MONDAY,0,0,1.1,100,27.7,1003.9,Snow
1/29/2024 5:00,5,25,6145,14945,30,21090,MONDAY,0,0,1.1,100,25.9,1003.4,Snow
1/29/2024 6:00,6,101,4512,57344,107,61856,MONDAY,0,0,0.6,100,24.1,1003.5,Snow
1/29/2024 7:00,23,266,103902,383552,289,487454,MONDAY,0,0,0.6,100,16.6,1003.6,Snow
1/29/2024 8:00,48,625,38930,604407,673,643337,MONDAY,0,0,1.1,100,18.4,1003.7,Snow
1/29/2024 9:00,43,363,38100,440975,406,479075,MONDAY,0,0,1.1,100,18.4,1003.7,Snow
1/29/2024 10:00,29,243,40861,429462,272,470323,MONDAY,0,0,0.6,100,27.7,1004.2,Snow
1/29/2024 11:00,35,225,38622,148895,260,187517,MONDAY,0,0,0.6,100,27.7,1004.2,Snow
1/29/2024 12:00,38,248,41379,230371,286,271750,MONDAY,0,0,0.6,96,31.7,1004.8,Snow
1/29/2024 13:00,35,285,28694,178426,320,207120,MONDAY,0,0,0.6,92,22.3,1006.7,Snow
1/29/2024 14:00,49,296,36992,189778,345,226770,MONDAY,0,0,0.6,92,22.3,1006.7,Snow
1/29/2024 15:00,62,336,60850,232992,398,293842,MONDAY,0,0,1.7,85,31.7,1008.2,Snow
1/29/2024 16:00,74,550,68834,364356,624,433190,MONDAY,0,0,2.2,79,31.7,1008.5,Cloudy
1/29/2024 17:00,69,740,60576,508072,809,568648,MONDAY,0,0,2.2,79,40.7,1009,Cloudy
1/29/2024 18:00,68,561,50112,388612,629,438724,MONDAY,0,0,2.2,79,33.5,1009,Snow
1/29/2024 19:00,62,340,57595,251204,402,308799,MONDAY,0,0,2.2,70,31.7,1010.6,Cloudy
1/29/2024 20:00,28,248,35553,143207,276,178760,MONDAY,0,0,1.7,72,22.3,1011.7,Cloudy
1/29/2024 21:00,22,194,15714,167330,216,183044,MONDAY,0,0,1.7,75,24.1,1012.9,Cloudy
1/29/2024 22:00,39,110,34927,65592,149,100519,MONDAY,0,0,1.7,75,24.1,1014,Cloudy
1/29/2024 23:00,12,49,7955,26703,61,34658,MONDAY,0,0,1.7,75,24.1,1014,Cloudy
1/30/2024 0:00,9,27,79536,13929,36,93465,TUESDAY,0,0,1.1,79,24.1,1016.1,Cloudy
1/30/2024 1:00,3,13,9001,9615,16,18616,TUESDAY,0,0,1.1,82,20.5,1016.9,Cloudy
1/30/2024 2:00,1,9,419,7841,10,8260,TUESDAY,0,0,1.1,82,27.7,1017.8,Cloudy
1/30/2024 3:00,1,7,462,2297,8,2759,TUESDAY,0,0,0.6,85,16.6,1018.4,Cloudy
1/30/2024 4:00,1,7,265,5484,8,5749,TUESDAY,0,0,0.6,85,16.6,1018.4,Cloudy
1/30/2024 5:00,6,33,8081,21021,39,29102,TUESDAY,0,0,0,92,16.6,1019.3,Cloudy
1/30/2024 6:00,13,172,9426,110944,185,120370,TUESDAY,0,0,0,85,16.6,1019.9,Cloudy
1/30/2024 7:00,30,383,23285,297486,413,320771,TUESDAY,0,0,0,79,14.8,1020.5,Cloudy
1/30/2024 8:00,61,842,47809,735318,903,783127,TUESDAY,0,0,-0.6,92,18.4,1021.1,Cloudy
1/30/2024 9:00,39,464,40580,328571,503,369151,TUESDAY,0,0,-0.6,92,18.4,1021.1,Cloudy
1/30/2024 10:00,38,261,29746,155740,299,185486,TUESDAY,0,0,-1.1,88,20.5,1022.3,Cloudy
1/30/2024 11:00,34,236,47032,144022,270,191054,TUESDAY,0,0,-1.1,88,20.5,1022.3,Cloudy
1/30/2024 12:00,38,261,119878,157441,299,277319,TUESDAY,0,0,-1.1,88,20.5,1023.9,Cloudy
1/30/2024 13:00,35,309,34102,197970,344,232072,TUESDAY,0,0,-1.7,89,20.5,1024.8,Cloudy
1/30/2024 14:00,45,248,51362,214195,293,265557,TUESDAY,0,0,-1.7,89,29.5,1024.8,Cloudy
1/30/2024 15:00,61,353,57842,312409,414,370251,TUESDAY,0,0,-2.2,75,31.7,1025.7,Cloudy
1/30/2024 16:00,74,601,57545,1030606,675,1088151,TUESDAY,0,0,-2.2,69,22.3,1025.4,Cloudy
1/30/2024 17:00,91,811,235450,1037671,902,1273121,TUESDAY,0,0,-2.2,69,18.4,1024.9,Cloudy
1/30/2024 18:00,58,580,51044,906592,638,957636,TUESDAY,0,0,-2.2,69,18.4,1024.9,Cloudy
1/30/2024 19:00,54,382,39884,487558,436,527442,TUESDAY,0,0,-2.8,75,16.6,1025.1,Cloudy
1/30/2024 20:00,46,278,31536,289176,324,320712,TUESDAY,0,0,-2.8,72,16.6,1025.1,Cloudy
1/30/2024 21:00,27,183,61407,170775,210,232182,TUESDAY,0,0,-2.8,72,16.6,1025.1,Cloudy
1/30/2024 22:00,17,129,20883,125672,146,146555,TUESDAY,0,0,-3.3,77,13,1025.1,Cloudy
1/30/2024 23:00,16,51,39048,28954,67,68002,TUESDAY,0,0,-3.3,77,13,1025.1,Cloudy
1/31/2024 0:00,5,24,5968,16395,29,22363,WEDNESDAY,0,0,-3.3,77,7.6,1024.8,Cloudy
1/31/2024 1:00,4,10,3078,5599,14,8677,WEDNESDAY,0,0,-2.8,75,9.4,1024.4,Cloudy
1/31/2024 2:00,2,11,1714,8294,13,10008,WEDNESDAY,0,0,-2.8,75,9.4,1024.2,Cloudy
1/31/2024 3:00,1,5,927,3299,6,4226,WEDNESDAY,0,0,-2.8,75,9.4,1024.2,Cloudy
1/31/2024 4:00,1,12,242,7539,13,7781,WEDNESDAY,0,0,-2.2,75,7.6,1023.8,Cloudy
1/31/2024 5:00,6,40,5322,26753,46,32075,WEDNESDAY,0,0,-2.2,75,5.4,1023.5,Cloudy
1/31/2024 6:00,11,150,8402,87601,161,96003,WEDNESDAY,0,0,-2.2,75,7.6,1023.5,Cloudy
1/31/2024 7:00,40,405,24760,408394,445,433154,WEDNESDAY,0,0,-2.2,75,5.4,1023.1,Cloudy
1/31/2024 8:00,65,811,97257,552897,876,650154,WEDNESDAY,0,0,-2.2,75,5.4,1023.1,Cloudy
1/31/2024 9:00,51,485,34188,307289,536,341477,WEDNESDAY,0,0,-2.2,75,9.4,1022.3,Cloudy
1/31/2024 10:00,42,294,44829,295066,336,339895,WEDNESDAY,0,0,-2.2,71,11.2,1022.4,Cloudy
1/31/2024 11:00,54,292,56792,287233,346,344025,WEDNESDAY,0,0,-2.2,71,11.2,1022.2,Cloudy
1/31/2024 12:00,35,311,51321,199637,346,250958,WEDNESDAY,0,0,-2.2,75,11.2,1021.9,Cloudy
1/31/2024 13:00,59,315,146354,193995,374,340349,WEDNESDAY,0,0,-2.2,75,11.2,1021.9,Cloudy
1/31/2024 14:00,59,286,45116,194721,345,239837,WEDNESDAY,0,0,-1.1,69,7.6,1021.4,Cloudy
1/31/2024 15:00,55,377,50632,310463,432,361095,WEDNESDAY,0,0,-0.6,69,7.6,1020.8,Cloudy
1/31/2024 16:00,81,623,132924,524023,704,656947,WEDNESDAY,0,0,-0.6,72,9.4,1020,Cloudy
1/31/2024 17:00,103,880,226649,639668,983,866317,WEDNESDAY,0,0,0,72,13,1019.8,Cloudy
1/31/2024 18:00,65,568,52015,526961,633,578976,WEDNESDAY,0,0,0,72,13,1019.8,Cloudy
1/31/2024 19:00,57,386,156456,312408,443,468864,WEDNESDAY,0,0,0.6,72,14.8,1019,Cloudy
1/31/2024 20:00,36,302,24012,189265,338,213277,WEDNESDAY,0,0,1.1,73,14.8,1018.9,Cloudy
1/31/2024 21:00,29,200,57849,250957,229,308806,WEDNESDAY,0,0,1.1,75,14.8,1018.6,Cloudy
1/31/2024 22:00,6,133,3809,91207,139,95016,WEDNESDAY,0,0,1.1,75,14.8,1018.7,Cloudy
1/31/2024 23:00,9,66,6731,40133,75,46864,WEDNESDAY,0,0,1.1,75,14.8,1018.7,Cloudy
2/1/2024 0:00,7,30,4342,23379,37,27721,THURSDAY,0,0,1.1,79,16.6,1018.4,Cloudy
2/1/2024 1:00,2,14,1081,8338,16,9419,THURSDAY,0,0,1.1,82,16.6,1018.1,Fair
2/1/2024 2:00,6,11,8241,5528,17,13769,THURSDAY,0,0,1.7,82,14.8,1017.9,Fair
2/1/2024 3:00,1,4,1792,2857,5,4649,THURSDAY,0,0,1.1,85,16.6,1017.7,Fair
2/1/2024 4:00,1,5,973,4010,6,4983,THURSDAY,0,0,1.1,85,16.6,1017.7,Clear
2/1/2024 5:00,4,43,3288,32715,47,36003,THURSDAY,0,0,1.1,85,14.8,1016.5,Fair
2/1/2024 6:00,12,154,7796,100023,166,107819,THURSDAY,0,0,1.1,85,14.8,1016.4,Fair
2/1/2024 7:00,45,393,37058,289891,438,326949,THURSDAY,0,0,1.1,88,13,1016.1,Fair
2/1/2024 8:00,75,821,49956,746216,896,796172,THURSDAY,0,0,1.1,88,13,1016.1,Fair
2/1/2024 9:00,62,518,66399,390636,580,457035,THURSDAY,0,0,1.1,88,11.2,1016.3,Fair
2/1/2024 10:00,40,307,71754,276212,347,347966,THURSDAY,0,0,1.1,88,11.2,1016.4,Cloudy
2/1/2024 11:00,52,316,67455,198216,368,265671,THURSDAY,0,0,1.7,85,13,1016.7,Cloudy
2/1/2024 12:00,53,335,45315,209931,388,255246,THURSDAY,0,0,1.7,89,14.8,1016.9,Cloudy
2/1/2024 13:00,50,322,132090,228824,372,360914,THURSDAY,0,0,1.7,89,14.8,1016.9,Cloudy
2/1/2024 14:00,67,322,53373,208104,389,261477,THURSDAY,0,0,2.8,85,20.5,1016.5,Cloudy
2/1/2024 15:00,84,394,79206,294680,478,373886,THURSDAY,0,0,4.4,76,18.4,1016,Cloudy
2/1/2024 16:00,96,656,102397,475003,752,577400,THURSDAY,0,0,3.9,82,16.6,1015.1,Cloudy
2/1/2024 17:00,119,884,135971,726900,1003,862871,THURSDAY,0,0,5.6,67,16.6,1015.1,Cloudy
2/1/2024 18:00,121,662,106222,457280,783,563502,THURSDAY,0,0,5,67,16.6,1014.3,Cloudy
2/1/2024 19:00,76,420,75514,268990,496,344504,THURSDAY,0,0,5.6,67,5.4,1013,Cloudy
2/1/2024 20:00,73,310,563506,205197,383,768703,THURSDAY,0,0,5.6,70,9.4,1012.6,Cloudy
2/1/2024 21:00,47,217,38824,151116,264,189940,THURSDAY,0,0,5,76,9.4,1011.9,Cloudy
2/1/2024 22:00,50,168,44747,106103,218,150850,THURSDAY,0,0,5,76,9.4,1011.9,Cloudy
2/1/2024 23:00,22,91,31540,134230,113,165770,THURSDAY,0,0,5.6,70,11.2,1012.3,Cloudy
2/2/2024 0:00,25,48,337676,65243,73,402919,FRIDAY,0,0,5.6,70,13,1012.4,Cloudy
2/2/2024 1:00,14,28,22056,18916,42,40972,FRIDAY,0,0,5,73,14.8,1012.4,Cloudy
2/2/2024 2:00,6,16,4742,10502,22,15244,FRIDAY,0,0,5,76,14.8,1012.2,Cloudy
2/2/2024 3:00,4,6,13276,4617,10,17893,FRIDAY,0,0,5,76,14.8,1012.2,Cloudy
2/2/2024 4:00,3,7,3285,5321,10,8606,FRIDAY,0,0,4.4,79,14.8,1011.8,Cloudy
2/2/2024 5:00,5,40,3923,25112,45,29035,FRIDAY,0,0,4.4,79,16.6,1011.2,Cloudy
2/2/2024 6:00,24,129,13120,79761,153,92881,FRIDAY,0,0,4.4,79,16.6,1011.2,Cloudy
2/2/2024 7:00,23,311,267304,395479,334,662783,FRIDAY,0,0,3.9,82,9.4,1010.4,Cloudy
2/2/2024 8:00,88,610,199857,501343,698,701200,FRIDAY,0,0,3.9,82,9.4,1010.4,Cloudy
2/2/2024 9:00,67,414,62053,368971,481,431024,FRIDAY,0,0,4.4,79,7.6,1010.2,Cloudy
2/2/2024 10:00,44,321,58587,193276,365,251863,FRIDAY,0,0,4.4,79,5.4,1010.3,Cloudy
2/2/2024 11:00,59,289,153123,180950,348,334073,FRIDAY,0,0,3.3,86,0,1010.4,Cloudy
2/2/2024 12:00,59,360,48488,287215,419,335703,FRIDAY,0,0,4.4,79,5.4,1011.1,Cloudy
2/2/2024 13:00,70,368,89102,231441,438,320543,FRIDAY,0,0,4.4,79,5.4,1011.1,Cloudy
2/2/2024 14:00,81,387,112674,240003,468,352677,FRIDAY,0,0,4.4,79,11.2,1011.5,Cloudy
2/2/2024 15:00,104,429,203354,282558,533,485912,FRIDAY,0,0,4.4,79,11.2,1011.6,Cloudy
2/2/2024 16:00,132,619,1068271,596662,751,1664933,FRIDAY,0,0,4.4,79,11.2,1011.1,Cloudy
2/2/2024 17:00,154,711,195364,691779,865,887143,FRIDAY,0,0,5,73,14.8,1010.8,Cloudy
2/2/2024 18:00,128,571,168944,390905,699,559849,FRIDAY,0,0,5,73,14.8,1010.8,Cloudy
2/2/2024 19:00,115,459,250563,371797,574,622360,FRIDAY,0,0,5,73,13,1011.1,Cloudy
2/2/2024 20:00,74,209,174168,226901,283,401069,FRIDAY,0,0,5,73,13,1011.1,Cloudy
2/2/2024 21:00,46,141,126868,141311,187,268179,FRIDAY,0,0,5.6,70,11.2,1012.1,Cloudy
2/2/2024 22:00,36,120,183823,83766,156,267589,FRIDAY,0,0,5.6,70,11.2,1012.1,Cloudy
2/2/2024 23:00,51,89,235427,62629,140,298056,FRIDAY,0,0,4.4,79,9.4,1013.2,Cloudy
2/3/2024 0:00,59,100,140389,60933,159,201322,SATURDAY,1,0,3.9,86,16.6,1013.7,Cloudy
2/3/2024 1:00,49,62,111154,48313,111,159467,SATURDAY,1,0,3.9,86,16.6,1013.7,Cloudy
2/3/2024 2:00,22,36,66609,28404,58,95013,SATURDAY,1,0,2.8,89,16.6,1014.3,Cloudy
2/3/2024 3:00,6,8,4379,5766,14,10145,SATURDAY,1,0,2.8,89,16.6,1014.3,Cloudy
2/3/2024 4:00,2,9,2001,3686,11,5687,SATURDAY,1,0,1.7,78,18.4,1014.6,Cloudy
2/3/2024 5:00,4,18,2122,11225,22,13347,SATURDAY,1,0,0.6,78,18.4,1014.7,Cloudy
2/3/2024 6:00,5,40,277038,27548,45,304586,SATURDAY,1,0,0.6,75,20.5,1014.8,Cloudy
2/3/2024 7:00,13,70,11294,39463,83,50757,SATURDAY,1,0,0.6,72,20.5,1014.9,Cloudy
2/3/2024 8:00,24,156,114098,116767,180,230865,SATURDAY,1,0,0.6,72,20.5,1014.9,Cloudy
2/3/2024 9:00,66,216,90507,141775,282,232282,SATURDAY,1,0,-0.6,72,20.5,1015.5,Cloudy
2/3/2024 10:00,80,299,75518,206279,379,281797,SATURDAY,1,0,-0.6,69,22.3,1016,Cloudy
2/3/2024 11:00,116,344,185815,224846,460,410661,SATURDAY,1,0,-1.1,69,20.5,1016.7,Cloudy
2/3/2024 12:00,150,352,162730,246712,502,409442,SATURDAY,1,0,-1.7,72,18.4,1017.2,Cloudy
2/3/2024 13:00,142,374,350485,289657,516,640142,SATURDAY,1,0,-1.7,72,18.4,1017.2,Cloudy
2/3/2024 14:00,155,407,194099,406490,562,600589,SATURDAY,1,0,-0.6,61,25.9,1017.3,Cloudy
2/3/2024 15:00,146,421,333738,354750,567,688488,SATURDAY,1,0,1.1,59,25.9,1017.1,Cloudy
2/3/2024 16:00,132,466,241140,532409,598,773549,SATURDAY,1,0,1.7,54,20.5,1016.6,Cloudy
2/3/2024 17:00,102,412,118649,308126,514,426775,SATURDAY,1,0,2.8,48,16.6,1015.7,Cloudy
2/3/2024 18:00,73,335,61954,209063,408,271017,SATURDAY,1,0,2.8,48,16.6,1015.7,Cloudy
2/3/2024 19:00,81,284,274947,188066,365,463013,SATURDAY,1,0,3.3,40,20.5,1014.9,Fair
2/3/2024 20:00,46,212,41561,122865,258,164426,SATURDAY,1,0,3.3,34,20.5,1014.9,Fair
2/3/2024 21:00,45,188,803342,115450,233,918792,SATURDAY,1,0,3.3,34,20.5,1014.9,Fair
2/3/2024 22:00,45,130,201163,72520,175,273683,SATURDAY,1,0,2.8,35,13,1015.1,Cloudy
2/3/2024 23:00,63,93,185239,53761,156,239000,SATURDAY,1,0,1.1,41,20.5,1015.9,Fair
2/4/2024 0:00,34,65,31620,36418,99,68038,SUNDAY,1,0,0.6,49,14.8,1016.1,Fair
2/4/2024 1:00,56,57,202617,34901,113,237518,SUNDAY,1,0,0,51,14.8,1016.4,Fair
2/4/2024 2:00,28,29,34352,17329,57,51681,SUNDAY,1,0,-0.6,54,16.6,1016.3,Fair
2/4/2024 3:00,10,11,12146,9441,21,21587,SUNDAY,1,0,-0.6,54,16.6,1016.3,Fair
2/4/2024 4:00,0,7,0,3303,7,3303,SUNDAY,1,0,-1.7,53,20.5,1016.2,Clear
2/4/2024 5:00,6,9,4063,4235,15,8298,SUNDAY,1,0,-2.2,53,16.6,1016.1,Clear
2/4/2024 6:00,6,23,4548,15386,29,19934,SUNDAY,1,0,-2.2,48,18.4,1015.9,Clear
2/4/2024 7:00,9,40,6122,24273,49,30395,SUNDAY,1,0,-2.8,53,14.8,1015.7,Clear
2/4/2024 8:00,14,125,13949,73317,139,87266,SUNDAY,1,0,-2.8,53,14.8,1015.7,Clear
2/4/2024 9:00,52,173,57418,107413,225,164831,SUNDAY,1,0,-3.9,63,18.4,1015.9,Clear
2/4/2024 10:00,64,252,155441,182642,316,338083,SUNDAY,1,0,-3.9,63,14.8,1016.1,Clear
2/4/2024 11:00,89,325,96086,241878,414,337964,SUNDAY,1,0,-4.4,65,13,1016.2,Cloudy
2/4/2024 12:00,119,386,577539,309289,505,886828,SUNDAY,1,0,-4.4,65,13,1016.2,Fair
2/4/2024 13:00,149,438,2139563,346040,587,2485603,SUNDAY,1,0,-2.8,58,18.4,1015.9,Fair
2/4/2024 14:00,141,416,281193,490912,557,772105,SUNDAY,1,0,-1.1,49,14.8,1015.4,Fair
2/4/2024 15:00,162,451,529008,314773,613,843781,SUNDAY,1,0,0.6,43,16.6,1014.6,Fair
2/4/2024 16:00,149,403,197698,381812,552,579510,SUNDAY,1,0,2.2,37,16.6,1013.5,Fair
2/4/2024 17:00,93,387,268421,396914,480,665335,SUNDAY,1,0,2.2,37,16.6,1013.5,Fair
2/4/2024 18:00,72,309,83006,197074,381,280080,SUNDAY,1,0,3.9,33,14.8,1011.9,Fair
2/4/2024 19:00,48,262,87851,170808,310,258659,SUNDAY,1,0,5,33,18.4,1011.4,Fair
2/4/2024 20:00,20,195,18464,129556,215,148020,SUNDAY,1,0,5,33,14.8,1011,Fair
2/4/2024 21:00,27,130,17263,119623,157,136886,SUNDAY,1,0,5,33,14.8,1011,Fair
2/4/2024 22:00,21,78,16261,45827,99,62088,SUNDAY,1,0,4.4,37,14.8,1010.9,Fair
2/4/2024 23:00,10,47,10177,30003,57,40180,SUNDAY,1,0,3.3,40,22.3,1011,Clear
2/5/2024 0:00,12,25,8546,19258,37,27804,MONDAY,0,0,2.8,42,24.1,1011.2,Clear
2/5/2024 1:00,9,16,7582,8317,25,15899,MONDAY,0,0,2.2,40,27.7,1011.4,Clear
2/5/2024 2:00,3,6,1265,6259,9,7524,MONDAY,0,0,1.1,46,20.5,1011.4,Clear
2/5/2024 3:00,0,5,0,1557,5,1557,MONDAY,0,0,0.6,47,24.1,1011.4,Clear
2/5/2024 4:00,1,6,860,1946,7,2806,MONDAY,0,0,0,49,22.3,1011.2,Clear
2/5/2024 5:00,11,34,9731,23998,45,33729,MONDAY,0,0,-0.6,54,16.6,1011.2,Clear
2/5/2024 6:00,12,154,9418,98170,166,107588,MONDAY,0,0,-1.1,51,13,1011.4,Clear
2/5/2024 7:00,45,365,36534,280998,410,317532,MONDAY,0,0,-1.7,56,18.4,1011.4,Clear
2/5/2024 8:00,57,770,133763,564958,827,698721,MONDAY,0,0,-1.7,53,18.4,1011.6,Clear
2/5/2024 9:00,60,474,50789,351484,534,402273,MONDAY,0,0,-1.7,53,18.4,1011.6,Clear
2/5/2024 10:00,45,244,42503,170385,289,212888,MONDAY,0,0,-2.8,58,14.8,1011.9,Clear
2/5/2024 11:00,51,265,49994,173985,316,223979,MONDAY,0,0,-3.3,55,18.4,1012.2,Cloudy
2/5/2024 12:00,63,369,62509,250902,432,313411,MONDAY,0,0,-2.2,48,18.4,1012.7,Fair
2/5/2024 13:00,60,314,76506,227594,374,304100,MONDAY,0,0,-0.6,36,14.8,1012.8,Fair
2/5/2024 14:00,69,350,90992,238345,419,329337,MONDAY,0,0,-0.6,36,14.8,1012.8,Fair
2/5/2024 15:00,96,368,117468,254410,464,371878,MONDAY,0,0,1.7,22,20.5,1012.2,Fair
2/5/2024 16:00,91,662,83478,546220,753,629698,MONDAY,0,0,1.7,22,20.5,1012.2,Fair
2/5/2024 17:00,137,804,187316,698595,941,885911,MONDAY,0,0,3.9,23,24.1,1011.3,Fair
2/5/2024 18:00,105,588,97087,410445,693,507532,MONDAY,0,0,3.9,23,20.5,1011.3,Fair
2/5/2024 19:00,67,401,124727,289766,468,414493,MONDAY,0,0,4.4,23,20.5,1011.8,Fair
2/5/2024 20:00,49,300,41525,246075,349,287600,MONDAY,0,0,4.4,24,18.4,1012.3,Fair
2/5/2024 21:00,40,197,32051,121906,237,153957,MONDAY,0,0,3.9,26,16.6,1013,Fair
2/5/2024 22:00,34,131,34775,114281,165,149056,MONDAY,0,0,3.3,29,11.2,1014.1,Cloudy
2/5/2024 23:00,17,65,18912,37398,82,56310,MONDAY,0,0,3.3,29,11.2,1014.1,Fair
2/6/2024 0:00,7,23,5163,59295,30,64458,TUESDAY,0,0,2.8,30,16.6,1015.3,Fair
2/6/2024 1:00,4,13,251749,7091,17,258840,TUESDAY,0,0,2.2,32,16.6,1016.2,Fair
2/6/2024 2:00,1,5,532,1805,6,2337,TUESDAY,0,0,1.7,56,16.6,1016.7,Fair
2/6/2024 3:00,4,5,3076,2399,9,5475,TUESDAY,0,0,0.6,56,27.7,1017,Fair
2/6/2024 4:00,2,7,488,4299,9,4787,TUESDAY,0,0,0.6,56,27.7,1017,Cloudy
2/6/2024 5:00,10,59,10828,88447,69,99275,TUESDAY,0,0,-0.6,56,18.4,1017.7,Cloudy
2/6/2024 6:00,15,184,9540,261309,199,270849,TUESDAY,0,0,-0.6,56,18.4,1018,Cloudy
2/6/2024 7:00,53,462,132060,419213,515,551273,TUESDAY,0,0,-1.1,58,22.3,1018.4,Cloudy
2/6/2024 8:00,110,909,98858,872112,1019,970970,TUESDAY,0,0,-1.1,58,22.3,1018.4,Cloudy
2/6/2024 9:00,64,538,88495,560334,602,648829,TUESDAY,0,0,-1.1,60,16.6,1019,Cloudy
2/6/2024 10:00,47,273,47666,354700,320,402366,TUESDAY,0,0,-1.7,63,22.3,1020.1,Cloudy
2/6/2024 11:00,48,291,83271,211331,339,294602,TUESDAY,0,0,-1.7,63,20.5,1021.1,Cloudy
2/6/2024 12:00,56,343,558382,237347,399,795729,TUESDAY,0,0,-1.7,63,18.4,1021.9,Cloudy
2/6/2024 13:00,47,306,64704,201703,353,266407,TUESDAY,0,0,-1.7,63,18.4,1021.9,Cloudy
2/6/2024 14:00,66,326,69212,208804,392,278016,TUESDAY,0,0,0,64,25.9,1022.3,Cloudy
2/6/2024 15:00,61,443,72908,290426,504,363334,TUESDAY,0,0,0.6,63,24.1,1022.6,Cloudy
2/6/2024 16:00,117,701,123775,495667,818,619442,TUESDAY,0,0,1.7,58,24.1,1022.2,Cloudy
2/6/2024 17:00,111,960,183824,772014,1071,955838,TUESDAY,0,0,2.2,59,20.5,1022,Cloudy
2/6/2024 18:00,108,624,167695,524154,732,691849,TUESDAY,0,0,2.8,59,16.6,1021.8,Cloudy
2/6/2024 19:00,87,432,81400,443020,519,524420,TUESDAY,0,0,2.8,59,16.6,1021.8,Cloudy
2/6/2024 20:00,55,292,72501,255976,347,328477,TUESDAY,0,0,1.7,66,14.8,1022.2,Cloudy
2/6/2024 21:00,37,221,32795,180296,258,213091,TUESDAY,0,0,1.7,66,14.8,1022.6,Cloudy
2/6/2024 22:00,30,124,21049,112246,154,133295,TUESDAY,0,0,1.7,64,13,1023.4,Cloudy
2/6/2024 23:00,18,75,22439,39769,93,62208,TUESDAY,0,0,1.7,64,13,1023.4,Cloudy
2/7/2024 0:00,7,39,6619,60499,46,67118,WEDNESDAY,0,0,1.1,75,7.6,1024,Fair
2/7/2024 1:00,2,7,2756,5309,9,8065,WEDNESDAY,0,0,1.1,75,7.6,1024.2,Cloudy
2/7/2024 2:00,5,6,3594,1895,11,5489,WEDNESDAY,0,0,1.1,75,7.6,1024.2,Cloudy
2/7/2024 3:00,1,6,685,3431,7,4116,WEDNESDAY,0,0,0.6,72,9.4,1024.4,Cloudy
2/7/2024 4:00,0,7,0,4635,7,4635,WEDNESDAY,0,0,0,72,11.2,1024.4,Cloudy
2/7/2024 5:00,10,58,8716,37863,68,46579,WEDNESDAY,0,0,-0.6,76,13,1024.2,Cloudy
2/7/2024 6:00,18,152,16182,102251,170,118433,WEDNESDAY,0,0,-0.6,72,16.6,1024.1,Cloudy
2/7/2024 7:00,56,471,42398,366258,527,408656,WEDNESDAY,0,0,-1.1,72,16.6,1024.2,Cloudy
2/7/2024 8:00,100,931,86028,653467,1031,739495,WEDNESDAY,0,0,-1.1,72,16.6,1024.2,Cloudy
2/7/2024 9:00,80,533,64473,526651,613,591124,WEDNESDAY,0,0,-1.7,75,16.6,1025.2,Cloudy
2/7/2024 10:00,55,316,142276,232392,371,374668,WEDNESDAY,0,0,-1.7,75,16.6,1025.2,Cloudy
2/7/2024 11:00,46,325,58272,329089,371,387361,WEDNESDAY,0,0,-1.1,75,14.8,1026.2,Cloudy
2/7/2024 12:00,64,330,55714,221826,394,277540,WEDNESDAY,0,0,-0.6,72,16.6,1026.8,Cloudy
2/7/2024 13:00,66,323,63369,209637,389,273006,WEDNESDAY,0,0,-0.6,72,16.6,1026.8,Cloudy
2/7/2024 14:00,74,377,71262,239063,451,310325,WEDNESDAY,0,0,2.2,70,16.6,1026.8,Cloudy
2/7/2024 15:00,74,436,63778,320433,510,384211,WEDNESDAY,0,0,3.3,67,22.3,1026.9,Cloudy
2/7/2024 16:00,127,742,149579,598926,869,748505,WEDNESDAY,0,0,3.9,64,16.6,1026,Cloudy
2/7/2024 17:00,141,937,137148,834707,1078,971855,WEDNESDAY,0,0,3.9,64,16.6,1026,Cloudy
2/7/2024 18:00,109,651,115805,463735,760,579540,WEDNESDAY,0,0,3.9,67,20.5,1025,Cloudy
2/7/2024 19:00,86,442,76207,390015,528,466222,WEDNESDAY,0,0,2.8,72,18.4,1024.9,Cloudy
2/7/2024 20:00,45,351,118935,233450,396,352385,WEDNESDAY,0,0,2.2,75,16.6,1025.2,Cloudy
2/7/2024 21:00,40,214,34071,225934,254,260005,WEDNESDAY,0,0,1.7,78,11.2,1025.5,Cloudy
2/7/2024 22:00,30,146,25899,102994,176,128893,WEDNESDAY,0,0,1.7,78,11.2,1025.5,Cloudy
2/7/2024 23:00,24,97,47711,56220,121,103931,WEDNESDAY,0,0,1.1,82,9.4,1025.7,Cloudy
2/8/2024 0:00,12,35,13920,18049,47,31969,THURSDAY,0,0,1.7,78,0,1025.9,Cloudy
2/8/2024 1:00,4,13,3120,5701,17,8821,THURSDAY,0,0,1.7,85,0,1026.1,Cloudy
2/8/2024 2:00,1,7,282,5659,8,5941,THURSDAY,0,0,0.6,85,0,1025.9,Cloudy
2/8/2024 3:00,3,2,716,2249,5,2965,THURSDAY,0,0,0.6,85,0,1025.9,Cloudy
2/8/2024 4:00,1,9,704,8012,10,8716,THURSDAY,0,0,0.6,85,0,1025.9,Fair
2/8/2024 5:00,4,59,4238,37355,63,41593,THURSDAY,0,0,0,81,7.6,1026.1,Cloudy
2/8/2024 6:00,21,166,102976,115658,187,218634,THURSDAY,0,0,-0.6,85,0,1026.2,Cloudy
2/8/2024 7:00,45,447,36043,477320,492,513363,THURSDAY,0,0,-0.6,82,0,1026.4,Fair
2/8/2024 8:00,98,930,156208,689337,1028,845545,THURSDAY,0,0,-0.6,82,0,1026.4,Fair
2/8/2024 9:00,46,567,41082,402320,613,443402,THURSDAY,0,0,-2.2,88,0,1026.4,Fair
2/8/2024 10:00,56,367,132107,259807,423,391914,THURSDAY,0,0,-1.7,92,5.4,1026.5,Cloudy
2/8/2024 11:00,64,334,161967,249049,398,411016,THURSDAY,0,0,-1.7,92,0,1026.7,Cloudy
2/8/2024 12:00,70,324,63493,216508,394,280001,THURSDAY,0,0,1.1,82,0,1027.4,Fair
2/8/2024 13:00,66,364,64288,238419,430,302707,THURSDAY,0,0,1.1,82,0,1027.4,Fair
2/8/2024 14:00,82,390,86111,245731,472,331842,THURSDAY,0,0,2.8,67,0,1027.7,Fair
2/8/2024 15:00,100,447,117845,315621,547,433466,THURSDAY,0,0,3.3,70,7.6,1027.2,Fair
2/8/2024 16:00,120,745,106370,537770,865,644140,THURSDAY,0,0,4.4,65,7.6,1026.7,Fair
2/8/2024 17:00,170,951,262561,681995,1121,944556,THURSDAY,0,0,4.4,65,7.6,1026.7,Fair
2/8/2024 18:00,129,676,115061,473090,805,588151,THURSDAY,0,0,5,55,11.2,1025.4,Fair
2/8/2024 19:00,88,477,75326,408359,565,483685,THURSDAY,0,0,4.4,60,9.4,1025.6,Fair
2/8/2024 20:00,62,357,65358,295314,419,360672,THURSDAY,0,0,4.4,60,9.4,1025.6,Fair
2/8/2024 21:00,57,241,58560,175034,298,233594,THURSDAY,0,0,2.8,76,13,1025.5,Fair
2/8/2024 22:00,35,147,26195,93036,182,119231,THURSDAY,0,0,2.8,76,13,1025.5,Cloudy
2/8/2024 23:00,26,116,18498,72657,142,91155,THURSDAY,0,0,2.2,85,11.2,1025.9,Fair
2/9/2024 0:00,11,44,98136,110876,55,209012,FRIDAY,0,0,2.2,89,9.4,1025.5,Fair
2/9/2024 1:00,10,21,4946,9757,31,14703,FRIDAY,0,0,1.1,85,11.2,1025.5,Fair
2/9/2024 2:00,9,14,9771,6023,23,15794,FRIDAY,0,0,1.1,85,11.2,1025.5,Fair
2/9/2024 3:00,1,5,1822,5180,6,7002,FRIDAY,0,0,0,92,11.2,1025,Fair
2/9/2024 4:00,1,8,952,3584,9,4536,FRIDAY,0,0,0.6,85,5.4,1025,Clear
2/9/2024 5:00,4,33,5167,20840,37,26007,FRIDAY,0,0,0,92,7.6,1024.4,Fair
2/9/2024 6:00,14,135,12706,86737,149,99443,FRIDAY,0,0,0,88,9.4,1024.6,Fair
2/9/2024 7:00,45,354,34557,254950,399,289507,FRIDAY,0,0,-0.6,96,9.4,1023.8,Fair
2/9/2024 8:00,80,661,66239,552077,741,618316,FRIDAY,0,0,-0.6,96,9.4,1023.8,Fair
2/9/2024 9:00,87,456,73417,312733,543,386150,FRIDAY,0,0,-1.1,96,11.2,1022.8,Cloudy
2/9/2024 10:00,54,300,43331,221375,354,264706,FRIDAY,0,0,0,96,11.2,1023,Cloudy
2/9/2024 11:00,66,306,65183,281831,372,347014,FRIDAY,0,0,0,96,9.4,1023.1,Cloudy
2/9/2024 12:00,98,418,211246,242380,516,453626,FRIDAY,0,0,0,96,9.4,1023.1,Cloudy
2/9/2024 13:00,101,459,98036,301375,560,399411,FRIDAY,0,0,1.7,92,7.6,1022.6,Cloudy
2/9/2024 14:00,115,438,227628,339586,553,567214,FRIDAY,0,0,2.2,92,13,1022.4,Cloudy
2/9/2024 15:00,159,550,202177,367421,709,569598,FRIDAY,0,0,2.2,92,13,1022.4,Cloudy
2/9/2024 16:00,185,740,243020,646424,925,889444,FRIDAY,0,0,3.9,89,16.6,1020.6,Cloudy
2/9/2024 17:00,194,826,296410,620501,1020,916911,FRIDAY,0,0,3.9,89,16.6,1020.6,Cloudy
2/9/2024 18:00,158,596,663639,469384,754,1133023,FRIDAY,0,0,6.7,70,20.5,1017.9,Cloudy
2/9/2024 19:00,122,421,910007,323238,543,1233245,FRIDAY,0,0,8.9,56,20.5,1017.2,Cloudy
2/9/2024 20:00,91,292,82068,192254,383,274322,FRIDAY,0,0,8.3,58,20.5,1016.2,Cloudy
2/9/2024 21:00,89,266,114545,183097,355,297642,FRIDAY,0,0,6.1,73,13,1016.1,Cloudy
2/9/2024 22:00,117,194,198492,157786,311,356278,FRIDAY,0,0,6.1,73,13,1016.1,Cloudy
2/9/2024 23:00,70,124,63998,83540,194,147538,FRIDAY,0,0,6.1,76,16.6,1016.5,Cloudy
2/10/2024 0:00,42,118,39246,124623,160,163869,SATURDAY,1,0,5.6,82,16.6,1015.7,Fair
2/10/2024 1:00,72,67,164749,47854,139,212603,SATURDAY,1,0,5,86,13,1015.4,Fair
2/10/2024 2:00,47,31,81066,36779,78,117845,SATURDAY,1,0,5,86,13,1015.4,Cloudy
2/10/2024 3:00,5,15,6039,13288,20,19327,SATURDAY,1,0,2.8,100,13,1014.6,Cloudy
2/10/2024 4:00,1,17,233,11855,18,12088,SATURDAY,1,0,2.8,100,13,1014.6,Cloudy
2/10/2024 5:00,2,13,4006,8693,15,12699,SATURDAY,1,0,2.2,100,11.2,1014.3,Cloudy
2/10/2024 6:00,10,31,18286,20667,41,38953,SATURDAY,1,0,3.3,100,5.4,1013.3,Cloudy
2/10/2024 7:00,26,79,37821,60576,105,98397,SATURDAY,1,0,3.3,100,5.4,1013.3,Cloudy
2/10/2024 8:00,50,171,146314,126414,221,272728,SATURDAY,1,0,3.3,100,7.6,1011.5,Cloudy
2/10/2024 9:00,96,307,254840,220987,403,475827,SATURDAY,1,0,2.8,100,13,1011.6,Cloudy
2/10/2024 10:00,183,393,322023,260463,576,582486,SATURDAY,1,0,2.8,100,13,1011.1,Fair
2/10/2024 11:00,252,457,609377,399650,709,1009027,SATURDAY,1,0,2.2,97,5.4,1010.8,Cloudy
2/10/2024 12:00,343,516,1238889,451446,859,1690335,SATURDAY,1,0,2.2,97,5.4,1010.8,Fair
2/10/2024 13:00,382,587,676560,519419,969,1195979,SATURDAY,1,0,5.6,92,20.5,1010.9,Fair
2/10/2024 14:00,471,630,1574576,615471,1101,2190047,SATURDAY,1,0,7.8,79,18.4,1010.4,Fair
2/10/2024 15:00,488,620,1712682,566773,1108,2279455,SATURDAY,1,0,10.6,68,14.8,1009.5,Fair
2/10/2024 16:00,481,627,888424,759536,1108,1647960,SATURDAY,1,0,10.6,68,14.8,1009.5,Cloudy
2/10/2024 17:00,274,562,634980,458350,836,1093330,SATURDAY,1,0,12.8,59,13,1007.3,Cloudy
2/10/2024 18:00,224,455,313676,439873,679,753549,SATURDAY,1,0,13.3,60,14.8,1006.3,Cloudy
2/10/2024 19:00,127,279,157909,184009,406,341918,SATURDAY,1,0,15,53,16.6,1005.7,Cloudy
2/10/2024 20:00,33,154,33703,111876,187,145579,SATURDAY,1,0,15,51,18.4,1005.1,Cloudy
2/10/2024 21:00,53,180,69525,123009,233,192534,SATURDAY,1,0,14.4,53,14.8,1005.3,Cloudy
2/10/2024 22:00,49,144,44479,93706,193,138185,SATURDAY,1,0,14.4,53,14.8,1005.3,Cloudy
2/10/2024 23:00,73,130,81966,210193,203,292159,SATURDAY,1,0,12.8,62,20.5,1006.5,Cloudy
2/11/2024 0:00,80,98,345516,63129,178,408645,SUNDAY,1,0,12.8,64,14.8,1007.1,Cloudy
2/11/2024 1:00,86,90,268699,71405,176,340104,SUNDAY,1,0,9.4,90,11.2,1007.4,Cloudy
2/11/2024 2:00,45,33,138789,31290,78,170079,SUNDAY,1,0,7.2,97,16.6,1007,Cloudy
2/11/2024 3:00,13,11,104254,13071,24,117325,SUNDAY,1,0,7.2,97,16.6,1007,Cloudy
2/11/2024 4:00,2,12,817,13481,14,14298,SUNDAY,1,0,10,80,24.1,1007.1,Cloudy
2/11/2024 5:00,6,20,6910,13402,26,20312,SUNDAY,1,0,10,77,24.1,1007.2,Cloudy
2/11/2024 6:00,6,20,5044,13045,26,18089,SUNDAY,1,0,9.4,74,18.4,1007.5,Cloudy
2/11/2024 7:00,15,53,14257,37601,68,51858,SUNDAY,1,0,9.4,74,18.4,1007.5,Cloudy
2/11/2024 8:00,38,139,45210,91561,177,136771,SUNDAY,1,0,7.8,68,13,1009,Cloudy
2/11/2024 9:00,56,245,140950,172675,301,313625,SUNDAY,1,0,7.2,71,20.5,1009.1,Cloudy
2/11/2024 10:00,104,377,139988,257234,481,397222,SUNDAY,1,0,6.7,68,18.4,1009.5,Cloudy
2/11/2024 11:00,135,366,164135,275056,501,439191,SUNDAY,1,0,6.7,62,24.1,1010,Cloudy
2/11/2024 12:00,159,418,350769,291442,577,642211,SUNDAY,1,0,6.7,62,24.1,1010,Cloudy
2/11/2024 13:00,185,446,298276,320059,631,618335,SUNDAY,1,0,6.7,60,22.3,1011.1,Cloudy
2/11/2024 14:00,197,436,825488,386568,633,1212056,SUNDAY,1,0,7.2,56,18.4,1010.7,Cloudy
2/11/2024 15:00,161,421,699386,381516,582,1080902,SUNDAY,1,0,7.8,53,24.1,1011.3,Cloudy
2/11/2024 16:00,170,492,809998,473406,662,1283404,SUNDAY,1,0,7.8,53,24.1,1011.3,Cloudy
2/11/2024 17:00,212,531,1193551,390600,743,1584151,SUNDAY,1,0,7.8,49,24.1,1010.1,Cloudy
2/11/2024 18:00,132,410,179514,464769,542,644283,SUNDAY,1,0,8.3,48,22.3,1009.8,Cloudy
2/11/2024 19:00,44,195,48592,134799,239,183391,SUNDAY,1,0,8.3,48,22.3,1009.6,Cloudy
2/11/2024 20:00,48,165,41420,198973,213,240393,SUNDAY,1,0,8.9,46,16.6,1009.5,Cloudy
2/11/2024 21:00,42,137,839365,90495,179,929860,SUNDAY,1,0,8.9,46,16.6,1009.5,Cloudy
2/11/2024 22:00,39,139,26229,170332,178,196561,SUNDAY,1,0,8.3,48,14.8,1010.5,Cloudy
2/11/2024 23:00,138,290,127283,209221,428,336504,SUNDAY,1,0,8.3,48,14.8,1010.5,Cloudy
2/12/2024 0:00,14,49,22079,26870,63,48949,MONDAY,0,0,6.7,55,20.5,1010.8,Cloudy
2/12/2024 1:00,12,13,42497,15725,25,58222,MONDAY,0,0,6.1,55,14.8,1011.1,Cloudy
2/12/2024 2:00,4,7,61678,8406,11,70084,MONDAY,0,0,6.1,55,14.8,1011.1,Cloudy
2/12/2024 3:00,2,8,2587,8809,10,11396,MONDAY,0,0,5,60,16.6,1011.2,Cloudy
2/12/2024 4:00,4,9,6516,6177,13,12693,MONDAY,0,0,3.9,62,14.8,1011.6,Cloudy
2/12/2024 5:00,6,45,4694,35718,51,40412,MONDAY,0,0,3.3,67,13,1012,Cloudy
2/12/2024 6:00,8,142,4229,118576,150,122805,MONDAY,0,0,3.3,67,13,1012,Cloudy
2/12/2024 7:00,38,390,44977,401895,428,446872,MONDAY,0,0,2.2,70,9.4,1011.6,Fair
2/12/2024 8:00,71,820,115582,737536,891,853118,MONDAY,0,0,1.7,72,9.4,1011.5,Fair
2/12/2024 9:00,43,496,128370,333365,539,461735,MONDAY,0,0,1.7,72,16.6,1011.9,Fair
2/12/2024 10:00,53,293,73258,208576,346,281834,MONDAY,0,0,1.7,72,16.6,1011.9,Clear
2/12/2024 11:00,48,346,63402,223973,394,287375,MONDAY,0,0,1.7,72,7.6,1012.6,Fair
2/12/2024 12:00,71,372,107036,253391,443,360427,MONDAY,0,0,2.2,70,9.4,1012.8,Fair
2/12/2024 13:00,81,348,107803,245064,429,352867,MONDAY,0,0,3.9,64,11.2,1012.9,Fair
2/12/2024 14:00,98,373,109561,258791,471,368352,MONDAY,0,0,3.9,64,11.2,1012.9,Fair
2/12/2024 15:00,121,494,114456,365426,615,479882,MONDAY,0,0,6.1,53,5.4,1012.8,Fair
2/12/2024 16:00,143,750,149154,523831,893,672985,MONDAY,0,0,5.6,59,13,1011.5,Fair
2/12/2024 17:00,154,985,199314,737134,1139,936448,MONDAY,0,0,5.6,59,14.8,1010.5,Fair
2/12/2024 18:00,125,734,144459,516900,859,661359,MONDAY,0,0,7.2,53,9.4,1009.2,Fair
2/12/2024 19:00,86,540,64002,430566,626,494568,MONDAY,0,0,6.7,55,9.4,1009.2,Fair
2/12/2024 20:00,62,342,133828,229864,404,363692,MONDAY,0,0,6.7,55,9.4,1009.2,Cloudy
2/12/2024 21:00,35,231,30065,146441,266,176506,MONDAY,0,0,5,70,11.2,1009.3,Cloudy
2/12/2024 22:00,68,155,64041,110002,223,174043,MONDAY,0,0,3.9,73,0,1009.6,Cloudy
2/12/2024 23:00,34,95,27891,56868,129,84759,MONDAY,0,0,3.9,73,5.4,1010.6,Cloudy
2/13/2024 0:00,18,38,107474,20967,56,128441,TUESDAY,0,0,3.9,73,5.4,1010.6,Cloudy
2/13/2024 1:00,8,14,9558,5784,22,15342,TUESDAY,0,0,4.4,62,14.8,1009.9,Cloudy
2/13/2024 2:00,3,7,2234,5316,10,7550,TUESDAY,0,0,4.4,62,14.8,1009.9,Cloudy
2/13/2024 3:00,4,4,102447,2281,8,104728,TUESDAY,0,0,3.3,57,13,1009.8,Cloudy
2/13/2024 4:00,6,9,6600,7042,15,13642,TUESDAY,0,0,3.3,57,13,1009.8,Cloudy
2/13/2024 5:00,11,31,8089,21362,42,29451,TUESDAY,0,0,2.2,62,13,1007.6,Cloudy
2/13/2024 6:00,14,94,11650,53895,108,65545,TUESDAY,0,0,2.2,64,16.6,1006.9,Cloudy
2/13/2024 7:00,18,132,9175,81890,150,91065,TUESDAY,0,0,2.2,64,11.2,1006.4,Cloudy
2/13/2024 8:00,12,164,7068,90385,176,97453,TUESDAY,0,0,2.2,64,11.2,1006.4,Cloudy
2/13/2024 9:00,16,99,10348,56895,115,67243,TUESDAY,0,0,3.3,83,25.9,1005,Cloudy
2/13/2024 10:00,6,93,4574,54268,99,58842,TUESDAY,0,0,3.3,83,24.1,1003.7,Rain
2/13/2024 11:00,9,75,6875,36169,84,43044,TUESDAY,0,0,3.3,83,25.9,1002.8,Rain
2/13/2024 12:00,6,78,4139,38227,84,42366,TUESDAY,0,0,3.3,89,25.9,1002.5,Snow
2/13/2024 13:00,4,70,3117,42769,74,45886,TUESDAY,0,0,2.8,93,29.5,1000.4,Snow
2/13/2024 14:00,19,116,10795,64851,135,75646,TUESDAY,0,0,2.8,93,35.3,1000.4,Snow
2/13/2024 15:00,41,163,255857,94493,204,350350,TUESDAY,0,0,2.2,92,37.1,999.5,Snow
2/13/2024 16:00,45,233,28662,155414,278,184076,TUESDAY,0,0,0.6,100,29.5,998.6,Snow
2/13/2024 17:00,56,427,45831,262608,483,308439,TUESDAY,0,0,0.6,100,29.5,997.3,Snow
2/13/2024 18:00,48,438,30106,245913,486,276019,TUESDAY,0,0,0.6,100,37.1,997.3,Snow
2/13/2024 19:00,50,302,111131,182669,352,293800,TUESDAY,0,0,0.6,82,33.5,997.2,Cloudy
2/13/2024 20:00,36,232,23333,217166,268,240499,TUESDAY,0,0,0.6,69,18.4,999.5,Snow
2/13/2024 21:00,21,175,13125,108989,196,122114,TUESDAY,0,0,1.1,61,16.6,1001.2,Snow
2/13/2024 22:00,30,123,176128,87546,153,263674,TUESDAY,0,0,1.1,56,20.5,1002.6,Snow
2/13/2024 23:00,12,71,10990,87963,83,98953,TUESDAY,0,0,1.1,56,20.5,1002.6,Snow
2/14/2024 0:00,7,29,5303,16393,36,21696,WEDNESDAY,0,0,1.1,54,16.6,1004.2,Cloudy
2/14/2024 1:00,2,18,1071,8759,20,9830,WEDNESDAY,0,0,1.1,64,16.6,1004.4,Cloudy
2/14/2024 2:00,1,11,352,6284,12,6636,WEDNESDAY,0,0,0.6,69,18.4,1004.5,Fair
2/14/2024 3:00,0,10,0,7787,10,7787,WEDNESDAY,0,0,0.6,69,18.4,1004.5,Fair
2/14/2024 4:00,3,5,4327,2499,8,6826,WEDNESDAY,0,0,0.6,72,20.5,1004.7,Clear
2/14/2024 5:00,6,41,6766,25918,47,32684,WEDNESDAY,0,0,0,69,16.6,1005.2,Cloudy
2/14/2024 6:00,21,169,17859,133059,190,150918,WEDNESDAY,0,0,0,64,16.6,1005.3,Fair
2/14/2024 7:00,49,458,35274,394631,507,429905,WEDNESDAY,0,0,0,66,20.5,1005.1,Fair
2/14/2024 8:00,82,930,74548,701696,1012,776244,WEDNESDAY,0,0,-0.6,76,13,1004.9,Fair
2/14/2024 9:00,48,498,36021,327304,546,363325,WEDNESDAY,0,0,-0.6,76,13,1004.9,Fair
2/14/2024 10:00,52,270,40666,178807,322,219473,WEDNESDAY,0,0,0.6,61,25.9,1005.3,Cloudy
2/14/2024 11:00,50,316,39089,209873,366,248962,WEDNESDAY,0,0,-0.6,66,27.7,1007.1,Cloudy
2/14/2024 12:00,35,300,52506,182522,335,235028,WEDNESDAY,0,0,-1.1,53,27.7,1008.1,Cloudy
2/14/2024 13:00,47,327,39463,200100,374,239563,WEDNESDAY,0,0,-1.1,53,40.7,1008.1,Fair
2/14/2024 14:00,54,310,50692,198256,364,248948,WEDNESDAY,0,0,-1.1,43,38.9,1009.3,Fair
2/14/2024 15:00,64,396,45511,349972,460,395483,WEDNESDAY,0,0,-1.1,39,40.7,1009.9,Fair
2/14/2024 16:00,109,691,107517,475150,800,582667,WEDNESDAY,0,0,0,39,37.1,1009.5,Fair
2/14/2024 17:00,181,890,262899,669545,1071,932444,WEDNESDAY,0,0,0,33,29.5,1009.4,Fair
2/14/2024 18:00,96,637,85827,450922,733,536749,WEDNESDAY,0,0,0,33,31.7,1009.4,Fair
2/14/2024 19:00,38,333,37924,211186,371,249110,WEDNESDAY,0,0,0,31,31.7,1009.3,Fair
2/14/2024 20:00,35,245,24714,155019,280,179733,WEDNESDAY,0,0,0,31,37.1,1009.6,Fair
2/14/2024 21:00,40,158,28158,103951,198,132109,WEDNESDAY,0,0,-0.6,31,44.6,1010.2,Fair
2/14/2024 22:00,28,96,24856,54075,124,78931,WEDNESDAY,0,0,-0.6,31,24.1,1011.3,Fair
2/14/2024 23:00,12,66,7284,42221,78,49505,WEDNESDAY,0,0,-0.6,31,24.1,1011.3,Fair
2/15/2024 0:00,11,23,14899,12067,34,26966,THURSDAY,0,0,-1.1,32,37.1,1012.4,Fair
2/15/2024 1:00,2,22,74081,12670,24,86751,THURSDAY,0,0,-1.7,34,27.7,1013.4,Clear
2/15/2024 2:00,2,11,671,5983,13,6654,THURSDAY,0,0,-1.7,34,27.7,1013.4,Clear
2/15/2024 3:00,0,5,0,3362,5,3362,THURSDAY,0,0,-2.2,37,31.7,1013.9,Clear
2/15/2024 4:00,3,11,1942,4655,14,6597,THURSDAY,0,0,-2.8,44,27.7,1014.1,Clear
2/15/2024 5:00,8,40,7151,25546,48,32697,THURSDAY,0,0,-3.3,42,29.5,1015.1,Clear
2/15/2024 6:00,19,143,436310,86523,162,522833,THURSDAY,0,0,-3.3,42,29.5,1015.1,Clear
2/15/2024 7:00,58,446,38920,302225,504,341145,THURSDAY,0,0,-3.3,44,24.1,1016.3,Clear
2/15/2024 8:00,128,881,138969,629422,1009,768391,THURSDAY,0,0,-3.9,46,29.5,1016.8,Clear
2/15/2024 9:00,60,498,48228,319462,558,367690,THURSDAY,0,0,-3.9,46,24.1,1017.4,Clear
2/15/2024 10:00,34,271,28495,181380,305,209875,THURSDAY,0,0,-3.9,46,24.1,1017.4,Clear
2/15/2024 11:00,26,294,24014,165987,320,190001,THURSDAY,0,0,-3.9,48,24.1,1018,Fair
2/15/2024 12:00,65,302,710167,187009,367,897176,THURSDAY,0,0,-2.8,44,20.5,1018.7,Fair
2/15/2024 13:00,65,307,345475,262614,372,608089,THURSDAY,0,0,-1.7,41,22.3,1018.7,Fair
2/15/2024 14:00,80,322,87634,209402,402,297036,THURSDAY,0,0,-0.6,36,22.3,1018.5,Fair
2/15/2024 15:00,92,402,97167,276480,494,373647,THURSDAY,0,0,-0.6,36,27.7,1018.5,Fair
2/15/2024 16:00,130,705,734561,545671,835,1280232,THURSDAY,0,0,1.1,30,20.5,1018.2,Fair
2/15/2024 17:00,165,908,144759,671632,1073,816391,THURSDAY,0,0,3.3,23,16.6,1017,Fair
2/15/2024 18:00,144,671,220107,530380,815,750487,THURSDAY,0,0,2.8,23,22.3,1016.1,Fair
2/15/2024 19:00,76,420,64632,267077,496,331709,THURSDAY,0,0,3.9,21,16.6,1014.8,Cloudy
2/15/2024 20:00,48,288,41738,177230,336,218968,THURSDAY,0,0,3.9,21,16.6,1014.8,Cloudy
2/15/2024 21:00,19,163,11881,111038,182,122919,THURSDAY,0,0,2.8,24,16.6,1012.8,Cloudy
2/15/2024 22:00,32,116,27988,79419,148,107407,THURSDAY,0,0,2.2,29,18.4,1012.3,Cloudy
2/15/2024 23:00,12,61,7889,37277,73,45166,THURSDAY,0,0,1.7,33,9.4,1011.4,Cloudy
2/16/2024 0:00,13,36,9091,21576,49,30667,FRIDAY,0,0,1.7,38,14.8,1010.4,Cloudy
2/16/2024 1:00,6,20,4848,15959,26,20807,FRIDAY,0,0,1.7,38,14.8,1010.4,Cloudy
2/16/2024 2:00,10,4,6930,1342,14,8272,FRIDAY,0,0,1.1,41,27.7,1010,Cloudy
2/16/2024 3:00,1,5,189,2172,6,2361,FRIDAY,0,0,-1.7,85,18.4,1007.3,Snow
2/16/2024 4:00,0,5,0,1952,5,1952,FRIDAY,0,0,-1.7,92,18.4,1005.3,Snow
2/16/2024 5:00,3,36,3128,21285,39,24413,FRIDAY,0,0,-1.7,92,18.4,1005.3,Snow
2/16/2024 6:00,19,110,14201,107699,129,121900,FRIDAY,0,0,-0.6,89,20.5,1003.8,Cloudy
2/16/2024 7:00,35,300,22620,314032,335,336652,FRIDAY,0,0,0,92,22.3,1001.1,Cloudy
2/16/2024 8:00,74,565,348779,400440,639,749219,FRIDAY,0,0,0.6,78,22.3,1000.9,Cloudy
2/16/2024 9:00,61,413,50539,283968,474,334507,FRIDAY,0,0,0.6,75,24.1,1001,Cloudy
2/16/2024 10:00,37,280,33897,297791,317,331688,FRIDAY,0,0,0.6,75,24.1,1001,Cloudy
2/16/2024 11:00,64,297,61710,182111,361,243821,FRIDAY,0,0,1.7,56,29.5,1001.3,Cloudy
2/16/2024 12:00,73,314,92422,201869,387,294291,FRIDAY,0,0,2.8,48,29.5,1002.2,Cloudy
2/16/2024 13:00,85,360,81903,216844,445,298747,FRIDAY,0,0,1.7,54,33.5,1003.3,Fair
2/16/2024 14:00,86,325,158205,203223,411,361428,FRIDAY,0,0,1.7,45,27.7,1004.5,Fair
2/16/2024 15:00,104,432,177488,298021,536,475509,FRIDAY,0,0,1.7,45,27.7,1004.5,Fair
2/16/2024 16:00,108,535,108266,445085,643,553351,FRIDAY,0,0,1.7,36,37.1,1006.7,Fair
2/16/2024 17:00,116,661,107136,496172,777,603308,FRIDAY,0,0,2.2,35,38.9,1007.1,Fair
2/16/2024 18:00,85,497,78490,331524,582,410014,FRIDAY,0,0,3.9,33,40.7,1007.3,Fair
2/16/2024 19:00,93,360,78648,222189,453,300837,FRIDAY,0,0,3.3,34,33.5,1007.7,Fair
2/16/2024 20:00,53,262,45670,167654,315,213324,FRIDAY,0,0,3.3,34,27.7,1007.7,Fair
2/16/2024 21:00,52,175,48178,105204,227,153382,FRIDAY,0,0,2.2,37,27.7,1009.4,Fair
2/16/2024 22:00,61,151,60634,92312,212,152946,FRIDAY,0,0,2.2,37,27.7,1009.4,Cloudy
2/16/2024 23:00,57,121,72907,74560,178,147467,FRIDAY,0,0,1.1,40,29.5,1012,Fair
2/17/2024 0:00,37,84,43914,49221,121,93135,SATURDAY,1,0,1.1,40,25.9,1012,Fair
2/17/2024 1:00,61,56,110938,34495,117,145433,SATURDAY,1,0,0.6,41,18.4,1012.8,Fair
2/17/2024 2:00,30,44,29745,30405,74,60150,SATURDAY,1,0,0,43,16.6,1012.1,Fair
2/17/2024 3:00,4,13,2610,9997,17,12607,SATURDAY,1,0,0,47,13,1012.1,Cloudy
2/17/2024 4:00,1,5,1716,3598,6,5314,SATURDAY,1,0,0,47,13,1011.9,Cloudy
2/17/2024 5:00,4,19,4015,16333,23,20348,SATURDAY,1,0,0,47,13,1011.9,Cloudy
2/17/2024 6:00,7,44,9784,29069,51,38853,SATURDAY,1,0,-0.6,49,9.4,1011.8,Cloudy
2/17/2024 7:00,25,74,18640,43141,99,61781,SATURDAY,1,0,-0.6,49,5.4,1010.5,Cloudy
2/17/2024 8:00,29,135,260357,91691,164,352048,SATURDAY,1,0,-0.6,54,16.6,1009.9,Cloudy
2/17/2024 9:00,47,223,54144,126340,270,180484,SATURDAY,1,0,-1.7,69,16.6,1009.4,Cloudy
2/17/2024 10:00,74,284,429078,175985,358,605063,SATURDAY,1,0,-1.7,69,16.6,1009.4,Cloudy
2/17/2024 11:00,100,332,110401,309417,432,419818,SATURDAY,1,0,-2.2,75,14.8,1008.7,Cloudy
2/17/2024 12:00,142,365,530071,332349,507,862420,SATURDAY,1,0,-1.7,72,9.4,1008.4,Cloudy
2/17/2024 13:00,146,340,224263,235487,486,459750,SATURDAY,1,0,-1.1,69,5.4,1007.9,Cloudy
2/17/2024 14:00,95,354,195177,243984,449,439161,SATURDAY,1,0,-1.1,69,9.4,1007.3,Cloudy
2/17/2024 15:00,135,319,1014133,223644,454,1237777,SATURDAY,1,0,-0.6,69,5.4,1007.3,Cloudy
2/17/2024 16:00,95,350,283309,249726,445,533035,SATURDAY,1,0,-0.6,69,5.4,1005.8,Cloudy
2/17/2024 17:00,109,345,429754,241845,454,671599,SATURDAY,1,0,0.6,61,7.6,1004.6,Cloudy
2/17/2024 18:00,76,339,323371,233619,415,556990,SATURDAY,1,0,1.7,56,13,1003.6,Cloudy
2/17/2024 19:00,81,252,273200,166819,333,440019,SATURDAY,1,0,1.7,56,13,1003.6,Cloudy
2/17/2024 20:00,70,212,453336,126336,282,579672,SATURDAY,1,0,0.6,61,22.3,1004.3,Cloudy
2/17/2024 21:00,38,159,32393,114799,197,147192,SATURDAY,1,0,0,54,16.6,1004.5,Cloudy
2/17/2024 22:00,53,117,137956,67523,170,205479,SATURDAY,1,0,0,54,16.6,1004.5,Cloudy
2/17/2024 23:00,34,94,32876,52887,128,85763,SATURDAY,1,0,-0.6,43,24.1,1006.2,Cloudy
2/18/2024 0:00,22,58,21975,36107,80,58082,SUNDAY,1,0,-0.6,36,24.1,1006.2,Fair
2/18/2024 1:00,38,48,55894,37571,86,93465,SUNDAY,1,0,-2.2,44,27.7,1007.7,Fair
2/18/2024 2:00,21,27,64278,21046,48,85324,SUNDAY,1,0,-2.8,41,27.7,1008.2,Fair
2/18/2024 3:00,2,9,1901,3668,11,5569,SUNDAY,1,0,-3.3,38,24.1,1008.8,Clear
2/18/2024 4:00,6,3,4495,2367,9,6862,SUNDAY,1,0,-3.9,40,22.3,1009.2,Clear
2/18/2024 5:00,3,9,3592,4271,12,7863,SUNDAY,1,0,-3.9,40,22.3,1009.2,Clear
2/18/2024 6:00,4,18,2937,23542,22,26479,SUNDAY,1,0,-3.9,42,29.5,1009.8,Clear
2/18/2024 7:00,15,54,243141,35698,69,278839,SUNDAY,1,0,-5,48,18.4,1010.6,Clear
2/18/2024 8:00,22,88,16758,132730,110,149488,SUNDAY,1,0,-5,48,22.3,1011.2,Clear
2/18/2024 9:00,44,205,53787,124146,249,177933,SUNDAY,1,0,-5,52,20.5,1011.7,Clear
2/18/2024 10:00,81,234,73331,134417,315,207748,SUNDAY,1,0,-5,52,20.5,1011.7,Cloudy
2/18/2024 11:00,104,300,113259,369634,404,482893,SUNDAY,1,0,-5.6,57,24.1,1011.3,Cloudy
2/18/2024 12:00,105,324,105308,237111,429,342419,SUNDAY,1,0,-4.4,50,20.5,1010.7,Cloudy
2/18/2024 13:00,135,315,135498,242446,450,377944,SUNDAY,1,0,-3.3,48,25.9,1010,Cloudy
2/18/2024 14:00,119,350,225383,343110,469,568493,SUNDAY,1,0,-1.7,45,31.7,1009.3,Cloudy
2/18/2024 15:00,154,304,302242,226990,458,529232,SUNDAY,1,0,-1.7,45,31.7,1009.3,Cloudy
2/18/2024 16:00,120,341,394328,227677,461,622005,SUNDAY,1,0,1.1,38,25.9,1007.4,Cloudy
2/18/2024 17:00,66,316,102775,211273,382,314048,SUNDAY,1,0,2.2,38,27.7,1006.2,Cloudy
2/18/2024 18:00,82,301,318147,190975,383,509122,SUNDAY,1,0,2.8,37,31.7,1005.6,Cloudy
2/18/2024 19:00,50,239,137673,147586,289,285259,SUNDAY,1,0,2.8,37,31.7,1005.6,Cloudy
2/18/2024 20:00,47,180,38026,110634,227,148660,SUNDAY,1,0,2.2,35,29.5,1005.6,Cloudy
2/18/2024 21:00,32,139,29860,82813,171,112673,SUNDAY,1,0,1.1,40,22.3,1006.5,Cloudy
2/18/2024 22:00,33,94,28107,57293,127,85400,SUNDAY,1,0,1.1,40,16.6,1007.1,Cloudy
2/18/2024 23:00,28,76,23743,59357,104,83100,SUNDAY,1,0,1.1,40,20.5,1008.1,Fair
2/19/2024 0:00,29,49,21586,33169,78,54755,MONDAY,0,1,1.1,40,20.5,1008.1,Fair
2/19/2024 1:00,8,16,4230,8826,24,13056,MONDAY,0,1,-0.6,49,14.8,1009.3,Fair
2/19/2024 2:00,8,16,10393,11077,24,21470,MONDAY,0,1,-0.6,49,14.8,1009.3,Fair
2/19/2024 3:00,0,7,0,5724,7,5724,MONDAY,0,1,-1.1,51,13,1009.5,Fair
2/19/2024 4:00,0,8,0,3571,8,3571,MONDAY,0,1,-1.1,51,20.5,1010.4,Clear
2/19/2024 5:00,5,22,4438,13851,27,18289,MONDAY,0,1,-1.1,51,20.5,1010.4,Fair
2/19/2024 6:00,9,56,26101,34666,65,60767,MONDAY,0,1,0.6,47,22.3,1010.8,Clear
2/19/2024 7:00,19,108,12233,67627,127,79860,MONDAY,0,1,0.6,47,22.3,1010.8,Clear
2/19/2024 8:00,34,237,53369,185335,271,238704,MONDAY,0,1,-1.1,53,20.5,1011.7,Clear
2/19/2024 9:00,41,247,41240,170223,288,211463,MONDAY,0,1,-2.2,60,24.1,1012.6,Clear
2/19/2024 10:00,66,263,92805,146378,329,239183,MONDAY,0,1,-0.6,56,16.6,1013.5,Clear
2/19/2024 11:00,87,300,590382,207588,387,797970,MONDAY,0,1,-0.6,56,16.6,1013.5,Fair
2/19/2024 12:00,118,373,415761,236357,491,652118,MONDAY,0,1,0,54,20.5,1016.1,Fair
2/19/2024 13:00,100,348,319255,245230,448,564485,MONDAY,0,1,1.7,36,25.9,1017.3,Fair
2/19/2024 14:00,101,363,272464,246420,464,518884,MONDAY,0,1,1.7,36,25.9,1017.3,Fair
2/19/2024 15:00,115,373,307605,246031,488,553636,MONDAY,0,1,1.7,40,27.7,1019,Fair
2/19/2024 16:00,120,442,468404,410808,562,879212,MONDAY,0,1,2.2,35,20.5,1019.2,Fair
2/19/2024 17:00,111,421,296353,261411,532,557764,MONDAY,0,1,2.2,25,27.7,1019.2,Fair
2/19/2024 18:00,47,386,31895,283507,433,315402,MONDAY,0,1,2.2,25,16.6,1019.4,Fair
2/19/2024 19:00,66,302,56931,166743,368,223674,MONDAY,0,1,2.2,23,16.6,1019.4,Fair
2/19/2024 20:00,43,222,26080,126447,265,152527,MONDAY,0,1,2.2,22,22.3,1020.1,Fair
2/19/2024 21:00,29,164,19951,101332,193,121283,MONDAY,0,1,1.7,18,16.6,1020.8,Fair
2/19/2024 22:00,27,106,64530,76785,133,141315,MONDAY,0,1,1.1,18,14.8,1022.1,Fair
2/19/2024 23:00,19,60,16893,90254,79,107147,MONDAY,0,1,0,21,18.4,1023.3,Fair
2/20/2024 0:00,6,33,2820,18008,39,20828,TUESDAY,0,0,0,21,18.4,1023.3,Clear
2/20/2024 1:00,3,13,1518,8745,16,10263,TUESDAY,0,0,-0.6,25,9.4,1025.1,Clear
2/20/2024 2:00,7,5,6136,2892,12,9028,TUESDAY,0,0,-1.7,30,18.4,1025.9,Clear
2/20/2024 3:00,4,6,68197,3380,10,71577,TUESDAY,0,0,-2.2,37,20.5,1026.4,Clear
2/20/2024 4:00,1,11,225,96201,12,96426,TUESDAY,0,0,-2.2,37,20.5,1026.4,Clear
2/20/2024 5:00,6,38,3420,25177,44,28597,TUESDAY,0,0,-3.3,42,20.5,1027.8,Clear
2/20/2024 6:00,15,133,10015,75944,148,85959,TUESDAY,0,0,-3.9,44,16.6,1028.3,Clear
2/20/2024 7:00,24,391,16888,269055,415,285943,TUESDAY,0,0,-5,43,16.6,1028.9,Clear
2/20/2024 8:00,68,822,52217,591126,890,643343,TUESDAY,0,0,-5.6,43,18.4,1029.2,Clear
2/20/2024 9:00,56,506,53804,317770,562,371574,TUESDAY,0,0,-6.1,45,20.5,1030,Clear
2/20/2024 10:00,38,283,69486,233126,321,302612,TUESDAY,0,0,-6.1,45,20.5,1030,Clear
2/20/2024 11:00,47,249,120904,155742,296,276646,TUESDAY,0,0,-6.7,47,9.4,1031.6,Cloudy
2/20/2024 12:00,67,328,54965,209683,395,264648,TUESDAY,0,0,-5.6,43,9.4,1032.8,Fair
2/20/2024 13:00,81,316,158672,281100,397,439772,TUESDAY,0,0,-3.9,36,9.4,1033.2,Fair
2/20/2024 14:00,76,262,59255,160244,338,219499,TUESDAY,0,0,-3.9,36,9.4,1033.2,Fair
2/20/2024 15:00,93,417,311257,274743,510,586000,TUESDAY,0,0,-1.7,36,5.4,1032.8,Fair
2/20/2024 16:00,102,630,270245,430189,732,700434,TUESDAY,0,0,-1.7,43,5.4,1032.4,Fair
2/20/2024 17:00,123,894,117105,677397,1017,794502,TUESDAY,0,0,-0.6,41,11.2,1032,Fair
2/20/2024 18:00,74,580,69432,467702,654,537134,TUESDAY,0,0,0,45,13,1031.6,Fair
2/20/2024 19:00,59,426,54138,279813,485,333951,TUESDAY,0,0,0,45,13,1031.6,Fair
2/20/2024 20:00,43,301,35341,191368,344,226709,TUESDAY,0,0,1.1,46,11.2,1031.5,Fair
2/20/2024 21:00,35,214,30383,141188,249,171571,TUESDAY,0,0,0.6,45,14.8,1031.8,Fair
2/20/2024 22:00,30,125,24204,73679,155,97883,TUESDAY,0,0,0.6,45,14.8,1031.8,Fair
2/20/2024 23:00,32,75,95607,41430,107,137037,TUESDAY,0,0,-0.6,58,14.8,1032.3,Fair
2/21/2024 0:00,5,37,5470,20327,42,25797,WEDNESDAY,0,0,-2.2,69,11.2,1033,Fair
2/21/2024 1:00,6,7,2200,4158,13,6358,WEDNESDAY,0,0,-2.2,69,11.2,1033.4,Clear
2/21/2024 2:00,3,16,3506,9649,19,13155,WEDNESDAY,0,0,-2.8,66,9.4,1033.7,Clear
2/21/2024 3:00,2,5,14099,2802,7,16901,WEDNESDAY,0,0,-2.8,66,16.6,1033.7,Clear
2/21/2024 4:00,1,14,437,8382,15,8819,WEDNESDAY,0,0,-2.8,66,16.6,1033.7,Clear
2/21/2024 5:00,7,51,4501,33958,58,38459,WEDNESDAY,0,0,-2.8,69,7.6,1033.7,Clear
2/21/2024 6:00,11,156,6202,98404,167,104606,WEDNESDAY,0,0,-3.3,68,9.4,1033.5,Clear
2/21/2024 7:00,43,418,34296,280327,461,314623,WEDNESDAY,0,0,-3.3,68,7.6,1033.1,Clear
2/21/2024 8:00,69,851,50281,717524,920,767805,WEDNESDAY,0,0,-3.3,68,7.6,1033.1,Clear
2/21/2024 9:00,66,494,102158,440079,560,542237,WEDNESDAY,0,0,-3.3,71,0,1033.2,Fair
2/21/2024 10:00,52,313,46802,191396,365,238198,WEDNESDAY,0,0,-3.3,68,11.2,1034.2,Clear
2/21/2024 11:00,55,346,145661,311037,401,456698,WEDNESDAY,0,0,-3.3,68,11.2,1034.2,Cloudy
2/21/2024 12:00,66,287,166690,193407,353,360097,WEDNESDAY,0,0,-2.2,63,7.6,1034.5,Fair
2/21/2024 13:00,97,337,117885,241015,434,358900,WEDNESDAY,0,0,-1.1,63,7.6,1034.8,Fair
2/21/2024 14:00,115,378,108342,241471,493,349813,WEDNESDAY,0,0,-1.1,63,7.6,1034.8,Fair
2/21/2024 15:00,128,441,170215,308501,569,478716,WEDNESDAY,0,0,1.1,54,5.4,1033.9,Fair
2/21/2024 16:00,159,655,225241,524483,814,749724,WEDNESDAY,0,0,1.7,56,7.6,1032.5,Cloudy
2/21/2024 17:00,176,914,424923,869928,1090,1294851,WEDNESDAY,0,0,2.2,54,9.4,1031.1,Cloudy
2/21/2024 18:00,109,620,102557,416777,729,519334,WEDNESDAY,0,0,2.2,54,9.4,1031.1,Cloudy
2/21/2024 19:00,76,401,151464,247409,477,398873,WEDNESDAY,0,0,2.2,59,20.5,1029.6,Cloudy
2/21/2024 20:00,44,299,39645,195576,343,235221,WEDNESDAY,0,0,1.7,64,22.3,1029.5,Cloudy
2/21/2024 21:00,34,193,26935,176725,227,203660,WEDNESDAY,0,0,1.1,67,25.9,1029.2,Cloudy
2/21/2024 22:00,33,121,116686,78297,154,194983,WEDNESDAY,0,0,0.6,69,24.1,1028.7,Cloudy
2/21/2024 23:00,12,77,7822,44865,89,52687,WEDNESDAY,0,0,0.6,69,24.1,1028.7,Cloudy
2/22/2024 0:00,6,49,5257,32665,55,37922,THURSDAY,0,0,-0.6,72,14.8,1028.2,Cloudy
2/22/2024 1:00,8,13,16678,9987,21,26665,THURSDAY,0,0,-0.6,72,13,1027.6,Cloudy
2/22/2024 2:00,1,3,236,4613,4,4849,THURSDAY,0,0,-1.1,75,16.6,1027,Cloudy
2/22/2024 3:00,4,5,23140,2128,9,25268,THURSDAY,0,0,-2.2,81,9.4,1026.2,Cloudy
2/22/2024 4:00,1,6,313,7529,7,7842,THURSDAY,0,0,-2.2,81,9.4,1026.2,Fair
2/22/2024 5:00,7,31,6527,23390,38,29917,THURSDAY,0,0,-1.7,75,7.6,1024.6,Fair
2/22/2024 6:00,13,147,8117,185288,160,193405,THURSDAY,0,0,-2.8,78,0,1024.2,Fair
2/22/2024 7:00,36,360,24696,252622,396,277318,THURSDAY,0,0,-2.8,78,0,1024.2,Fair
2/22/2024 8:00,94,742,82737,535600,836,618337,THURSDAY,0,0,-2.8,81,0,1022.2,Fair
2/22/2024 9:00,68,495,51864,302189,563,354053,THURSDAY,0,0,-2.8,81,0,1022.2,Fair
2/22/2024 10:00,59,298,187655,185463,357,373118,THURSDAY,0,0,-2.8,81,7.6,1021.4,Fair
2/22/2024 11:00,57,292,46598,187534,349,234132,THURSDAY,0,0,-3.9,92,11.2,1020.5,Fair
2/22/2024 12:00,91,373,145217,216318,464,361535,THURSDAY,0,0,-1.1,81,7.6,1020.1,Fair
2/22/2024 13:00,106,330,145687,209018,436,354705,THURSDAY,0,0,-1.1,81,7.6,1020.1,Fair
2/22/2024 14:00,95,404,105522,252970,499,358492,THURSDAY,0,0,1.1,69,14.8,1018.6,Fair
2/22/2024 15:00,112,446,121848,296579,558,418427,THURSDAY,0,0,1.7,66,18.4,1016.8,Fair
2/22/2024 16:00,159,676,169879,466123,835,636002,THURSDAY,0,0,2.8,61,13,1015.2,Fair
2/22/2024 17:00,173,910,170092,750652,1083,920744,THURSDAY,0,0,3.9,57,14.8,1013.5,Fair
2/22/2024 18:00,113,638,107063,416400,751,523463,THURSDAY,0,0,3.9,57,14.8,1013.5,Cloudy
2/22/2024 19:00,83,485,68451,336431,568,404882,THURSDAY,0,0,3.9,67,18.4,1011.4,Cloudy
2/22/2024 20:00,72,335,74755,207170,407,281925,THURSDAY,0,0,6.1,51,22.3,1010.7,Cloudy
2/22/2024 21:00,45,235,126425,152416,280,278841,THURSDAY,0,0,5,60,22.3,1009.8,Cloudy
2/22/2024 22:00,37,175,31880,105864,212,137744,THURSDAY,0,0,3.9,64,20.5,1009.6,Cloudy
2/22/2024 23:00,15,97,8995,56178,112,65173,THURSDAY,0,0,2.8,70,22.3,1009.6,Cloudy
2/23/2024 0:00,13,37,10236,22326,50,32562,FRIDAY,0,0,1.7,82,18.4,1009.2,Cloudy
2/23/2024 1:00,10,26,9410,13987,36,23397,FRIDAY,0,0,1.7,82,18.4,1009.2,Cloudy
2/23/2024 2:00,15,8,101047,6063,23,107110,FRIDAY,0,0,2.2,82,20.5,1008,Cloudy
2/23/2024 3:00,3,3,1885,1287,6,3172,FRIDAY,0,0,2.2,85,18.4,1007.4,Cloudy
2/23/2024 4:00,3,9,4193,3391,12,7584,FRIDAY,0,0,2.2,85,18.4,1007.4,Cloudy
2/23/2024 5:00,9,33,9527,20484,42,30011,FRIDAY,0,0,2.2,85,16.6,1005.9,Rain
2/23/2024 6:00,7,101,4251,63738,108,67989,FRIDAY,0,0,2.8,82,14.8,1005.2,Rain
2/23/2024 7:00,25,221,17579,148818,246,166397,FRIDAY,0,0,2.8,78,14.8,1004.6,Rain
2/23/2024 8:00,39,484,115879,325472,523,441351,FRIDAY,0,0,2.8,78,14.8,1004.6,Rain
2/23/2024 9:00,59,410,54200,251821,469,306021,FRIDAY,0,0,2.8,76,11.2,1003,Rain
2/23/2024 10:00,51,266,123014,160676,317,283690,FRIDAY,0,0,2.8,76,11.2,1003,Rain
2/23/2024 11:00,63,307,63705,186331,370,250036,FRIDAY,0,0,3.3,79,0,1001.6,Rain
2/23/2024 12:00,63,310,65696,189536,373,255232,FRIDAY,0,0,3.3,76,7.6,1001.4,Rain
2/23/2024 13:00,91,363,191570,210220,454,401790,FRIDAY,0,0,3.9,76,7.6,1000.9,Rain
2/23/2024 14:00,105,329,130469,267274,434,397743,FRIDAY,0,0,3.9,76,7.6,1000.9,Rain
2/23/2024 15:00,108,432,119343,356741,540,476084,FRIDAY,0,0,3.9,76,13,1000.1,Cloudy
2/23/2024 16:00,159,564,171952,396872,723,568824,FRIDAY,0,0,4.4,73,7.6,999.6,Cloudy
2/23/2024 17:00,183,701,280730,499548,884,780278,FRIDAY,0,0,4.4,73,7.6,998.9,Cloudy
2/23/2024 18:00,129,566,120519,375565,695,496084,FRIDAY,0,0,4.4,73,7.6,998.3,Cloudy
2/23/2024 19:00,98,518,95804,465295,616,561099,FRIDAY,0,0,5.6,67,9.4,998,Cloudy
2/23/2024 20:00,90,325,112459,300281,415,412740,FRIDAY,0,0,5.6,67,9.4,998,Cloudy
2/23/2024 21:00,80,248,91547,202816,328,294363,FRIDAY,0,0,4.4,73,9.4,997.7,Cloudy
2/23/2024 22:00,96,197,94951,122406,293,217357,FRIDAY,0,0,3.9,76,7.6,997.5,Cloudy
2/23/2024 23:00,72,126,209428,125599,198,335027,FRIDAY,0,0,3.9,76,7.6,997.5,Cloudy
2/24/2024 0:00,57,122,132503,84639,179,217142,SATURDAY,1,0,4.4,68,9.4,997.9,Cloudy
2/24/2024 1:00,78,85,122164,76791,163,198955,SATURDAY,1,0,3.9,68,9.4,997.5,Cloudy
2/24/2024 2:00,48,37,51269,23248,85,74517,SATURDAY,1,0,3.9,70,9.4,997.5,Cloudy
2/24/2024 3:00,15,16,59186,13496,31,72682,SATURDAY,1,0,3.9,89,5.4,997.2,Cloudy
2/24/2024 4:00,4,17,5706,15927,21,21633,SATURDAY,1,0,3.9,96,11.2,996.7,Cloudy
2/24/2024 5:00,4,29,3293,21575,33,24868,SATURDAY,1,0,3.3,100,14.8,996.1,Cloudy
2/24/2024 6:00,10,40,7667,27242,50,34909,SATURDAY,1,0,3.3,100,14.8,996.1,Cloudy
2/24/2024 7:00,27,90,25954,69906,117,95860,SATURDAY,1,0,3.3,97,13,996.3,Cloudy
2/24/2024 8:00,31,198,33609,110581,229,144190,SATURDAY,1,0,3.3,97,13,996.3,Cloudy
2/24/2024 9:00,76,296,88512,188858,372,277370,SATURDAY,1,0,3.3,89,22.3,997.6,Cloudy
2/24/2024 10:00,114,377,307879,241117,491,548996,SATURDAY,1,0,3.3,86,14.8,997.9,Cloudy
2/24/2024 11:00,117,377,212914,257763,494,470677,SATURDAY,1,0,3.9,82,14.8,998.3,Cloudy
2/24/2024 12:00,177,401,279819,255711,578,535530,SATURDAY,1,0,3.9,82,24.1,999.5,Cloudy
2/24/2024 13:00,170,469,297752,331940,639,629692,SATURDAY,1,0,3.9,82,24.1,999.5,Cloudy
2/24/2024 14:00,179,489,384497,352157,668,736654,SATURDAY,1,0,2.8,70,24.1,1002.1,Cloudy
2/24/2024 15:00,188,456,236060,341377,644,577437,SATURDAY,1,0,2.2,64,24.1,1002.6,Cloudy
2/24/2024 16:00,184,457,238649,310261,641,548910,SATURDAY,1,0,2.8,54,29.5,1002.5,Cloudy
2/24/2024 17:00,160,424,232893,294377,584,527270,SATURDAY,1,0,2.8,54,27.7,1002.5,Cloudy
2/24/2024 18:00,112,394,185345,278573,506,463918,SATURDAY,1,0,2.8,46,29.5,1003.9,Cloudy
2/24/2024 19:00,86,286,77796,186378,372,264174,SATURDAY,1,0,3.9,46,20.5,1004.4,Fair
2/24/2024 20:00,58,204,50130,122860,262,172990,SATURDAY,1,0,2.8,48,20.5,1005.6,Fair
2/24/2024 21:00,35,176,30267,110767,211,141034,SATURDAY,1,0,1.1,46,20.5,1007.1,Fair
2/24/2024 22:00,37,130,27279,143363,167,170642,SATURDAY,1,0,1.1,43,25.9,1007.1,Cloudy
2/24/2024 23:00,42,93,36098,60400,135,96498,SATURDAY,1,0,-1.7,41,24.1,1010.2,Fair
2/25/2024 0:00,39,67,65056,40845,106,105901,SUNDAY,1,0,-3.3,42,24.1,1012,Fair
2/25/2024 1:00,44,44,133285,64889,88,198174,SUNDAY,1,0,-4.4,40,24.1,1013.4,Clear
2/25/2024 2:00,14,35,10540,22268,49,32808,SUNDAY,1,0,-5.6,40,31.7,1014.3,Clear
2/25/2024 3:00,8,5,3410,2950,13,6360,SUNDAY,1,0,-5.6,40,25.9,1014.3,Clear
2/25/2024 4:00,5,10,5252,7440,15,12692,SUNDAY,1,0,-6.7,36,24.1,1015.9,Clear
2/25/2024 5:00,2,12,1994,7952,14,9946,SUNDAY,1,0,-7.2,35,18.4,1016.5,Clear
2/25/2024 6:00,5,21,5474,15459,26,20933,SUNDAY,1,0,-7.8,37,18.4,1017.3,Clear
2/25/2024 7:00,15,64,10788,83895,79,94683,SUNDAY,1,0,-8.3,37,13,1017.9,Clear
2/25/2024 8:00,22,111,76053,133695,133,209748,SUNDAY,1,0,-8.3,37,13,1017.9,Clear
2/25/2024 9:00,54,202,46894,204658,256,251552,SUNDAY,1,0,-8.3,42,11.2,1019.2,Clear
2/25/2024 10:00,63,267,74845,152240,330,227085,SUNDAY,1,0,-8.3,42,13,1019.9,Clear
2/25/2024 11:00,129,331,245845,264391,460,510236,SUNDAY,1,0,-8.3,42,7.6,1020.6,Fair
2/25/2024 12:00,106,387,113503,268709,493,382212,SUNDAY,1,0,-6.7,41,9.4,1021.2,Fair
2/25/2024 13:00,135,381,160577,279331,516,439908,SUNDAY,1,0,-6.7,41,9.4,1021.2,Fair
2/25/2024 14:00,146,405,205005,291433,551,496438,SUNDAY,1,0,-4.4,40,7.6,1021.2,Fair
2/25/2024 15:00,163,392,380623,287217,555,667840,SUNDAY,1,0,-2.8,41,13,1020.5,Fair
2/25/2024 16:00,151,380,180681,274284,531,454965,SUNDAY,1,0,-1.1,41,5.4,1020.1,Fair
2/25/2024 17:00,105,365,311944,259456,470,571400,SUNDAY,1,0,-1.1,41,5.4,1020.1,Fair
2/25/2024 18:00,96,366,97792,267959,462,365751,SUNDAY,1,0,0.6,41,9.4,1018.7,Fair
2/25/2024 19:00,54,222,61743,131591,276,193334,SUNDAY,1,0,0.6,41,9.4,1018.4,Fair
2/25/2024 20:00,28,186,22701,109035,214,131736,SUNDAY,1,0,-0.6,45,20.5,1018.5,Fair
2/25/2024 21:00,27,161,17402,88997,188,106399,SUNDAY,1,0,0,56,18.4,1018.1,Fair
2/25/2024 22:00,19,75,13091,40716,94,53807,SUNDAY,1,0,0,58,18.4,1018.1,Cloudy
2/25/2024 23:00,21,50,43412,22786,71,66198,SUNDAY,1,0,0,43,22.3,1018.4,Fair
2/26/2024 0:00,9,33,5187,21805,42,26992,MONDAY,0,0,-1.7,53,20.5,1018.5,Fair
2/26/2024 1:00,13,10,34437,3251,23,37688,MONDAY,0,0,-1.7,56,25.9,1018.7,Fair
2/26/2024 2:00,2,9,1550,3250,11,4800,MONDAY,0,0,-1.7,53,18.4,1018.5,Fair
2/26/2024 3:00,1,7,2624,4479,8,7103,MONDAY,0,0,-1.7,53,18.4,1018.5,Clear
2/26/2024 4:00,2,13,847,8137,15,8984,MONDAY,0,0,-1.7,63,20.5,1018,Clear
2/26/2024 5:00,8,53,4447,35040,61,39487,MONDAY,0,0,-1.7,69,20.5,1017.6,Fair
2/26/2024 6:00,19,159,10326,96368,178,106694,MONDAY,0,0,-1.1,69,22.3,1017.6,Fair
2/26/2024 7:00,35,458,24824,341601,493,366425,MONDAY,0,0,-1.1,69,22.3,1017.6,Cloudy
2/26/2024 8:00,53,834,42940,583473,887,626413,MONDAY,0,0,0.6,78,25.9,1016.4,Cloudy
2/26/2024 9:00,49,482,39201,393402,531,432603,MONDAY,0,0,0.6,78,25.9,1016.1,Cloudy
2/26/2024 10:00,57,292,62249,280548,349,342797,MONDAY,0,0,1.1,75,25.9,1016.2,Cloudy
2/26/2024 11:00,77,300,94539,182826,377,277365,MONDAY,0,0,1.1,79,20.5,1016.3,Cloudy
2/26/2024 12:00,95,343,97668,218657,438,316325,MONDAY,0,0,1.1,79,20.5,1016.3,Cloudy
2/26/2024 13:00,89,344,114663,215535,433,330198,MONDAY,0,0,3.3,67,18.4,1016.3,Cloudy
2/26/2024 14:00,134,384,191588,238814,518,430402,MONDAY,0,0,4.4,65,22.3,1016.3,Cloudy
2/26/2024 15:00,138,471,210720,327784,609,538504,MONDAY,0,0,7.8,53,22.3,1015.4,Cloudy
2/26/2024 16:00,153,763,177642,581484,916,759126,MONDAY,0,0,9.4,54,18.4,1015.3,Cloudy
2/26/2024 17:00,191,1035,385458,820858,1226,1206316,MONDAY,0,0,9.4,54,18.4,1015.3,Cloudy
2/26/2024 18:00,135,669,143170,451600,804,594770,MONDAY,0,0,12.2,53,25.9,1013.1,Fair
2/26/2024 19:00,98,475,90522,290548,573,381070,MONDAY,0,0,12.8,52,33.5,1012.9,Fair
2/26/2024 20:00,71,345,58478,217127,416,275605,MONDAY,0,0,12.2,53,33.5,1013.3,Fair
2/26/2024 21:00,55,213,42812,138226,268,181038,MONDAY,0,0,11.7,52,27.7,1013.8,Fair
2/26/2024 22:00,41,144,38194,85027,185,123221,MONDAY,0,0,10,58,20.5,1014.5,Cloudy
2/26/2024 23:00,23,83,17692,45516,106,63208,MONDAY,0,0,10,58,20.5,1014.5,Fair
2/27/2024 0:00,6,33,8606,17593,39,26199,TUESDAY,0,0,7.8,65,18.4,1016.1,Fair
2/27/2024 1:00,6,13,4830,16383,19,21213,TUESDAY,0,0,6.7,70,13,1017.3,Fair
2/27/2024 2:00,1,14,539,13649,15,14188,TUESDAY,0,0,6.1,73,13,1018.4,Fair
2/27/2024 3:00,1,15,1194,8883,16,10077,TUESDAY,0,0,6.1,73,13,1018.4,Fair
2/27/2024 4:00,2,10,3193,5870,12,9063,TUESDAY,0,0,2.8,89,13,1018.7,Fair
2/27/2024 5:00,16,51,10222,34955,67,45177,TUESDAY,0,0,2.2,92,0,1018.9,Fair
2/27/2024 6:00,28,211,24327,168857,239,193184,TUESDAY,0,0,2.2,92,0,1019.1,Fair
2/27/2024 7:00,79,565,75583,432022,644,507605,TUESDAY,0,0,2.2,92,0,1019.1,Fair
2/27/2024 8:00,122,1030,122507,755136,1152,877643,TUESDAY,0,0,1.1,97,9.4,1019.1,Fair
2/27/2024 9:00,84,636,92285,475887,720,568172,TUESDAY,0,0,-0.6,100,9.4,1019.5,Fair
2/27/2024 10:00,71,314,97718,225487,385,323205,TUESDAY,0,0,-0.6,100,9.4,1019.5,Clear
2/27/2024 11:00,82,349,306848,234023,431,540871,TUESDAY,0,0,-0.6,100,9.4,1019.5,Cloudy
2/27/2024 12:00,109,405,131959,254838,514,386797,TUESDAY,0,0,1.7,96,9.4,1020.2,Cloudy
2/27/2024 13:00,112,407,138685,312063,519,450748,TUESDAY,0,0,1.7,96,9.4,1020.2,Fair
2/27/2024 14:00,133,392,161543,255430,525,416973,TUESDAY,0,0,3.9,82,7.6,1020.3,Fair
2/27/2024 15:00,187,551,318980,377306,738,696286,TUESDAY,0,0,6.1,79,9.4,1019.6,Fair
2/27/2024 16:00,204,850,237469,646042,1054,883511,TUESDAY,0,0,7.8,73,7.6,1018.5,Fair
2/27/2024 17:00,283,1128,352430,849419,1411,1201849,TUESDAY,0,0,7.8,73,7.6,1018.5,Fair
2/27/2024 18:00,173,770,256884,585744,943,842628,TUESDAY,0,0,5.6,82,14.8,1016.8,Fair
2/27/2024 19:00,95,516,91706,342678,611,434384,TUESDAY,0,0,6.1,89,13,1016.5,Fair
2/27/2024 20:00,86,349,70377,257512,435,327889,TUESDAY,0,0,5.6,89,9.4,1016.1,Fair
2/27/2024 21:00,86,259,158910,186922,345,345832,TUESDAY,0,0,5,93,5.4,1015.3,Fair
2/27/2024 22:00,60,182,56221,204029,242,260250,TUESDAY,0,0,5,93,5.4,1015.3,Cloudy
2/27/2024 23:00,16,50,20437,24549,66,44986,TUESDAY,0,0,9.4,77,24.1,1014.7,Cloudy
2/28/2024 0:00,6,26,27714,16650,32,44364,WEDNESDAY,0,0,9.4,83,22.3,1014.9,Cloudy
2/28/2024 1:00,6,15,3086,9357,21,12443,WEDNESDAY,0,0,11.1,89,24.1,1015.1,Cloudy
2/28/2024 2:00,2,13,1035,12447,15,13482,WEDNESDAY,0,0,11.1,89,24.1,1015.1,Rain
2/28/2024 3:00,1,3,373,2258,4,2631,WEDNESDAY,0,0,10,96,13,1015,Rain
2/28/2024 4:00,3,14,3892,7851,17,11743,WEDNESDAY,0,0,10.6,92,16.6,1014.5,Rain
2/28/2024 5:00,9,45,6465,27368,54,33833,WEDNESDAY,0,0,11.1,97,25.9,1012.3,Rain
2/28/2024 6:00,16,149,10924,99634,165,110558,WEDNESDAY,0,0,11.1,97,37.1,1011.7,Rain
2/28/2024 7:00,31,267,115445,208850,298,324295,WEDNESDAY,0,0,11.1,97,29.5,1011.7,Rain
2/28/2024 8:00,61,558,49661,459380,619,509041,WEDNESDAY,0,0,11.1,97,31.7,1010.6,Rain
2/28/2024 9:00,49,451,31356,275246,500,306602,WEDNESDAY,0,0,11.1,97,31.7,1010.7,Rain
2/28/2024 10:00,49,316,41380,175603,365,216983,WEDNESDAY,0,0,10.6,96,25.9,1010,Rain
2/28/2024 11:00,31,278,23855,155473,309,179328,WEDNESDAY,0,0,11.1,100,31.7,1009.1,Rain
2/28/2024 12:00,30,217,29638,124680,247,154318,WEDNESDAY,0,0,11.1,100,31.7,1009.1,Rain
2/28/2024 13:00,60,304,64763,161275,364,226038,WEDNESDAY,0,0,12.2,97,31.7,1007.6,Cloudy
2/28/2024 14:00,83,323,101303,206062,406,307365,WEDNESDAY,0,0,12.2,97,31.7,1007.1,Cloudy
2/28/2024 15:00,109,400,204315,250704,509,455019,WEDNESDAY,0,0,12.2,97,35.3,1006.2,Rain
2/28/2024 16:00,118,671,113928,472547,789,586475,WEDNESDAY,0,0,12.2,97,35.3,1006.2,Rain
2/28/2024 17:00,159,910,239943,736742,1069,976685,WEDNESDAY,0,0,12.2,100,42.5,1004.9,Rain
2/28/2024 18:00,144,656,131384,528861,800,660245,WEDNESDAY,0,0,12.2,97,27.7,1003.5,Rain
2/28/2024 19:00,84,435,74229,306317,519,380546,WEDNESDAY,0,0,12.2,97,27.7,1003.5,Rain
2/28/2024 20:00,57,311,44718,193694,368,238412,WEDNESDAY,0,0,12.2,93,33.5,1002.1,Rain
2/28/2024 21:00,48,244,41422,160920,292,202342,WEDNESDAY,0,0,12.8,89,31.7,1001.5,Rain
2/28/2024 22:00,21,140,17283,86447,161,103730,WEDNESDAY,0,0,12.2,93,40.7,1000.6,Rain
2/28/2024 23:00,2,42,2605,25761,44,28366,WEDNESDAY,0,0,11.7,93,33.5,999.9,Rain
2/29/2024 0:00,3,17,2952,9888,20,12840,THURSDAY,0,0,11.1,93,37.1,997.7,Rain
2/29/2024 1:00,1,11,479,4752,12,5231,THURSDAY,0,0,12.2,90,38.9,998.4,Rain
2/29/2024 2:00,4,2,1517,2026,6,3543,THURSDAY,0,0,12.2,90,38.9,998.4,Rain
2/29/2024 3:00,1,7,2650,3940,8,6590,THURSDAY,0,0,12.8,89,37.1,996.7,Rain
2/29/2024 4:00,1,11,1062,6327,12,7389,THURSDAY,0,0,8.9,89,44.6,1002,Rain
2/29/2024 5:00,6,44,2849,27420,50,30269,THURSDAY,0,0,2.8,85,48.2,1002.1,Rain
2/29/2024 6:00,9,147,10398,90923,156,101321,THURSDAY,0,0,1.7,82,29.5,1005.3,Snow
2/29/2024 7:00,52,460,40623,326022,512,366645,THURSDAY,0,0,1.7,54,46.4,1005.3,Rain
2/29/2024 8:00,90,878,65206,590564,968,655770,THURSDAY,0,0,-1.1,47,33.5,1010.3,Cloudy
2/29/2024 9:00,54,491,56080,381540,545,437620,THURSDAY,0,0,-1.7,45,25.9,1012.8,Fair
2/29/2024 10:00,41,284,35491,156017,325,191508,THURSDAY,0,0,-2.8,41,38.9,1015.2,Cloudy
2/29/2024 11:00,44,279,35605,168302,323,203907,THURSDAY,0,0,-2.8,41,38.9,1015.2,Fair
2/29/2024 12:00,35,330,27243,189391,365,216634,THURSDAY,0,0,-2.2,39,24.1,1019.2,Fair
2/29/2024 13:00,60,309,65974,196678,369,262652,THURSDAY,0,0,-1.7,37,24.1,1020.3,Fair
2/29/2024 14:00,64,306,50016,174534,370,224550,THURSDAY,0,0,-0.6,39,38.9,1021.1,Fair
2/29/2024 15:00,77,361,56218,226790,438,283008,THURSDAY,0,0,-0.6,39,31.7,1021.2,Fair
2/29/2024 16:00,106,645,175869,451988,751,627857,THURSDAY,0,0,0.6,39,31.7,1021.1,Fair
2/29/2024 17:00,122,864,117280,595926,986,713206,THURSDAY,0,0,0.6,39,38.9,1021.1,Fair
2/29/2024 18:00,81,609,84137,425750,690,509887,THURSDAY,0,0,0,39,33.5,1020.6,Fair
2/29/2024 19:00,63,405,130106,240996,468,371102,THURSDAY,0,0,0.6,41,38.9,1020.8,Fair
2/29/2024 20:00,41,270,30233,170506,311,200739,THURSDAY,0,0,0,39,38.9,1021.8,Fair
2/29/2024 21:00,31,206,19605,121359,237,140964,THURSDAY,0,0,0,39,31.7,1021.8,Fair
2/29/2024 22:00,29,129,22163,84705,158,106868,THURSDAY,0,0,-1.7,41,25.9,1023.8,Fair
2/29/2024 23:00,19,86,11293,46120,105,57413,THURSDAY,0,0,-1.7,37,25.9,1025.2,Fair
3/1/2024 0:00,3,26,1525,11914,29,13439,FRIDAY,0,0,-2.2,39,29.5,1025.9,Fair
3/1/2024 1:00,21,11,22946,6623,32,29569,FRIDAY,0,0,-2.2,39,29.5,1025.9,Fair
3/1/2024 2:00,6,13,6550,6748,19,13298,FRIDAY,0,0,-2.8,39,22.3,1027.4,Clear
3/1/2024 3:00,1,5,4482,5566,6,10048,FRIDAY,0,0,-2.8,41,22.3,1028.1,Clear
3/1/2024 4:00,1,15,190,9998,16,10188,FRIDAY,0,0,-2.8,41,29.5,1028.1,Clear
3/1/2024 5:00,6,38,4556,26409,44,30965,FRIDAY,0,0,-3.3,37,20.5,1029.7,Clear
3/1/2024 6:00,18,130,10603,80757,148,91360,FRIDAY,0,0,-3.3,37,27.7,1029.7,Clear
3/1/2024 7:00,49,341,44029,318545,390,362574,FRIDAY,0,0,-4.4,40,14.8,1031.1,Clear
3/1/2024 8:00,86,616,74040,410569,702,484609,FRIDAY,0,0,-5,39,16.6,1032.4,Clear
3/1/2024 9:00,47,418,47445,251803,465,299248,FRIDAY,0,0,-5,39,16.6,1033.4,Clear
3/1/2024 10:00,46,315,41276,197720,361,238996,FRIDAY,0,0,-5,43,11.2,1034.2,Cloudy
3/1/2024 11:00,62,356,53768,222228,418,275996,FRIDAY,0,0,-4.4,41,11.2,1035.3,Fair
3/1/2024 12:00,73,389,80623,244761,462,325384,FRIDAY,0,0,-4.4,41,11.2,1035.3,Fair
3/1/2024 13:00,84,403,96264,272478,487,368742,FRIDAY,0,0,-2.2,39,18.4,1036.2,Fair
3/1/2024 14:00,107,412,140989,261232,519,402221,FRIDAY,0,0,-0.6,39,22.3,1036.1,Fair
3/1/2024 15:00,148,477,142453,392762,625,535215,FRIDAY,0,0,-0.6,39,22.3,1036.1,Fair
3/1/2024 16:00,194,608,230937,437809,802,668746,FRIDAY,0,0,2.2,42,24.1,1035.2,Fair
3/1/2024 17:00,174,762,202348,551549,936,753897,FRIDAY,0,0,3.3,44,24.1,1034.4,Fair
3/1/2024 18:00,127,574,211101,451727,701,662828,FRIDAY,0,0,4.4,44,27.7,1033.7,Fair
3/1/2024 19:00,102,410,221102,287924,512,509026,FRIDAY,0,0,5,45,22.3,1033.5,Fair
3/1/2024 20:00,87,262,211351,162865,349,374216,FRIDAY,0,0,5,45,22.3,1033.5,Fair
3/1/2024 21:00,58,223,102902,145273,281,248175,FRIDAY,0,0,5.6,43,18.4,1033.2,Fair
3/1/2024 22:00,67,199,63990,130279,266,194269,FRIDAY,0,0,4.4,44,13,1033.8,Fair
3/1/2024 23:00,42,100,37131,65445,142,102576,FRIDAY,0,0,3.9,44,24.1,1034.4,Fair
3/2/2024 0:00,55,96,59253,56575,151,115828,SATURDAY,1,0,3.9,44,24.1,1034.4,Fair
3/2/2024 1:00,56,60,139489,35678,116,175167,SATURDAY,1,0,2.2,52,20.5,1034,Fair
3/2/2024 2:00,20,32,47718,120614,52,168332,SATURDAY,1,0,2.2,52,20.5,1034,Fair
3/2/2024 3:00,13,16,10582,10599,29,21181,SATURDAY,1,0,1.1,64,18.4,1034,Fair
3/2/2024 4:00,6,9,7866,9056,15,16922,SATURDAY,1,0,1.1,61,20.5,1034,Cloudy
3/2/2024 5:00,11,21,8232,14953,32,23185,SATURDAY,1,0,1.1,64,22.3,1033.8,Cloudy
3/2/2024 6:00,6,30,3208,22023,36,25231,SATURDAY,1,0,1.1,64,22.3,1033.8,Cloudy
3/2/2024 7:00,23,83,20721,55510,106,76231,SATURDAY,1,0,1.1,69,13,1033.1,Cloudy
3/2/2024 8:00,49,179,128935,112275,228,241210,SATURDAY,1,0,1.7,72,13,1033,Cloudy
3/2/2024 9:00,90,308,99113,209486,398,308599,SATURDAY,1,0,2.8,72,14.8,1033.3,Cloudy
3/2/2024 10:00,129,381,145243,257317,510,402560,SATURDAY,1,0,2.8,78,13,1033.6,Cloudy
3/2/2024 11:00,156,414,298427,309038,570,607465,SATURDAY,1,0,2.8,78,13,1033.6,Cloudy
3/2/2024 12:00,180,462,237816,342795,642,580611,SATURDAY,1,0,3.3,83,11.2,1033.1,Cloudy
3/2/2024 13:00,133,402,199706,291582,535,491288,SATURDAY,1,0,4.4,76,11.2,1032.8,Cloudy
3/2/2024 14:00,95,364,300681,248579,459,549260,SATURDAY,1,0,5.6,79,13,1032.3,Cloudy
3/2/2024 15:00,90,264,192063,169910,354,361973,SATURDAY,1,0,6.7,76,9.4,1031.4,Cloudy
3/2/2024 16:00,69,226,75675,157569,295,233244,SATURDAY,1,0,6.7,76,9.4,1031.4,Cloudy
3/2/2024 17:00,39,180,36113,114743,219,150856,SATURDAY,1,0,5.6,85,11.2,1031,Rain
3/2/2024 18:00,28,158,27858,105618,186,133476,SATURDAY,1,0,6.7,93,9.4,1029.1,Rain
3/2/2024 19:00,26,96,24989,59944,122,84933,SATURDAY,1,0,6.1,100,11.2,1028.5,Rain
3/2/2024 20:00,26,88,25601,52969,114,78570,SATURDAY,1,0,6.1,100,11.2,1028.5,Rain
3/2/2024 21:00,10,36,11862,22822,46,34684,SATURDAY,1,0,5.6,100,11.2,1027.1,Rain
3/2/2024 22:00,11,23,6749,11780,34,18529,SATURDAY,1,0,5.6,100,11.2,1027.1,Rain
3/2/2024 23:00,10,24,6422,12588,34,19010,SATURDAY,1,0,5.6,100,14.8,1026.6,Rain
3/3/2024 0:00,12,50,10625,45670,62,56295,SUNDAY,1,0,5.6,100,13,1026.1,Rain
3/3/2024 1:00,32,39,129364,32938,71,162302,SUNDAY,1,0,5.6,100,13,1025.3,Rain
3/3/2024 2:00,16,24,89196,20934,40,110130,SUNDAY,1,0,5.6,100,13,1024.2,Rain
3/3/2024 3:00,2,7,950,4588,9,5538,SUNDAY,1,0,6.7,100,20.5,1022.3,Rain
3/3/2024 4:00,9,7,5490,4267,16,9757,SUNDAY,1,0,6.7,100,18.4,1020.6,Rain
3/3/2024 5:00,2,16,2325,9663,18,11988,SUNDAY,1,0,8.9,100,11.2,1020.2,Rain
3/3/2024 6:00,12,31,7174,17872,43,25046,SUNDAY,1,0,8.3,100,14.8,1017.8,Rain
3/3/2024 7:00,11,76,8877,46525,87,55402,SUNDAY,1,0,8.3,100,14.8,1017.8,Rain
3/3/2024 8:00,33,146,34741,92410,179,127151,SUNDAY,1,0,7.2,100,0,1017.3,Cloudy
3/3/2024 9:00,68,249,67420,163294,317,230714,SUNDAY,1,0,7.2,100,0,1017.3,Cloudy
3/3/2024 10:00,98,306,204519,217930,404,422449,SUNDAY,1,0,6.7,100,5.4,1017,Cloudy
3/3/2024 11:00,156,369,225570,268246,525,493816,SUNDAY,1,0,7.8,100,14.8,1017.9,Cloudy
3/3/2024 12:00,214,486,453152,398103,700,851255,SUNDAY,1,0,7.8,100,14.8,1017.9,Cloudy
3/3/2024 13:00,234,505,529122,375875,739,904997,SUNDAY,1,0,7.8,96,18.4,1019.3,Cloudy
3/3/2024 14:00,308,511,633780,442683,819,1076463,SUNDAY,1,0,7.8,96,18.4,1019.8,Cloudy
3/3/2024 15:00,254,521,515482,412445,775,927927,SUNDAY,1,0,7.8,96,18.4,1019.8,Cloudy
3/3/2024 16:00,327,561,757594,464721,888,1222315,SUNDAY,1,0,11.1,80,20.5,1019.5,Cloudy
3/3/2024 17:00,311,563,528901,438229,874,967130,SUNDAY,1,0,11.7,74,22.3,1019.3,Cloudy
3/3/2024 18:00,183,439,223235,392360,622,615595,SUNDAY,1,0,12.8,69,22.3,1019.5,Cloudy
3/3/2024 19:00,127,314,160178,204176,441,364354,SUNDAY,1,0,13.9,67,24.1,1019.7,Cloudy
3/3/2024 20:00,82,248,100401,149502,330,249903,SUNDAY,1,0,13.9,67,24.1,1019.7,Cloudy
3/3/2024 21:00,65,201,83560,121191,266,204751,SUNDAY,1,0,13.3,72,14.8,1020.6,Cloudy
3/3/2024 22:00,61,149,138387,88253,210,226640,SUNDAY,1,0,12.2,77,7.6,1021.9,Cloudy
3/3/2024 23:00,53,77,103693,52145,130,155838,SUNDAY,1,0,12.2,77,0,1023,Cloudy
3/4/2024 0:00,19,38,43967,23592,57,67559,MONDAY,0,0,8.3,93,0,1023,Cloudy
3/4/2024 1:00,23,29,46487,17255,52,63742,MONDAY,0,0,8.9,89,7.6,1023.7,Cloudy
3/4/2024 2:00,7,6,14270,2823,13,17093,MONDAY,0,0,10,86,5.4,1024.4,Cloudy
3/4/2024 3:00,8,7,30247,2795,15,33042,MONDAY,0,0,10,86,5.4,1024.4,Cloudy
3/4/2024 4:00,2,13,1032,8181,15,9213,MONDAY,0,0,8.9,89,0,1025,Cloudy
3/4/2024 5:00,12,41,8034,25400,53,33434,MONDAY,0,0,10.6,83,18.4,1025.5,Cloudy
3/4/2024 6:00,22,199,14259,165679,221,179938,MONDAY,0,0,8.3,90,11.2,1025.7,Cloudy
3/4/2024 7:00,56,494,46411,354004,550,400415,MONDAY,0,0,8.9,86,14.8,1026.3,Cloudy
3/4/2024 8:00,104,892,206255,693792,996,900047,MONDAY,0,0,7.2,90,11.2,1027.1,Cloudy
3/4/2024 9:00,76,470,78126,322372,546,400498,MONDAY,0,0,7.8,93,11.2,1028.1,Cloudy
3/4/2024 10:00,59,280,100114,290698,339,390812,MONDAY,0,0,7.8,93,11.2,1028.1,Cloudy
3/4/2024 11:00,61,272,100152,194771,333,294923,MONDAY,0,0,8.3,90,16.6,1029.6,Cloudy
3/4/2024 12:00,93,321,147869,188244,414,336113,MONDAY,0,0,8.9,83,20.5,1029.9,Cloudy
3/4/2024 13:00,71,311,70750,209532,382,280282,MONDAY,0,0,8.9,83,20.5,1030.9,Cloudy
3/4/2024 14:00,97,332,114939,222423,429,337362,MONDAY,0,0,8.9,83,20.5,1030.9,Cloudy
3/4/2024 15:00,104,448,178268,323395,552,501663,MONDAY,0,0,6.7,93,20.5,1031.9,Cloudy
3/4/2024 16:00,118,731,127397,460419,849,587816,MONDAY,0,0,7.2,93,13,1031.8,Cloudy
3/4/2024 17:00,121,802,215500,643453,923,858953,MONDAY,0,0,7.2,93,13,1031.8,Cloudy
3/4/2024 18:00,74,554,72444,550414,628,622858,MONDAY,0,0,7.8,86,16.6,1031.2,Cloudy
3/4/2024 19:00,44,379,35676,233413,423,269089,MONDAY,0,0,7.8,86,16.6,1031.2,Cloudy
3/4/2024 20:00,38,283,34942,178210,321,213152,MONDAY,0,0,6.1,86,25.9,1031.1,Cloudy
3/4/2024 21:00,35,206,68081,120002,241,188083,MONDAY,0,0,4.4,100,22.3,1031.8,Cloudy
3/4/2024 22:00,27,137,23174,87142,164,110316,MONDAY,0,0,4.4,100,22.3,1031.8,Cloudy
3/4/2024 23:00,19,66,109313,36998,85,146311,MONDAY,0,0,4.4,100,18.4,1031.9,Cloudy
3/5/2024 0:00,12,18,6833,10219,30,17052,TUESDAY,0,0,4.4,100,18.4,1031.8,Cloudy
3/5/2024 1:00,9,12,6696,7094,21,13790,TUESDAY,0,0,3.9,100,20.5,1031,Cloudy
3/5/2024 2:00,2,4,725,960,6,1685,TUESDAY,0,0,3.9,100,18.4,1031,Cloudy
3/5/2024 3:00,4,5,11818,1463,9,13281,TUESDAY,0,0,3.9,100,18.4,1031,Cloudy
3/5/2024 4:00,0,7,0,4961,7,4961,TUESDAY,0,0,3.3,100,13,1030.2,Cloudy
3/5/2024 5:00,12,52,8182,34178,64,42360,TUESDAY,0,0,3.3,100,13,1030.2,Cloudy
3/5/2024 6:00,23,202,20060,219332,225,239392,TUESDAY,0,0,3.3,100,11.2,1029.1,Cloudy
3/5/2024 7:00,47,464,68868,361626,511,430494,TUESDAY,0,0,3.3,100,14.8,1028.4,Cloudy
3/5/2024 8:00,100,900,91065,817561,1000,908626,TUESDAY,0,0,3.3,100,11.2,1028.4,Cloudy
3/5/2024 9:00,65,522,50905,432402,587,483307,TUESDAY,0,0,3.9,100,13,1027.8,Cloudy
3/5/2024 10:00,41,286,44210,221663,327,265873,TUESDAY,0,0,3.9,100,13,1027.8,Cloudy
3/5/2024 11:00,43,230,48917,132829,273,181746,TUESDAY,0,0,4.4,100,13,1027.7,Cloudy
3/5/2024 12:00,50,222,46455,133762,272,180217,TUESDAY,0,0,4.4,100,13,1028,Cloudy
3/5/2024 13:00,28,177,24944,121713,205,146657,TUESDAY,0,0,4.4,100,13,1027.3,Cloudy
3/5/2024 14:00,37,244,36037,158618,281,194655,TUESDAY,0,0,4.4,100,13,1027.3,Cloudy
3/5/2024 15:00,36,287,29913,264173,323,294086,TUESDAY,0,0,4.4,100,16.6,1025.9,Rain
3/5/2024 16:00,69,394,165665,260820,463,426485,TUESDAY,0,0,4.4,100,18.4,1025.1,Rain
3/5/2024 17:00,87,630,73604,509222,717,582826,TUESDAY,0,0,4.4,100,18.4,1023.6,Rain
3/5/2024 18:00,62,513,58404,351314,575,409718,TUESDAY,0,0,5,100,18.4,1022.4,Cloudy
3/5/2024 19:00,52,380,47531,260532,432,308063,TUESDAY,0,0,5,100,18.4,1022.4,Rain
3/5/2024 20:00,26,263,18154,161466,289,179620,TUESDAY,0,0,5,100,16.6,1021.8,Rain
3/5/2024 21:00,24,149,17393,101403,173,118796,TUESDAY,0,0,5,100,11.2,1020,Rain
3/5/2024 22:00,34,126,26772,87696,160,114468,TUESDAY,0,0,5,100,14.8,1019,Rain
3/5/2024 23:00,20,66,61630,43051,86,104681,TUESDAY,0,0,5,100,14.8,1019,Rain
3/6/2024 0:00,8,31,7155,21501,39,28656,WEDNESDAY,0,0,5,100,13,1018.8,Rain
3/6/2024 1:00,7,15,4747,10689,22,15436,WEDNESDAY,0,0,5,100,11.2,1016.4,Rain
3/6/2024 2:00,7,10,14518,5951,17,20469,WEDNESDAY,0,0,5,100,11.2,1016.4,Rain
3/6/2024 3:00,3,3,3787,1556,6,5343,WEDNESDAY,0,0,5,100,7.6,1015.9,Rain
3/6/2024 4:00,3,14,958,10402,17,11360,WEDNESDAY,0,0,5,100,7.6,1016.1,Rain
3/6/2024 5:00,10,47,8790,31003,57,39793,WEDNESDAY,0,0,5.6,100,16.6,1015.9,Rain
3/6/2024 6:00,26,218,15146,144565,244,159711,WEDNESDAY,0,0,5.6,100,13,1016,Rain
3/6/2024 7:00,60,529,77121,481804,589,558925,WEDNESDAY,0,0,5.6,100,13,1016,Cloudy
3/6/2024 8:00,112,1031,208275,814007,1143,1022282,WEDNESDAY,0,0,5.6,100,11.2,1016,Cloudy
3/6/2024 9:00,80,584,242198,766257,664,1008455,WEDNESDAY,0,0,5.6,96,5.4,1016.1,Cloudy
3/6/2024 10:00,68,360,84268,434100,428,518368,WEDNESDAY,0,0,6.1,97,16.6,1016.7,Cloudy
3/6/2024 11:00,71,381,80009,264364,452,344373,WEDNESDAY,0,0,6.1,97,18.4,1016.9,Cloudy
3/6/2024 12:00,97,384,110752,434596,481,545348,WEDNESDAY,0,0,6.7,100,16.6,1018.4,Cloudy
3/6/2024 13:00,77,321,169804,214462,398,384266,WEDNESDAY,0,0,6.7,100,16.6,1018.4,Cloudy
3/6/2024 14:00,133,410,169106,272504,543,441610,WEDNESDAY,0,0,8.9,93,7.6,1018.2,Cloudy
3/6/2024 15:00,110,449,111244,285404,559,396648,WEDNESDAY,0,0,9.4,93,14.8,1018,Cloudy
3/6/2024 16:00,114,596,180848,385201,710,566049,WEDNESDAY,0,0,9.4,93,14.8,1018,Cloudy
3/6/2024 17:00,115,724,119390,513984,839,633374,WEDNESDAY,0,0,8.3,97,16.6,1017.1,Cloudy
3/6/2024 18:00,86,534,77377,419016,620,496393,WEDNESDAY,0,0,6.7,100,14.8,1016.4,Cloudy
3/6/2024 19:00,59,389,234228,332015,448,566243,WEDNESDAY,0,0,6.7,100,14.8,1016.4,Cloudy
3/6/2024 20:00,45,265,38321,170696,310,209017,WEDNESDAY,0,0,6.1,100,9.4,1016.8,Cloudy
3/6/2024 21:00,30,148,42756,89392,178,132148,WEDNESDAY,0,0,6.1,100,5.4,1017.2,Rain
3/6/2024 22:00,15,96,17828,57283,111,75111,WEDNESDAY,0,0,6.1,100,13,1016.4,Rain
3/6/2024 23:00,4,30,1279,13451,34,14730,WEDNESDAY,0,0,6.1,100,13,1016.2,Rain
3/7/2024 0:00,4,14,91382,7151,18,98533,THURSDAY,0,0,6.1,100,13,1016.2,Rain
3/7/2024 1:00,1,2,567,1440,3,2007,THURSDAY,0,0,5.6,100,20.5,1015.9,Rain
3/7/2024 2:00,0,1,0,335,1,335,THURSDAY,0,0,5.6,100,20.5,1015.9,Rain
3/7/2024 3:00,1,4,3491,6137,5,9628,THURSDAY,0,0,5.6,100,18.4,1015.2,Rain
3/7/2024 4:00,1,8,353,3798,9,4151,THURSDAY,0,0,5.6,100,22.3,1013.6,Rain
3/7/2024 5:00,4,37,3670,46819,41,50489,THURSDAY,0,0,5.6,100,20.5,1012.7,Rain
3/7/2024 6:00,9,75,7699,47372,84,55071,THURSDAY,0,0,5.6,100,25.9,1010.2,Rain
3/7/2024 7:00,25,230,27357,146476,255,173833,THURSDAY,0,0,5.6,100,27.7,1008.8,Rain
3/7/2024 8:00,45,528,37070,392934,573,430004,THURSDAY,0,0,5,100,31.7,1007.5,Rain
3/7/2024 9:00,43,360,47210,348554,403,395764,THURSDAY,0,0,5,100,20.5,1008.5,Rain
3/7/2024 10:00,28,206,108134,122080,234,230214,THURSDAY,0,0,5,100,33.5,1008.1,Rain
3/7/2024 11:00,14,132,8296,78936,146,87232,THURSDAY,0,0,6.1,97,22.3,1009.9,Rain
3/7/2024 12:00,33,183,109144,181769,216,290913,THURSDAY,0,0,6.1,97,22.3,1009.9,Rain
3/7/2024 13:00,58,273,59752,168314,331,228066,THURSDAY,0,0,6.7,96,29.5,1010.4,Rain
3/7/2024 14:00,70,257,136833,174390,327,311223,THURSDAY,0,0,6.7,96,40.7,1010.4,Rain
3/7/2024 15:00,80,385,77842,335192,465,413034,THURSDAY,0,0,6.7,93,37.1,1011.3,Rain
3/7/2024 16:00,124,655,192727,448231,779,640958,THURSDAY,0,0,6.7,100,24.1,1012.5,Rain
3/7/2024 17:00,168,872,256426,648401,1040,904827,THURSDAY,0,0,7.2,97,29.5,1013.2,Rain
3/7/2024 18:00,118,627,119411,463033,745,582444,THURSDAY,0,0,7.2,93,29.5,1013.5,Rain
3/7/2024 19:00,82,489,72659,330854,571,403513,THURSDAY,0,0,6.1,93,38.9,1014.2,Rain
3/7/2024 20:00,67,323,67347,263838,390,331185,THURSDAY,0,0,6.1,93,29.5,1014.2,Rain
3/7/2024 21:00,55,243,48551,174072,298,222623,THURSDAY,0,0,5.6,89,24.1,1016.3,Rain
3/7/2024 22:00,54,171,44487,110576,225,155063,THURSDAY,0,0,5.6,85,24.1,1017.3,Cloudy
3/7/2024 23:00,30,115,22070,69073,145,91143,THURSDAY,0,0,5,86,27.7,1017.8,Cloudy
3/8/2024 0:00,13,47,8109,29876,60,37985,FRIDAY,0,0,5,86,27.7,1017.8,Cloudy
3/8/2024 1:00,16,26,20039,17232,42,37271,FRIDAY,0,0,5.6,79,31.7,1018.4,Cloudy
3/8/2024 2:00,9,14,8146,38640,23,46786,FRIDAY,0,0,5,76,33.5,1019.8,Cloudy
3/8/2024 3:00,0,13,0,7084,13,7084,FRIDAY,0,0,5,76,38.9,1019.8,Cloudy
3/8/2024 4:00,7,7,5804,3790,14,9594,FRIDAY,0,0,5,73,37.1,1020.7,Cloudy
3/8/2024 5:00,9,48,5958,30893,57,36851,FRIDAY,0,0,4.4,73,33.5,1021.2,Cloudy
3/8/2024 6:00,25,161,19781,105487,186,125268,FRIDAY,0,0,3.9,76,24.1,1021.4,Cloudy
3/8/2024 7:00,48,342,42462,270589,390,313051,FRIDAY,0,0,3.3,70,25.9,1021.8,Cloudy
3/8/2024 8:00,99,785,202106,542860,884,744966,FRIDAY,0,0,2.8,67,31.7,1021.9,Cloudy
3/8/2024 9:00,74,526,89223,329700,600,418923,FRIDAY,0,0,2.2,70,24.1,1022.6,Cloudy
3/8/2024 10:00,86,345,189876,220576,431,410452,FRIDAY,0,0,2.2,70,22.3,1023.3,Fair
3/8/2024 11:00,107,358,151862,237253,465,389115,FRIDAY,0,0,1.7,75,25.9,1023.8,Fair
3/8/2024 12:00,146,448,183802,276173,594,459975,FRIDAY,0,0,2.2,73,18.4,1024.5,Fair
3/8/2024 13:00,158,442,229176,286822,600,515998,FRIDAY,0,0,3.3,73,29.5,1025.1,Fair
3/8/2024 14:00,188,471,291751,325350,659,617101,FRIDAY,0,0,5,70,25.9,1026,Fair
3/8/2024 15:00,209,571,309239,475711,780,784950,FRIDAY,0,0,5.6,67,24.1,1026.7,Fair
3/8/2024 16:00,262,687,352137,561435,949,913572,FRIDAY,0,0,6.1,68,24.1,1027,Fair
3/8/2024 17:00,238,767,301578,627906,1005,929484,FRIDAY,0,0,6.1,68,22.3,1026.6,Fair
3/8/2024 18:00,172,642,194145,529560,814,723705,FRIDAY,0,0,6.1,65,25.9,1026.5,Fair
3/8/2024 19:00,89,412,116394,273671,501,390065,FRIDAY,0,0,6.1,65,25.9,1026.5,Fair
3/8/2024 20:00,100,305,122216,207836,405,330052,FRIDAY,0,0,5.6,64,24.1,1026.6,Fair
3/8/2024 21:00,109,235,254378,164211,344,418589,FRIDAY,0,0,5,67,22.3,1026.9,Fair
3/8/2024 22:00,79,180,101768,117936,259,219704,FRIDAY,0,0,3.9,70,18.4,1026.6,Cloudy
3/8/2024 23:00,69,136,108180,93558,205,201738,FRIDAY,0,0,3.9,70,18.4,1026.6,Fair
3/9/2024 0:00,53,96,114414,66928,149,181342,SATURDAY,1,0,3.3,73,7.6,1027.7,Fair
3/9/2024 1:00,61,51,169159,35854,112,205013,SATURDAY,1,0,2.8,72,7.6,1027.7,Fair
3/9/2024 2:00,25,29,141672,16585,54,158257,SATURDAY,1,0,2.8,72,7.6,1027.7,Fair
3/9/2024 3:00,12,21,14817,15308,33,30125,SATURDAY,1,0,3.3,64,11.2,1027.3,Clear
3/9/2024 4:00,7,12,2377,7639,19,10016,SATURDAY,1,0,3.9,64,5.4,1028.2,Clear
3/9/2024 5:00,3,33,7747,25172,36,32919,SATURDAY,1,0,1.7,72,0,1028.6,Fair
3/9/2024 6:00,7,39,5223,30572,46,35795,SATURDAY,1,0,0.6,85,5.4,1027.8,Fair
3/9/2024 7:00,25,91,27191,56904,116,84095,SATURDAY,1,0,0.6,82,7.6,1026.6,Cloudy
3/9/2024 8:00,43,188,62801,130086,231,192887,SATURDAY,1,0,0.6,82,7.6,1026.6,Cloudy
3/9/2024 9:00,72,291,75138,288005,363,363143,SATURDAY,1,0,2.8,85,18.4,1026.9,Cloudy
3/9/2024 10:00,110,388,135819,357603,498,493422,SATURDAY,1,0,2.8,85,18.4,1026.9,Cloudy
3/9/2024 11:00,148,465,286325,420044,613,706369,SATURDAY,1,0,2.8,85,14.8,1026.4,Cloudy
3/9/2024 12:00,135,458,215493,330512,593,546005,SATURDAY,1,0,2.8,85,14.8,1026.2,Cloudy
3/9/2024 13:00,176,409,268226,311058,585,579284,SATURDAY,1,0,2.8,85,14.8,1026.2,Cloudy
3/9/2024 14:00,218,465,323063,334828,683,657891,SATURDAY,1,0,2.8,85,14.8,1025.6,Cloudy
3/9/2024 15:00,187,464,279490,365568,651,645058,SATURDAY,1,0,2.8,85,14.8,1025.6,Cloudy
3/9/2024 16:00,178,456,504445,322885,634,827330,SATURDAY,1,0,3.3,86,14.8,1024.7,Cloudy
3/9/2024 17:00,195,428,240426,319018,623,559444,SATURDAY,1,0,4.4,86,18.4,1022.6,Cloudy
3/9/2024 18:00,124,404,319316,276005,528,595321,SATURDAY,1,0,4.4,86,18.4,1022.6,Cloudy
3/9/2024 19:00,88,320,100338,204247,408,304585,SATURDAY,1,0,3.9,89,22.3,1021.8,Cloudy
3/9/2024 20:00,91,240,175355,213148,331,388503,SATURDAY,1,0,4.4,86,25.9,1019.6,Cloudy
3/9/2024 21:00,51,142,91562,86365,193,177927,SATURDAY,1,0,4.4,86,25.9,1019.6,Cloudy
3/9/2024 22:00,23,104,179959,68506,127,248465,SATURDAY,1,0,4.4,83,22.3,1019.4,Rain
3/9/2024 23:00,16,32,48523,17533,48,66056,SATURDAY,1,0,3.9,89,25.9,1017.7,Rain
3/10/2024 0:00,15,21,20905,9612,36,30517,SUNDAY,1,0,3.9,89,25.9,1017.7,Rain
3/10/2024 1:00,9,20,26435,36831,29,63266,SUNDAY,1,0,3.3,93,38.9,1015.1,Rain
3/10/2024 3:00,14,16,17571,12426,30,29997,SUNDAY,1,0,3.9,100,31.7,1011.3,Rain
3/10/2024 4:00,1,10,272,6759,11,7031,SUNDAY,1,0,3.9,100,29.5,1011.3,Rain
3/10/2024 5:00,3,11,3934,8712,14,12646,SUNDAY,1,0,3.9,100,31.7,1007.9,Rain
3/10/2024 6:00,4,15,20530,8561,19,29091,SUNDAY,1,0,4.4,100,33.5,1005.4,Rain
3/10/2024 7:00,6,28,4207,14586,34,18793,SUNDAY,1,0,5,100,33.5,1002.2,Rain
3/10/2024 8:00,14,75,10717,48565,89,59282,SUNDAY,1,0,6.7,100,24.1,999,Rain
3/10/2024 9:00,53,188,72642,109364,241,182006,SUNDAY,1,0,6.7,100,31.7,996.5,Rain
3/10/2024 10:00,77,286,98960,184092,363,283052,SUNDAY,1,0,7.2,100,29.5,993.2,Rain
3/10/2024 11:00,125,364,159959,273032,489,432991,SUNDAY,1,0,7.8,100,9.4,991.4,Cloudy
3/10/2024 12:00,190,380,264616,293730,570,558346,SUNDAY,1,0,9.4,100,22.3,989.6,Cloudy
3/10/2024 13:00,263,417,658882,333392,680,992274,SUNDAY,1,0,10,100,20.5,989.6,Rain
3/10/2024 14:00,250,447,577996,373239,697,951235,SUNDAY,1,0,11.1,93,25.9,989.9,Rain
3/10/2024 15:00,193,481,314874,409740,674,724614,SUNDAY,1,0,9.4,86,20.5,990,Cloudy
3/10/2024 16:00,215,485,319468,350914,700,670382,SUNDAY,1,0,9.4,71,27.7,990.3,Cloudy
3/10/2024 17:00,177,444,272323,314130,621,586453,SUNDAY,1,0,10,68,25.9,989.9,Cloudy
3/10/2024 18:00,132,409,215956,290896,541,506852,SUNDAY,1,0,10.6,68,18.4,988.9,Cloudy
3/10/2024 19:00,85,279,174948,196869,364,371817,SUNDAY,1,0,10.6,68,18.4,988.9,Cloudy
3/10/2024 20:00,58,208,49667,122536,266,172203,SUNDAY,1,0,8.9,66,25.9,989.2,Cloudy
3/10/2024 21:00,30,147,19574,89425,177,108999,SUNDAY,1,0,7.8,65,18.4,989.6,Cloudy
3/10/2024 22:00,27,128,19033,67482,155,86515,SUNDAY,1,0,7.2,65,25.9,989.7,Cloudy
3/10/2024 23:00,18,62,13870,50664,80,64534,SUNDAY,1,0,6.7,65,25.9,989.7,Cloudy
3/11/2024 0:00,23,36,122991,19377,59,142368,MONDAY,0,0,6.7,65,25.9,989.7,Cloudy
3/11/2024 1:00,12,15,109813,10189,27,120002,MONDAY,0,0,6.7,65,22.3,989.8,Cloudy
3/11/2024 2:00,3,8,814,4363,11,5177,MONDAY,0,0,5,70,31.7,989.8,Cloudy
3/11/2024 3:00,6,5,93728,3614,11,97342,MONDAY,0,0,5,70,31.7,989.8,Cloudy
3/11/2024 4:00,2,10,3272,3975,12,7247,MONDAY,0,0,4.4,68,29.5,989.8,Cloudy
3/11/2024 5:00,5,48,2846,29617,53,32463,MONDAY,0,0,3.9,64,37.1,990.1,Cloudy
3/11/2024 6:00,8,138,4274,89533,146,93807,MONDAY,0,0,2.8,67,33.5,990.7,Cloudy
3/11/2024 7:00,30,302,20006,308005,332,328011,MONDAY,0,0,2.2,64,33.5,990.4,Cloudy
3/11/2024 8:00,66,728,52588,611068,794,663656,MONDAY,0,0,1.7,66,29.5,990.7,Cloudy
3/11/2024 9:00,36,447,31754,287861,483,319615,MONDAY,0,0,1.1,69,38.9,991.3,Cloudy
3/11/2024 10:00,41,236,34975,152519,277,187494,MONDAY,0,0,1.1,67,33.5,991.7,Cloudy
3/11/2024 11:00,38,244,35831,395758,282,431589,MONDAY,0,0,1.1,61,31.7,992.4,Cloudy
3/11/2024 12:00,33,235,40593,140978,268,181571,MONDAY,0,0,1.1,59,29.5,993.6,Cloudy
3/11/2024 13:00,67,227,83788,140435,294,224223,MONDAY,0,0,1.7,56,29.5,994.2,Cloudy
3/11/2024 14:00,71,283,79912,173696,354,253608,MONDAY,0,0,2.2,56,46.4,994.8,Cloudy
3/11/2024 15:00,56,341,122304,200316,397,322620,MONDAY,0,0,3.9,57,40.7,995,Cloudy
3/11/2024 16:00,92,534,111030,364371,626,475401,MONDAY,0,0,4.4,57,33.5,994.8,Cloudy
3/11/2024 17:00,103,814,98515,529060,917,627575,MONDAY,0,0,5.6,57,53.6,994.9,Cloudy
3/11/2024 18:00,87,661,239080,403038,748,642118,MONDAY,0,0,7.2,58,37.1,995.3,Cloudy
3/11/2024 19:00,57,423,51922,258692,480,310614,MONDAY,0,0,7.2,58,35.3,995.7,Cloudy
3/11/2024 20:00,46,244,35464,138314,290,173778,MONDAY,0,0,6.1,62,37.1,996.8,Cloudy
3/11/2024 21:00,27,201,21915,146038,228,167953,MONDAY,0,0,5,60,46.4,998.6,Cloudy
3/11/2024 22:00,15,149,14949,79276,164,94225,MONDAY,0,0,5,60,38.9,998.6,Cloudy
3/11/2024 23:00,12,50,9604,23078,62,32682,MONDAY,0,0,5,60,40.7,999.8,Fair
3/12/2024 0:00,17,35,19869,21507,52,41376,TUESDAY,0,0,5,60,18.4,1001.9,Fair
3/12/2024 1:00,7,15,14205,7844,22,22049,TUESDAY,0,0,4.4,60,37.1,1002.8,Fair
3/12/2024 2:00,1,12,372,5880,13,6252,TUESDAY,0,0,4.4,60,27.7,1002.8,Fair
3/12/2024 3:00,1,6,684,1994,7,2678,TUESDAY,0,0,4.4,57,25.9,1003.2,Fair
3/12/2024 4:00,2,10,1472,5811,12,7283,TUESDAY,0,0,3.9,55,20.5,1003.6,Clear
3/12/2024 5:00,6,46,5857,34123,52,39980,TUESDAY,0,0,3.9,55,22.3,1003.8,Clear
3/12/2024 6:00,21,176,12655,122978,197,135633,TUESDAY,0,0,3.9,55,22.3,1004.1,Clear
3/12/2024 7:00,60,449,40963,317664,509,358627,TUESDAY,0,0,3.3,55,20.5,1003.8,Clear
3/12/2024 8:00,76,1031,60783,755713,1107,816496,TUESDAY,0,0,3.3,55,27.7,1003.5,Clear
3/12/2024 9:00,71,550,121894,449525,621,571419,TUESDAY,0,0,3.3,55,18.4,1004.2,Fair
3/12/2024 10:00,63,277,111384,196398,340,307782,TUESDAY,0,0,3.3,55,24.1,1004.8,Cloudy
3/12/2024 11:00,71,258,113709,168528,329,282237,TUESDAY,0,0,4.4,55,18.4,1005.6,Fair
3/12/2024 12:00,95,342,155447,219191,437,374638,TUESDAY,0,0,4.4,55,18.4,1005.6,Fair
3/12/2024 13:00,81,321,332970,219906,402,552876,TUESDAY,0,0,6.7,57,16.6,1006.2,Fair
3/12/2024 14:00,85,352,112002,329812,437,441814,TUESDAY,0,0,7.8,58,29.5,1006.2,Fair
3/12/2024 15:00,159,521,253140,367418,680,620558,TUESDAY,0,0,8.9,58,27.7,1005.7,Fair
3/12/2024 16:00,167,811,327408,617670,978,945078,TUESDAY,0,0,10,56,24.1,1005.5,Fair
3/12/2024 17:00,251,1102,305578,927770,1353,1233348,TUESDAY,0,0,10,56,24.1,1005.5,Fair
3/12/2024 18:00,207,811,306259,581345,1018,887604,TUESDAY,0,0,12.2,59,27.7,1004.5,Fair
3/12/2024 19:00,128,543,201052,440721,671,641773,TUESDAY,0,0,11.7,59,27.7,1004.8,Fair
3/12/2024 20:00,61,379,58566,254281,440,312847,TUESDAY,0,0,12.2,61,37.1,1004.8,Fair
3/12/2024 21:00,50,232,165859,198872,282,364731,TUESDAY,0,0,11.7,57,25.9,1005.5,Fair
3/12/2024 22:00,37,158,34640,204008,195,238648,TUESDAY,0,0,11.7,59,25.9,1005.5,Fair
3/12/2024 23:00,26,86,21531,53870,112,75401,TUESDAY,0,0,10.6,57,29.5,1007.1,Fair
3/13/2024 0:00,6,26,5504,19039,32,24543,WEDNESDAY,0,0,10.6,56,25.9,1007.1,Fair
3/13/2024 1:00,14,15,8433,6367,29,14800,WEDNESDAY,0,0,9.4,59,20.5,1007.9,Fair
3/13/2024 2:00,0,18,0,15723,18,15723,WEDNESDAY,0,0,7.2,56,18.4,1010,Clear
3/13/2024 3:00,2,7,1140,3976,9,5116,WEDNESDAY,0,0,7.2,56,18.4,1010,Clear
3/13/2024 4:00,5,11,6628,5224,16,11852,WEDNESDAY,0,0,6.7,55,18.4,1010.3,Clear
3/13/2024 5:00,12,40,8201,29120,52,37321,WEDNESDAY,0,0,5.6,53,13,1010.7,Clear
3/13/2024 6:00,25,190,16500,163658,215,180158,WEDNESDAY,0,0,5,53,11.2,1011.1,Clear
3/13/2024 7:00,52,499,53541,381838,551,435379,WEDNESDAY,0,0,3.9,57,11.2,1011.3,Clear
3/13/2024 8:00,104,976,93635,734334,1080,827969,WEDNESDAY,0,0,5,55,20.5,1011.4,Clear
3/13/2024 9:00,80,569,86869,396936,649,483805,WEDNESDAY,0,0,3.3,52,14.8,1012.2,Clear
3/13/2024 10:00,67,355,79602,241213,422,320815,WEDNESDAY,0,0,3.3,52,14.8,1012.2,Fair
3/13/2024 11:00,90,359,119716,223036,449,342752,WEDNESDAY,0,0,3.3,52,14.8,1012.7,Fair
3/13/2024 12:00,92,370,158058,311657,462,469715,WEDNESDAY,0,0,4.4,53,14.8,1013.3,Fair
3/13/2024 13:00,123,349,150604,237814,472,388418,WEDNESDAY,0,0,7.2,51,5.4,1014.4,Fair
3/13/2024 14:00,150,409,390693,264630,559,655323,WEDNESDAY,0,0,7.8,51,9.4,1014.9,Fair
3/13/2024 15:00,155,497,410689,343303,652,753992,WEDNESDAY,0,0,7.2,53,13,1014.9,Fair
3/13/2024 16:00,194,831,289007,602423,1025,891430,WEDNESDAY,0,0,7.2,53,13,1014.9,Fair
3/13/2024 17:00,262,1120,395627,820039,1382,1215666,WEDNESDAY,0,0,8.3,56,18.4,1013.8,Fair
3/13/2024 18:00,198,770,242584,623135,968,865719,WEDNESDAY,0,0,7.8,56,24.1,1013.5,Fair
3/13/2024 19:00,91,487,104491,318579,578,423070,WEDNESDAY,0,0,6.7,68,25.9,1013.3,Fair
3/13/2024 20:00,94,381,119371,248046,475,367417,WEDNESDAY,0,0,6.7,68,25.9,1013.3,Fair
3/13/2024 21:00,66,254,65182,166996,320,232178,WEDNESDAY,0,0,6.7,62,25.9,1013.3,Fair
3/13/2024 22:00,44,166,48817,102909,210,151726,WEDNESDAY,0,0,5.6,79,25.9,1014.1,Fair
3/13/2024 23:00,29,87,41743,145045,116,186788,WEDNESDAY,0,0,5.6,82,18.4,1014.7,Fair
3/14/2024 0:00,16,37,27313,24521,53,51834,THURSDAY,0,0,5.6,76,14.8,1015.3,Cloudy
3/14/2024 1:00,8,15,6629,9380,23,16009,THURSDAY,0,0,5.6,76,14.8,1015.3,Cloudy
3/14/2024 2:00,5,9,7005,11305,14,18310,THURSDAY,0,0,4.4,65,11.2,1016.1,Cloudy
3/14/2024 3:00,4,12,5150,8568,16,13718,THURSDAY,0,0,5,70,20.5,1016.3,Cloudy
3/14/2024 4:00,2,12,2081,7045,14,9126,THURSDAY,0,0,5,76,13,1015.9,Cloudy
3/14/2024 5:00,12,55,11871,35957,67,47828,THURSDAY,0,0,5.6,76,7.6,1015.9,Cloudy
3/14/2024 6:00,18,188,15644,228676,206,244320,THURSDAY,0,0,5.6,76,7.6,1015.9,Cloudy
3/14/2024 7:00,49,488,41395,340673,537,382068,THURSDAY,0,0,4.4,83,5.4,1015.8,Cloudy
3/14/2024 8:00,93,959,166557,688212,1052,854769,THURSDAY,0,0,3.9,89,5.4,1015.9,Cloudy
3/14/2024 9:00,63,607,176384,399960,670,576344,THURSDAY,0,0,3.9,89,7.6,1016.2,Cloudy
3/14/2024 10:00,68,354,104509,285177,422,389686,THURSDAY,0,0,3.9,89,7.6,1016.2,Cloudy
3/14/2024 11:00,99,351,196023,241273,450,437296,THURSDAY,0,0,4.4,93,5.4,1017,Cloudy
3/14/2024 12:00,127,425,196447,292257,552,488704,THURSDAY,0,0,5.6,85,7.6,1017.4,Cloudy
3/14/2024 13:00,153,421,212714,297493,574,510207,THURSDAY,0,0,7.2,76,9.4,1017.7,Cloudy
3/14/2024 14:00,186,444,661722,311300,630,973022,THURSDAY,0,0,8.3,74,9.4,1017.6,Cloudy
3/14/2024 15:00,202,548,362764,388850,750,751614,THURSDAY,0,0,8.3,74,9.4,1017.6,Cloudy
3/14/2024 16:00,280,844,477433,742824,1124,1220257,THURSDAY,0,0,8.3,76,14.8,1017.5,Cloudy
3/14/2024 17:00,309,1054,441977,981828,1363,1423805,THURSDAY,0,0,9.4,74,14.8,1017.4,Cloudy
3/14/2024 18:00,265,793,573400,583864,1058,1157264,THURSDAY,0,0,8.9,77,16.6,1016.8,Fair
3/14/2024 19:00,138,514,281544,348767,652,630311,THURSDAY,0,0,8.3,83,16.6,1017,Fair
3/14/2024 20:00,86,395,107761,257342,481,365103,THURSDAY,0,0,8.3,83,16.6,1017,Fair
3/14/2024 21:00,86,254,109287,176239,340,285526,THURSDAY,0,0,7.2,86,18.4,1016.9,Cloudy
3/14/2024 22:00,64,194,67691,133136,258,200827,THURSDAY,0,0,6.1,89,7.6,1017.8,Cloudy
3/14/2024 23:00,43,94,66441,61718,137,128159,THURSDAY,0,0,6.1,89,7.6,1017.8,Cloudy
3/15/2024 0:00,28,51,61717,36380,79,98097,FRIDAY,0,0,6.7,89,13,1017.8,Cloudy
3/15/2024 1:00,25,33,25730,24570,58,50300,FRIDAY,0,0,5.6,96,11.2,1017.6,Cloudy
3/15/2024 2:00,6,8,5404,6481,14,11885,FRIDAY,0,0,5.6,96,11.2,1017.6,Cloudy
3/15/2024 3:00,3,3,2902,2407,6,5309,FRIDAY,0,0,5.6,100,9.4,1016.6,Cloudy
3/15/2024 4:00,2,12,2089,6344,14,8433,FRIDAY,0,0,5.6,100,9.4,1016.1,Cloudy
3/15/2024 5:00,8,34,6069,22643,42,28712,FRIDAY,0,0,5.6,100,9.4,1014.9,Cloudy
3/15/2024 6:00,15,96,10381,69830,111,80211,FRIDAY,0,0,5.6,100,7.6,1015.7,Cloudy
3/15/2024 7:00,32,277,32921,188221,309,221142,FRIDAY,0,0,5.6,100,14.8,1012.8,Rain
3/15/2024 8:00,71,606,59149,414726,677,473875,FRIDAY,0,0,5.6,100,14.8,1011.6,Rain
3/15/2024 9:00,64,492,49072,294004,556,343076,FRIDAY,0,0,5.6,100,14.8,1011,Rain
3/15/2024 10:00,55,316,48323,199624,371,247947,FRIDAY,0,0,5,100,24.1,1008.6,Rain
3/15/2024 11:00,86,296,111307,184181,382,295488,FRIDAY,0,0,5,100,20.5,1008.1,Rain
3/15/2024 12:00,98,359,138570,208924,457,347494,FRIDAY,0,0,5.6,100,16.6,1007.3,Rain
3/15/2024 13:00,118,349,145892,288732,467,434624,FRIDAY,0,0,5.6,100,9.4,1006.7,Rain
3/15/2024 14:00,112,343,145215,216158,455,361373,FRIDAY,0,0,6.1,100,7.6,1006.5,Rain
3/15/2024 15:00,136,417,224198,250228,553,474426,FRIDAY,0,0,6.1,100,14.8,1006.4,Cloudy
3/15/2024 16:00,141,573,148332,384361,714,532693,FRIDAY,0,0,6.7,96,24.1,1005.5,Cloudy
3/15/2024 17:00,177,721,262097,587724,898,849821,FRIDAY,0,0,6.1,97,27.7,1006.3,Cloudy
3/15/2024 18:00,141,653,172231,440089,794,612320,FRIDAY,0,0,5.6,92,25.9,1005.9,Cloudy
3/15/2024 19:00,132,423,229569,286815,555,516384,FRIDAY,0,0,5,93,24.1,1007.3,Cloudy
3/15/2024 20:00,88,284,76168,183124,372,259292,FRIDAY,0,0,5,93,20.5,1007.8,Cloudy
3/15/2024 21:00,97,219,116832,155736,316,272568,FRIDAY,0,0,5,93,20.5,1007.8,Cloudy
3/15/2024 22:00,88,205,136909,175774,293,312683,FRIDAY,0,0,5,89,22.3,1008.3,Cloudy
3/15/2024 23:00,58,132,79110,119279,190,198389,FRIDAY,0,0,5,86,9.4,1008.8,Cloudy
3/16/2024 0:00,81,113,160477,165978,194,326455,SATURDAY,1,0,4.4,93,9.4,1009.3,Cloudy
3/16/2024 1:00,69,68,366847,51421,137,418268,SATURDAY,1,0,3.9,100,11.2,1009.6,Cloudy
3/16/2024 2:00,48,41,193299,29782,89,223081,SATURDAY,1,0,4.4,100,9.4,1009,Cloudy
3/16/2024 3:00,5,8,18278,6365,13,24643,SATURDAY,1,0,4.4,97,7.6,1008.8,Cloudy
3/16/2024 4:00,2,9,3552,4989,11,8541,SATURDAY,1,0,3.3,97,7.6,1008.3,Cloudy
3/16/2024 5:00,7,16,7427,10537,23,17964,SATURDAY,1,0,3.9,100,0,1008.8,Cloudy
3/16/2024 6:00,6,49,2124,25660,55,27784,SATURDAY,1,0,4.4,97,0,1008.7,Cloudy
3/16/2024 7:00,26,102,32624,62083,128,94707,SATURDAY,1,0,5,89,5.4,1008.6,Cloudy
3/16/2024 8:00,54,139,63514,93903,193,157417,SATURDAY,1,0,5,89,9.4,1008.3,Cloudy
3/16/2024 9:00,104,294,160300,181603,398,341903,SATURDAY,1,0,4.4,97,7.6,1008.9,Cloudy
3/16/2024 10:00,192,383,337571,263062,575,600633,SATURDAY,1,0,4.4,97,0,1009,Cloudy
3/16/2024 11:00,288,477,588849,456945,765,1045794,SATURDAY,1,0,5.6,92,0,1009.4,Cloudy
3/16/2024 12:00,396,540,921012,472552,936,1393564,SATURDAY,1,0,5.6,92,0,1009.4,Fair
3/16/2024 13:00,444,584,877455,645180,1028,1522635,SATURDAY,1,0,7.8,79,7.6,1009.5,Fair
3/16/2024 14:00,519,567,1241607,655527,1086,1897134,SATURDAY,1,0,8.9,77,11.2,1009.5,Fair
3/16/2024 15:00,397,540,943887,478282,937,1422169,SATURDAY,1,0,10,71,13,1009,Fair
3/16/2024 16:00,438,512,760397,597775,950,1358172,SATURDAY,1,0,9.4,77,13,1008.6,Fair
3/16/2024 17:00,407,504,991275,405205,911,1396480,SATURDAY,1,0,9.4,77,22.3,1008.6,Fair
3/16/2024 18:00,346,510,776280,446275,856,1222555,SATURDAY,1,0,8.3,80,25.9,1007.1,Fair
3/16/2024 19:00,199,376,466309,347059,575,813368,SATURDAY,1,0,8.9,80,27.7,1006.6,Cloudy
3/16/2024 20:00,137,282,280402,279623,419,560025,SATURDAY,1,0,8.3,83,18.4,1006.3,Cloudy
3/16/2024 21:00,126,218,152140,227335,344,379475,SATURDAY,1,0,8.3,86,11.2,1006.3,Cloudy
3/16/2024 22:00,116,204,301049,149671,320,450720,SATURDAY,1,0,8.3,86,11.2,1006.3,Cloudy
3/16/2024 23:00,94,159,168922,104023,253,272945,SATURDAY,1,0,9.4,71,18.4,1006.7,Cloudy
3/17/2024 0:00,101,99,188153,66275,200,254428,SUNDAY,1,1,8.3,74,16.6,1006.9,Cloudy
3/17/2024 1:00,90,77,169508,67717,167,237225,SUNDAY,1,1,7.8,76,18.4,1006.9,Cloudy
3/17/2024 2:00,36,37,77168,24623,73,101791,SUNDAY,1,1,7.8,76,18.4,1006.9,Cloudy
3/17/2024 3:00,12,18,13698,12134,30,25832,SUNDAY,1,1,6.7,82,14.8,1006,Cloudy
3/17/2024 4:00,4,8,4265,5684,12,9949,SUNDAY,1,1,6.1,93,22.3,1005.5,Cloudy
3/17/2024 5:00,11,8,20726,5694,19,26420,SUNDAY,1,1,6.1,93,22.3,1005.5,Cloudy
3/17/2024 6:00,7,32,43891,21866,39,65757,SUNDAY,1,1,6.1,97,24.1,1004.9,Cloudy
3/17/2024 7:00,12,45,10489,29698,57,40187,SUNDAY,1,1,6.1,97,20.5,1003.5,Cloudy
3/17/2024 8:00,29,106,55426,61043,135,116469,SUNDAY,1,1,6.1,97,20.5,1003.5,Cloudy
3/17/2024 9:00,42,168,65945,99140,210,165085,SUNDAY,1,1,6.7,93,22.3,1001.7,Cloudy
3/17/2024 10:00,144,329,198197,234015,473,432212,SUNDAY,1,1,7.2,93,25.9,1001.6,Cloudy
3/17/2024 11:00,227,414,647529,322447,641,969976,SUNDAY,1,1,7.2,93,25.9,1001.6,Cloudy
3/17/2024 12:00,328,506,703584,433110,834,1136694,SUNDAY,1,1,7.2,97,27.7,1001.3,Cloudy
3/17/2024 13:00,408,480,1672792,548673,888,2221465,SUNDAY,1,1,7.8,96,25.9,1000.1,Cloudy
3/17/2024 14:00,332,466,920852,400789,798,1321641,SUNDAY,1,1,8.9,93,24.1,998.9,Cloudy
3/17/2024 15:00,452,486,1026752,404297,938,1431049,SUNDAY,1,1,11.7,86,24.1,999,Cloudy
3/17/2024 16:00,447,523,821381,462445,970,1283826,SUNDAY,1,1,11.7,86,24.1,999,Cloudy
3/17/2024 17:00,399,495,882085,540194,894,1422279,SUNDAY,1,1,13.9,80,25.9,998.1,Cloudy
3/17/2024 18:00,282,472,693065,357376,754,1050441,SUNDAY,1,1,14.4,77,24.1,997.5,Cloudy
3/17/2024 19:00,161,336,432123,220481,497,652604,SUNDAY,1,1,15,75,22.3,997.5,Cloudy
3/17/2024 20:00,90,259,107250,176915,349,284165,SUNDAY,1,1,11.1,74,22.3,999,Cloudy
3/17/2024 21:00,55,166,140871,108896,221,249767,SUNDAY,1,1,11.1,74,27.7,999,Cloudy
3/17/2024 22:00,47,151,37419,80673,198,118092,SUNDAY,1,1,10,68,24.1,1001,Fair
3/17/2024 23:00,48,82,194568,61819,130,256387,SUNDAY,1,1,9.4,69,20.5,1002.2,Fair
3/18/2024 0:00,28,42,53788,25528,70,79316,MONDAY,0,1,8.9,69,16.6,1002.9,Fair
3/18/2024 1:00,10,22,11127,13072,32,24199,MONDAY,0,1,8.9,66,16.6,1002.9,Fair
3/18/2024 2:00,10,8,9398,7698,18,17096,MONDAY,0,1,7.8,65,18.4,1003.2,Fair
3/18/2024 3:00,4,6,3276,2733,10,6009,MONDAY,0,1,7.2,60,16.6,1003.6,Fair
3/18/2024 4:00,2,13,861,10349,15,11210,MONDAY,0,1,6.1,62,14.8,1003.9,Fair
3/18/2024 5:00,15,45,9543,33405,60,42948,MONDAY,0,1,6.7,65,24.1,1004,Fair
3/18/2024 6:00,31,154,26547,111162,185,137709,MONDAY,0,1,6.7,65,24.1,1004,Fair
3/18/2024 7:00,50,395,54115,284333,445,338448,MONDAY,0,1,6.1,62,16.6,1003.3,Fair
3/18/2024 8:00,84,830,68278,569750,914,638028,MONDAY,0,1,5.6,62,22.3,1003.5,Fair
3/18/2024 9:00,83,524,97170,346809,607,443979,MONDAY,0,1,5.6,62,18.4,1004,Fair
3/18/2024 10:00,77,321,291447,210958,398,502405,MONDAY,0,1,5.6,64,18.4,1004.3,Cloudy
3/18/2024 11:00,79,312,95145,212155,391,307300,MONDAY,0,1,5.6,64,18.4,1004.3,Cloudy
3/18/2024 12:00,104,349,228165,213869,453,442034,MONDAY,0,1,5,65,20.5,1004.8,Cloudy
3/18/2024 13:00,98,325,193772,208082,423,401854,MONDAY,0,1,6.7,62,20.5,1003.9,Fair
3/18/2024 14:00,151,398,310003,256086,549,566089,MONDAY,0,1,7.8,62,31.7,1003.5,Fair
3/18/2024 15:00,132,460,262238,302754,592,564992,MONDAY,0,1,7.8,60,31.7,1003.5,Fair
3/18/2024 16:00,179,755,306482,518161,934,824643,MONDAY,0,1,8.3,63,24.1,1002.8,Fair
3/18/2024 17:00,241,959,278388,707881,1200,986269,MONDAY,0,1,8.9,65,29.5,1002,Fair
3/18/2024 18:00,182,754,212260,515978,936,728238,MONDAY,0,1,10,66,24.1,1001.4,Fair
3/18/2024 19:00,77,496,73495,307162,573,380657,MONDAY,0,1,8.9,63,18.4,1001.3,Fair
3/18/2024 20:00,87,344,84391,204395,431,288786,MONDAY,0,1,8.9,63,18.4,1001.3,Cloudy
3/18/2024 21:00,51,205,46522,132737,256,179259,MONDAY,0,1,8.3,63,22.3,1001.3,Cloudy
3/18/2024 22:00,32,155,42724,104443,187,147167,MONDAY,0,1,6.7,63,24.1,1002.2,Cloudy
3/18/2024 23:00,15,68,11008,33760,83,44768,MONDAY,0,1,5.6,62,22.3,1002.9,Fair
3/19/2024 0:00,18,22,81215,15977,40,97192,TUESDAY,0,0,4.4,62,22.3,1003.1,Fair
3/19/2024 1:00,7,11,5009,3978,18,8987,TUESDAY,0,0,4.4,62,24.1,1003.1,Fair
3/19/2024 2:00,3,7,4219,3632,10,7851,TUESDAY,0,0,3.3,64,18.4,1002.6,Fair
3/19/2024 3:00,3,3,3106,2356,6,5462,TUESDAY,0,0,2.8,67,20.5,1002.2,Fair
3/19/2024 4:00,3,10,5758,5636,13,11394,TUESDAY,0,0,2.8,67,20.5,1002.2,Fair
3/19/2024 5:00,9,65,5746,44411,74,50157,TUESDAY,0,0,2.2,73,25.9,1002.3,Fair
3/19/2024 6:00,21,229,20531,152214,250,172745,TUESDAY,0,0,2.2,73,25.9,1002.1,Fair
3/19/2024 7:00,73,508,64499,362859,581,427358,TUESDAY,0,0,2.2,73,25.9,1001.6,Fair
3/19/2024 8:00,144,1053,140769,741554,1197,882323,TUESDAY,0,0,2.2,73,25.9,1001.6,Fair
3/19/2024 9:00,80,578,63787,387805,658,451592,TUESDAY,0,0,1.7,75,20.5,1001.6,Fair
3/19/2024 10:00,56,338,81197,317583,394,398780,TUESDAY,0,0,1.7,75,22.3,1001.9,Fair
3/19/2024 11:00,71,319,90791,239706,390,330497,TUESDAY,0,0,2.2,73,22.3,1002.3,Fair
3/19/2024 12:00,93,343,130237,216457,436,346694,TUESDAY,0,0,2.2,73,22.3,1002.3,Fair
3/19/2024 13:00,84,349,111823,210937,433,322760,TUESDAY,0,0,4.4,65,27.7,1003.1,Fair
3/19/2024 14:00,89,373,146726,256238,462,402964,TUESDAY,0,0,5.6,62,24.1,1003.5,Fair
3/19/2024 15:00,147,435,181197,390595,582,571792,TUESDAY,0,0,6.1,62,25.9,1003.2,Fair
3/19/2024 16:00,185,905,245799,641906,1090,887705,TUESDAY,0,0,6.1,62,25.9,1003.2,Fair
3/19/2024 17:00,245,1106,344953,810555,1351,1155508,TUESDAY,0,0,6.7,62,29.5,1003,Fair
3/19/2024 18:00,188,857,195673,570425,1045,766098,TUESDAY,0,0,7.8,60,22.3,1002.4,Fair
3/19/2024 19:00,83,539,71228,441869,622,513097,TUESDAY,0,0,7,60,24.1,1002.3,Fair
3/19/2024 20:00,66,332,59602,208368,398,267970,TUESDAY,0,0,6.1,26,27.7,1002.6,Cloudy
3/19/2024 21:00,66,240,55307,164248,306,219555,TUESDAY,0,0,5.6,29,29.5,1003.2,Cloudy
3/19/2024 22:00,51,189,113218,147373,240,260591,TUESDAY,0,0,5.6,29,29.5,1003.2,Cloudy
3/19/2024 23:00,19,87,16765,63102,106,79867,TUESDAY,0,0,5.6,34,14.8,1004.6,Cloudy
3/20/2024 0:00,4,43,3677,25623,47,29300,WEDNESDAY,0,0,5,36,14.8,1005.1,Cloudy
3/20/2024 1:00,5,28,3359,12614,33,15973,WEDNESDAY,0,0,4.4,43,16.6,1005.8,Cloudy
3/20/2024 2:00,4,5,1300,2804,9,4104,WEDNESDAY,0,0,3.9,44,16.6,1005.8,Cloudy
3/20/2024 3:00,4,2,3741,809,6,4550,WEDNESDAY,0,0,3.9,44,16.6,1005.8,Cloudy
3/20/2024 4:00,6,15,4472,8036,21,12508,WEDNESDAY,0,0,3.9,48,13,1005.7,Cloudy
3/20/2024 5:00,9,65,6545,49810,74,56355,WEDNESDAY,0,0,3.3,50,11.2,1005.6,Cloudy
3/20/2024 6:00,28,181,29589,119339,209,148928,WEDNESDAY,0,0,3.3,50,13,1005.1,Cloudy
3/20/2024 7:00,74,521,71753,364557,595,436310,WEDNESDAY,0,0,2.2,54,14.8,1004.9,Cloudy
3/20/2024 8:00,134,1029,119927,706534,1163,826461,WEDNESDAY,0,0,2.2,54,14.8,1004.9,Cloudy
3/20/2024 9:00,104,642,275585,400616,746,676201,WEDNESDAY,0,0,3.3,59,25.9,1005.2,Cloudy
3/20/2024 10:00,74,377,83741,255521,451,339262,WEDNESDAY,0,0,3.9,57,14.8,1005.1,Cloudy
3/20/2024 11:00,87,326,125567,224578,413,350145,WEDNESDAY,0,0,3.9,62,14.8,1005,Cloudy
3/20/2024 12:00,89,367,196363,214817,456,411180,WEDNESDAY,0,0,4.4,62,13,1004.7,Cloudy
3/20/2024 13:00,104,362,259490,208387,466,467877,WEDNESDAY,0,0,4.4,62,13,1004.7,Cloudy
3/20/2024 14:00,130,418,122368,266873,548,389241,WEDNESDAY,0,0,7.2,58,20.5,1003.3,Cloudy
3/20/2024 15:00,141,450,330118,320396,591,650514,WEDNESDAY,0,0,8.3,54,18.4,1002.4,Cloudy
3/20/2024 16:00,183,850,373009,572576,1033,945585,WEDNESDAY,0,0,10,41,27.7,1002.3,Cloudy
3/20/2024 17:00,266,1075,388270,855279,1341,1243549,WEDNESDAY,0,0,10,41,27.7,1002.3,Cloudy
3/20/2024 18:00,155,680,143248,484316,835,627564,WEDNESDAY,0,0,11.7,33,29.5,1001.2,Cloudy
3/20/2024 19:00,42,259,35629,163685,301,199314,WEDNESDAY,0,0,9.4,38,14.8,1001.4,Cloudy
3/20/2024 20:00,21,179,25866,115702,200,141568,WEDNESDAY,0,0,7.8,55,22.3,1001.6,Cloudy
3/20/2024 21:00,23,168,20118,120592,191,140710,WEDNESDAY,0,0,6.7,62,11.2,1001.8,Rain
3/20/2024 22:00,39,174,74959,112667,213,187626,WEDNESDAY,0,0,6.7,62,11.2,1001.8,Cloudy
3/20/2024 23:00,19,86,15895,53586,105,69481,WEDNESDAY,0,0,4.4,83,20.5,1002.1,Cloudy
3/21/2024 0:00,10,40,12650,28383,50,41033,THURSDAY,0,0,4.4,86,29.5,1002.6,Cloudy
3/21/2024 1:00,1,9,703,9536,10,10239,THURSDAY,0,0,3.3,67,29.5,1003.3,Cloudy
3/21/2024 2:00,7,8,15378,9713,15,25091,THURSDAY,0,0,3.3,67,25.9,1003.3,Cloudy
3/21/2024 3:00,0,3,0,2265,3,2265,THURSDAY,0,0,2.8,54,31.7,1004.1,Cloudy
3/21/2024 4:00,2,8,1354,2668,10,4022,THURSDAY,0,0,1.7,47,27.7,1004.9,Cloudy
3/21/2024 5:00,3,46,2672,33355,49,36027,THURSDAY,0,0,0.6,45,46.4,1005.6,Cloudy
3/21/2024 6:00,17,148,13962,97635,165,111597,THURSDAY,0,0,0,47,27.7,1006.2,Fair
3/21/2024 7:00,59,434,38692,282684,493,321376,THURSDAY,0,0,0,47,31.7,1006.5,Fair
3/21/2024 8:00,109,848,84918,604797,957,689715,THURSDAY,0,0,-0.6,45,27.7,1007.7,Fair
3/21/2024 9:00,60,490,139693,318043,550,457736,THURSDAY,0,0,-1.1,44,27.7,1008.3,Fair
3/21/2024 10:00,57,295,48200,162128,352,210328,THURSDAY,0,0,-2.2,40,40.7,1009.6,Cloudy
3/21/2024 11:00,45,279,38548,254951,324,293499,THURSDAY,0,0,-2.2,39,40.7,1010.8,Fair
3/21/2024 12:00,55,316,130988,198776,371,329764,THURSDAY,0,0,-2.2,39,44.6,1010.8,Fair
3/21/2024 13:00,72,342,68677,307984,414,376661,THURSDAY,0,0,-1.1,39,40.7,1011.7,Fair
3/21/2024 14:00,88,325,92757,206165,413,298922,THURSDAY,0,0,0.6,38,33.5,1011.9,Fair
3/21/2024 15:00,88,457,93377,293112,545,386489,THURSDAY,0,0,1.7,33,40.7,1011.8,Fair
3/21/2024 16:00,109,669,181120,432222,778,613342,THURSDAY,0,0,1.7,33,40.7,1011.8,Fair
3/21/2024 17:00,159,857,431942,608109,1016,1040051,THURSDAY,0,0,3.3,30,42.5,1012.2,Fair
3/21/2024 18:00,116,738,212471,601204,854,813675,THURSDAY,0,0,3.9,28,29.5,1012.3,Fair
3/21/2024 19:00,76,444,99453,360550,520,460003,THURSDAY,0,0,3.9,28,29.5,1012.3,Fair
3/21/2024 20:00,43,282,33429,174085,325,207514,THURSDAY,0,0,3.9,27,35.3,1012.8,Fair
3/21/2024 21:00,41,189,27618,217507,230,245125,THURSDAY,0,0,3.3,29,35.3,1013.6,Fair
3/21/2024 22:00,31,137,76231,80965,168,157196,THURSDAY,0,0,2.8,30,38.9,1014.7,Fair
3/21/2024 23:00,17,87,10749,49772,104,60521,THURSDAY,0,0,1.1,32,37.1,1017.7,Fair
3/22/2024 0:00,7,36,101356,21268,43,122624,FRIDAY,0,0,0,36,33.5,1018.9,Fair
3/22/2024 1:00,11,19,7931,11862,30,19793,FRIDAY,0,0,-1.1,39,29.5,1019.9,Clear
3/22/2024 2:00,5,16,5770,9416,21,15186,FRIDAY,0,0,-1.1,39,29.5,1019.9,Clear
3/22/2024 3:00,0,7,0,3082,7,3082,FRIDAY,0,0,-1.7,39,29.5,1021.4,Clear
3/22/2024 4:00,1,7,436,3409,8,3845,FRIDAY,0,0,-1.7,41,25.9,1022,Clear
3/22/2024 5:00,7,43,5796,25968,50,31764,FRIDAY,0,0,-2.2,42,25.9,1023,Fair
3/22/2024 6:00,21,125,29902,70492,146,100394,FRIDAY,0,0,-2.2,40,25.9,1023.6,Clear
3/22/2024 7:00,47,311,36156,214790,358,250946,FRIDAY,0,0,-2.2,40,25.9,1023.6,Clear
3/22/2024 8:00,63,659,49672,496534,722,546206,FRIDAY,0,0,-2.8,42,16.6,1024.2,Clear
3/22/2024 9:00,55,458,42988,274937,513,317925,FRIDAY,0,0,-2.8,41,13,1025.4,Clear
3/22/2024 10:00,55,310,159155,187475,365,346630,FRIDAY,0,0,-3.3,42,16.6,1026.1,Cloudy
3/22/2024 11:00,73,325,130095,197809,398,327904,FRIDAY,0,0,-3.3,42,16.6,1026.1,Fair
3/22/2024 12:00,95,366,109067,226252,461,335319,FRIDAY,0,0,-1.7,30,22.3,1027.9,Fair
3/22/2024 13:00,113,355,148063,212476,468,360539,FRIDAY,0,0,-1.7,28,16.6,1028.2,Fair
3/22/2024 14:00,105,406,99995,240181,511,340176,FRIDAY,0,0,0,25,22.3,1028.3,Fair
3/22/2024 15:00,134,486,124171,290776,620,414947,FRIDAY,0,0,1.1,25,25.9,1027.5,Fair
3/22/2024 16:00,156,625,180128,424160,781,604288,FRIDAY,0,0,1.1,25,25.9,1027.5,Fair
3/22/2024 17:00,174,727,223460,521997,901,745457,FRIDAY,0,0,2.8,20,16.6,1026.4,Cloudy
3/22/2024 18:00,183,596,261912,455976,779,717888,FRIDAY,0,0,3.3,21,14.8,1026.1,Cloudy
3/22/2024 19:00,148,434,244467,306873,582,551340,FRIDAY,0,0,4.4,18,11.2,1025.8,Cloudy
3/22/2024 20:00,93,270,104189,190000,363,294189,FRIDAY,0,0,3.9,21,16.6,1025.7,Cloudy
3/22/2024 21:00,64,226,74793,250066,290,324859,FRIDAY,0,0,3.9,21,16.6,1025.7,Cloudy
3/22/2024 22:00,78,166,103309,107390,244,210699,FRIDAY,0,0,3.3,19,16.6,1026.5,Cloudy
3/22/2024 23:00,46,121,68431,72775,167,141206,FRIDAY,0,0,3.3,21,9.4,1026.8,Cloudy
3/23/2024 0:00,43,103,45900,65221,146,111121,SATURDAY,1,0,3.3,23,5.4,1027.2,Cloudy
3/23/2024 1:00,73,75,69052,53577,148,122629,SATURDAY,1,0,3.3,23,5.4,1027.2,Cloudy
3/23/2024 2:00,32,32,132342,19271,64,151613,SATURDAY,1,0,3.3,30,9.4,1026.6,Cloudy
3/23/2024 3:00,11,7,12548,3181,18,15729,SATURDAY,1,0,2.8,46,7.6,1026.5,Cloudy
3/23/2024 4:00,1,13,449,7403,14,7852,SATURDAY,1,0,1.7,64,13,1026.3,Cloudy
3/23/2024 5:00,3,12,1586,8592,15,10178,SATURDAY,1,0,1.7,64,13,1026.3,Snow
3/23/2024 6:00,7,18,4523,10795,25,15318,SATURDAY,1,0,0,85,11.2,1026.1,Snow
3/23/2024 7:00,8,35,10150,20457,43,30607,SATURDAY,1,0,1.1,88,11.2,1023.9,Snow
3/23/2024 8:00,13,73,13613,48395,86,62008,SATURDAY,1,0,0.6,92,11.2,1023,Snow
3/23/2024 9:00,12,89,17299,139849,101,157148,SATURDAY,1,0,1.7,85,11.2,1022.8,Snow
3/23/2024 10:00,14,73,7954,42084,87,50038,SATURDAY,1,0,2.2,89,20.5,1022.3,Rain
3/23/2024 11:00,24,127,16505,79831,151,96336,SATURDAY,1,0,2.2,89,20.5,1022.3,Snow
3/23/2024 12:00,25,100,35489,52697,125,88186,SATURDAY,1,0,2.8,93,22.3,1020.8,Rain
3/23/2024 13:00,23,133,15458,77503,156,92961,SATURDAY,1,0,2.8,93,22.3,1020.8,Rain
3/23/2024 14:00,16,122,29652,60402,138,90054,SATURDAY,1,0,3.9,96,22.3,1018.1,Rain
3/23/2024 15:00,14,102,17111,70325,116,87436,SATURDAY,1,0,4.4,100,18.4,1017.1,Rain
3/23/2024 16:00,19,89,18455,49728,108,68183,SATURDAY,1,0,4.4,100,18.4,1017.1,Rain
3/23/2024 17:00,16,69,18416,44496,85,62912,SATURDAY,1,0,5.6,100,13,1014.1,Rain
3/23/2024 18:00,2,55,2147,34072,57,36219,SATURDAY,1,0,5.6,100,13,1014.1,Rain
3/23/2024 19:00,3,49,1606,29508,52,31114,SATURDAY,1,0,5.6,96,18.4,1012.1,Rain
3/23/2024 20:00,1,40,649,26611,41,27260,SATURDAY,1,0,5.6,96,20.5,1010.8,Rain
3/23/2024 21:00,5,28,3709,17494,33,21203,SATURDAY,1,0,5.6,100,25.9,1006.2,Rain
3/23/2024 22:00,8,59,8334,35140,67,43474,SATURDAY,1,0,5.6,100,25.9,1006.2,Rain
3/23/2024 23:00,12,58,11003,125833,70,136836,SATURDAY,1,0,3.3,100,35.3,1004.2,Rain
3/24/2024 0:00,23,54,56491,34043,77,90534,SUNDAY,1,0,2.8,100,33.5,1002.8,Rain
3/24/2024 1:00,33,42,127219,28599,75,155818,SUNDAY,1,0,1.7,92,29.5,1003.6,Rain
3/24/2024 2:00,21,22,36294,17438,43,53732,SUNDAY,1,0,1.7,92,25.9,1005.1,Rain
3/24/2024 3:00,7,8,4946,4545,15,9491,SUNDAY,1,0,2.2,89,35.3,1004.6,Rain
3/24/2024 4:00,2,11,2195,6196,13,8391,SUNDAY,1,0,1.1,85,33.5,1005.4,Rain
3/24/2024 5:00,1,10,1831,6150,11,7981,SUNDAY,1,0,0,75,35.3,1009.2,Rain
3/24/2024 6:00,8,25,3619,12202,33,15821,SUNDAY,1,0,0,75,35.3,1009.2,Snow
3/24/2024 7:00,14,63,8959,38181,77,47140,SUNDAY,1,0,-1.1,66,31.7,1012.9,Cloudy
3/24/2024 8:00,23,112,29422,77958,135,107380,SUNDAY,1,0,-2.2,69,31.7,1015.1,Cloudy
3/24/2024 9:00,56,188,74785,102726,244,177511,SUNDAY,1,0,-2.2,66,31.7,1016.5,Cloudy
3/24/2024 10:00,66,272,105559,158673,338,264232,SUNDAY,1,0,-2.8,66,37.1,1018.7,Cloudy
3/24/2024 11:00,102,304,169319,247170,406,416489,SUNDAY,1,0,-2.8,66,35.3,1018.7,Cloudy
3/24/2024 12:00,149,348,189028,217867,497,406895,SUNDAY,1,0,-2.2,55,25.9,1021.7,Cloudy
3/24/2024 13:00,149,393,567520,285078,542,852598,SUNDAY,1,0,-1.1,49,25.9,1023,Cloudy
3/24/2024 14:00,172,407,238618,290895,579,529513,SUNDAY,1,0,0,45,27.7,1024,Cloudy
3/24/2024 15:00,169,378,216521,287499,547,504020,SUNDAY,1,0,0,45,27.7,1024,Cloudy
3/24/2024 16:00,171,395,246153,294429,566,540582,SUNDAY,1,0,2.8,34,20.5,1025.2,Cloudy
3/24/2024 17:00,132,455,137496,320487,587,457983,SUNDAY,1,0,2.8,34,20.5,1025.2,Cloudy
3/24/2024 18:00,164,423,221708,278581,587,500289,SUNDAY,1,0,5.6,30,18.4,1024.8,Cloudy
3/24/2024 19:00,57,321,67254,211489,378,278743,SUNDAY,1,0,5,29,16.6,1025.3,Cloudy
3/24/2024 20:00,53,211,53276,118298,264,171574,SUNDAY,1,0,5,29,16.6,1025.3,Cloudy
3/24/2024 21:00,34,173,24284,100552,207,124836,SUNDAY,1,0,4.4,34,20.5,1026.8,Cloudy
3/24/2024 22:00,25,94,13422,59873,119,73295,SUNDAY,1,0,3.3,44,18.4,1027.8,Cloudy
3/24/2024 23:00,16,76,9838,39986,92,49824,SUNDAY,1,0,3.3,40,16.6,1028.8,Cloudy
3/25/2024 0:00,9,42,6630,21547,51,28177,MONDAY,0,0,2.2,50,11.2,1030.2,Cloudy
3/25/2024 1:00,6,20,7299,11909,26,19208,MONDAY,0,0,2.2,50,11.2,1030.2,Cloudy
3/25/2024 2:00,2,9,49979,5636,11,55615,MONDAY,0,0,0.6,61,11.2,1030.9,Cloudy
3/25/2024 3:00,0,1,0,1681,1,1681,MONDAY,0,0,0.6,61,11.2,1030.9,Cloudy
3/25/2024 4:00,9,10,5327,4709,19,10036,MONDAY,0,0,1.1,59,13,1030.8,Cloudy
3/25/2024 5:00,7,53,3456,34845,60,38301,MONDAY,0,0,1.1,61,13,1031.2,Cloudy
3/25/2024 6:00,15,150,11691,96310,165,108001,MONDAY,0,0,0.6,69,20.5,1031.2,Cloudy
3/25/2024 7:00,32,416,23500,269038,448,292538,MONDAY,0,0,1.7,64,20.5,1031.9,Cloudy
3/25/2024 8:00,61,752,44262,523516,813,567778,MONDAY,0,0,1.7,64,20.5,1031.9,Cloudy
3/25/2024 9:00,64,431,47073,277096,495,324169,MONDAY,0,0,1.7,64,29.5,1032.9,Cloudy
3/25/2024 10:00,51,243,90039,252111,294,342150,MONDAY,0,0,2.2,59,25.9,1033.1,Cloudy
3/25/2024 11:00,62,288,148463,176804,350,325267,MONDAY,0,0,2.2,67,29.5,1033.6,Cloudy
3/25/2024 12:00,57,294,72313,162280,351,234593,MONDAY,0,0,3.3,62,29.5,1033.8,Cloudy
3/25/2024 13:00,76,265,85707,158264,341,243971,MONDAY,0,0,3.9,59,37.1,1034.2,Cloudy
3/25/2024 14:00,62,302,61408,189455,364,250863,MONDAY,0,0,3.9,59,33.5,1034.2,Cloudy
3/25/2024 15:00,71,379,86314,241453,450,327767,MONDAY,0,0,4.4,55,33.5,1034.7,Cloudy
3/25/2024 16:00,105,592,136988,391984,697,528972,MONDAY,0,0,4.4,55,33.5,1034.5,Cloudy
3/25/2024 17:00,130,895,136660,604046,1025,740706,MONDAY,0,0,4.4,57,31.7,1033.8,Cloudy
3/25/2024 18:00,114,663,100665,433843,777,534508,MONDAY,0,0,4.4,57,31.7,1033.8,Cloudy
3/25/2024 19:00,74,459,58221,284744,533,342965,MONDAY,0,0,5,55,35.3,1032.6,Cloudy
3/25/2024 20:00,42,295,28682,172239,337,200921,MONDAY,0,0,4.4,60,35.3,1031.9,Cloudy
3/25/2024 21:00,37,209,124685,139295,246,263980,MONDAY,0,0,3.9,62,33.5,1032,Cloudy
3/25/2024 22:00,27,128,18479,71907,155,90386,MONDAY,0,0,2.8,64,31.7,1032.1,Cloudy
3/25/2024 23:00,10,71,6606,42606,81,49212,MONDAY,0,0,2.8,64,31.7,1032.1,Cloudy
3/26/2024 0:00,8,35,4900,19854,43,24754,TUESDAY,0,0,2.8,67,31.7,1032.2,Cloudy
3/26/2024 1:00,8,16,5855,8632,24,14487,TUESDAY,0,0,2.2,67,29.5,1031.4,Cloudy
3/26/2024 2:00,3,6,1140,1744,9,2884,TUESDAY,0,0,2.2,67,27.7,1031.4,Cloudy
3/26/2024 3:00,4,5,2496,2856,9,5352,TUESDAY,0,0,2.8,67,31.7,1030.4,Cloudy
3/26/2024 4:00,4,9,1821,6275,13,8096,TUESDAY,0,0,2.8,70,27.7,1029.9,Fair
3/26/2024 5:00,10,67,4403,40732,77,45135,TUESDAY,0,0,2.8,70,24.1,1029.3,Fair
3/26/2024 6:00,24,185,29954,112877,209,142831,TUESDAY,0,0,2.8,67,27.7,1027.9,Fair
3/26/2024 7:00,52,439,45039,310870,491,355909,TUESDAY,0,0,2.8,67,25.9,1027.1,Cloudy
3/26/2024 8:00,95,948,162638,768612,1043,931250,TUESDAY,0,0,2.8,70,25.9,1026,Cloudy
3/26/2024 9:00,45,411,40551,270239,456,310790,TUESDAY,0,0,2.8,72,29.5,1026.3,Cloudy
3/26/2024 10:00,45,281,46726,180897,326,227623,TUESDAY,0,0,1.7,85,25.9,1026.8,Cloudy
3/26/2024 11:00,47,244,35619,158530,291,194149,TUESDAY,0,0,1.7,85,25.9,1026.8,Cloudy
3/26/2024 12:00,60,268,59807,169319,328,229126,TUESDAY,0,0,1.7,85,25.9,1027.3,Cloudy
3/26/2024 13:00,66,299,59523,176325,365,235848,TUESDAY,0,0,2.2,92,29.5,1026.9,Cloudy
3/26/2024 14:00,60,315,52323,189592,375,241915,TUESDAY,0,0,2.8,85,27.7,1027.2,Cloudy
3/26/2024 15:00,69,402,87619,255526,471,343145,TUESDAY,0,0,2.8,85,27.7,1026.3,Cloudy
3/26/2024 16:00,102,625,96087,545039,727,641126,TUESDAY,0,0,2.8,85,37.1,1026.3,Cloudy
3/26/2024 17:00,124,793,167479,953852,917,1121331,TUESDAY,0,0,2.8,82,37.1,1025.5,Cloudy
3/26/2024 18:00,103,617,81002,418855,720,499857,TUESDAY,0,0,3.3,83,27.7,1024.8,Cloudy
3/26/2024 19:00,54,380,90770,234290,434,325060,TUESDAY,0,0,3.3,83,27.7,1024.6,Cloudy
3/26/2024 20:00,36,259,37058,163169,295,200227,TUESDAY,0,0,2.8,93,29.5,1024.2,Cloudy
3/26/2024 21:00,20,214,16459,132849,234,149308,TUESDAY,0,0,2.8,96,25.9,1024.1,Rain
3/26/2024 22:00,15,94,16632,101569,109,118201,TUESDAY,0,0,2.8,96,25.9,1024.1,Cloudy
3/26/2024 23:00,19,64,18962,81949,83,100911,TUESDAY,0,0,2.8,96,22.3,1022.6,Cloudy
3/27/2024 0:00,10,29,5664,12541,39,18205,WEDNESDAY,0,0,3.3,93,20.5,1022.9,Cloudy
3/27/2024 1:00,5,9,4150,2721,14,6871,WEDNESDAY,0,0,3.3,93,20.5,1022.9,Cloudy
3/27/2024 2:00,1,9,390,4885,10,5275,WEDNESDAY,0,0,3.3,97,22.3,1022.3,Cloudy
3/27/2024 3:00,0,5,0,3241,5,3241,WEDNESDAY,0,0,3.9,96,24.1,1022,Cloudy
3/27/2024 4:00,3,9,1632,4098,12,5730,WEDNESDAY,0,0,3.9,96,14.8,1021.9,Cloudy
3/27/2024 5:00,11,63,6827,39234,74,46061,WEDNESDAY,0,0,3.9,96,16.6,1019.9,Cloudy
3/27/2024 6:00,25,172,16627,109804,197,126431,WEDNESDAY,0,0,3.9,100,14.8,1019.9,Cloudy
3/27/2024 7:00,41,435,26988,286813,476,313801,WEDNESDAY,0,0,3.9,100,14.8,1019.9,Cloudy
3/27/2024 8:00,96,851,76906,593542,947,670448,WEDNESDAY,0,0,4.4,97,14.8,1018.7,Cloudy
3/27/2024 9:00,90,548,88723,351865,638,440588,WEDNESDAY,0,0,4.4,100,14.8,1019.5,Cloudy
3/27/2024 10:00,67,331,85545,225976,398,311521,WEDNESDAY,0,0,4.4,100,14.8,1019.5,Cloudy
3/27/2024 11:00,86,340,136631,195942,426,332573,WEDNESDAY,0,0,4.4,100,14.8,1020.5,Cloudy
3/27/2024 12:00,81,363,102447,301201,444,403648,WEDNESDAY,0,0,4.4,100,14.8,1020.5,Cloudy
3/27/2024 13:00,98,334,169556,313487,432,483043,WEDNESDAY,0,0,6.1,89,7.6,1020.6,Cloudy
3/27/2024 14:00,140,404,210696,319082,544,529778,WEDNESDAY,0,0,6.1,86,7.6,1020.6,Cloudy
3/27/2024 15:00,160,438,400943,311549,598,712492,WEDNESDAY,0,0,6.7,85,7.6,1020.3,Cloudy
3/27/2024 16:00,157,792,267778,571488,949,839266,WEDNESDAY,0,0,7.2,86,5.4,1020.4,Cloudy
3/27/2024 17:00,239,1049,308135,934866,1288,1243001,WEDNESDAY,0,0,7.8,86,13,1019.4,Cloudy
3/27/2024 18:00,171,732,165746,521246,903,686992,WEDNESDAY,0,0,7.8,86,13,1019.2,Rain
3/27/2024 19:00,139,540,232828,354491,679,587319,WEDNESDAY,0,0,7.8,83,11.2,1018.7,Rain
3/27/2024 20:00,63,348,57902,224697,411,282599,WEDNESDAY,0,0,6.1,86,14.8,1018.4,Rain
3/27/2024 21:00,49,238,40544,208960,287,249504,WEDNESDAY,0,0,6.1,86,5.4,1019.5,Rain
3/27/2024 22:00,25,100,19702,61585,125,81287,WEDNESDAY,0,0,6.1,86,5.4,1019.5,Rain
3/27/2024 23:00,16,64,19720,39808,80,59528,WEDNESDAY,0,0,6.1,89,5.4,1018.7,Rain
3/28/2024 0:00,16,37,20051,32215,53,52266,THURSDAY,0,0,6.1,89,0,1019,Rain
3/28/2024 1:00,12,17,44219,7881,29,52100,THURSDAY,0,0,6.1,89,9.4,1018.8,Rain
3/28/2024 2:00,4,11,1350,5820,15,7170,THURSDAY,0,0,6.1,89,9.4,1018.8,Rain
3/28/2024 3:00,5,4,17371,2358,9,19729,THURSDAY,0,0,6.7,93,9.4,1017.7,Rain
3/28/2024 4:00,2,6,793,2873,8,3666,THURSDAY,0,0,6.7,93,9.4,1017.7,Rain
3/28/2024 5:00,3,13,3166,8547,16,11713,THURSDAY,0,0,6.1,100,7.6,1016.8,Rain
3/28/2024 6:00,6,71,3897,43964,77,47861,THURSDAY,0,0,6.1,100,0,1017,Rain
3/28/2024 7:00,21,169,17785,117782,190,135567,THURSDAY,0,0,6.1,100,0,1017,Rain
3/28/2024 8:00,36,328,28438,209286,364,237724,THURSDAY,0,0,7.8,96,7.6,1016.6,Rain
3/28/2024 9:00,32,243,24191,155747,275,179938,THURSDAY,0,0,8.3,100,0,1016.6,Rain
3/28/2024 10:00,25,151,19696,92244,176,111940,THURSDAY,0,0,8.3,100,0,1016.6,Rain
3/28/2024 11:00,17,130,12179,70537,147,82716,THURSDAY,0,0,7.2,100,0,1015.9,Rain
3/28/2024 12:00,17,121,15855,61422,138,77277,THURSDAY,0,0,7.8,100,0,1014.5,Rain
3/28/2024 13:00,27,116,29085,77232,143,106317,THURSDAY,0,0,8.3,100,0,1013.7,Rain
3/28/2024 14:00,24,170,23295,104951,194,128246,THURSDAY,0,0,7.2,100,7.6,1014.2,Rain
3/28/2024 15:00,30,148,19083,103561,178,122644,THURSDAY,0,0,7.2,100,7.6,1014.2,Rain
3/28/2024 16:00,41,271,128125,189276,312,317401,THURSDAY,0,0,7.8,100,9.4,1013.2,Rain
3/28/2024 17:00,58,357,61310,246287,415,307597,THURSDAY,0,0,7.8,100,9.4,1013.2,Rain
3/28/2024 18:00,42,269,38459,192114,311,230573,THURSDAY,0,0,8.9,93,0,1011.8,Rain
3/28/2024 19:00,25,170,17057,117893,195,134950,THURSDAY,0,0,9.4,97,9.4,1010.3,Rain
3/28/2024 20:00,13,132,13203,96039,145,109242,THURSDAY,0,0,10,100,0,1010.3,Rain
3/28/2024 21:00,20,95,81853,59725,115,141578,THURSDAY,0,0,10,100,0,1010.3,Rain
3/28/2024 22:00,9,54,6137,34119,63,40256,THURSDAY,0,0,10,100,11.2,1010.5,Rain
3/28/2024 23:00,6,31,2771,17510,37,20281,THURSDAY,0,0,9.4,97,11.2,1008.6,Rain
3/29/2024 0:00,15,31,101095,18597,46,119692,FRIDAY,0,0,9.4,93,14.8,1009.3,Rain
3/29/2024 1:00,16,14,12720,11547,30,24267,FRIDAY,0,0,9.4,93,14.8,1009.3,Rain
3/29/2024 2:00,6,12,2270,5998,18,8268,FRIDAY,0,0,8.3,97,14.8,1007.6,Rain
3/29/2024 3:00,2,2,710,508,4,1218,FRIDAY,0,0,8.3,97,18.4,1007.2,Rain
3/29/2024 4:00,0,4,0,1708,4,1708,FRIDAY,0,0,7.8,93,18.4,1006.1,Rain
3/29/2024 5:00,5,28,2644,14492,33,17136,FRIDAY,0,0,7.8,93,18.4,1006.1,Rain
3/29/2024 6:00,7,58,6011,35882,65,41893,FRIDAY,0,0,7.2,90,25.9,1005.1,Rain
3/29/2024 7:00,9,133,4639,86981,142,91620,FRIDAY,0,0,6.1,89,22.3,1004.5,Rain
3/29/2024 8:00,24,241,20291,161422,265,181713,FRIDAY,0,0,5,93,22.3,1003.7,Rain
3/29/2024 9:00,28,245,23208,150082,273,173290,FRIDAY,0,0,5,86,24.1,1003,Rain
3/29/2024 10:00,23,139,15207,66890,162,82097,FRIDAY,0,0,4.4,86,24.1,1002.8,Rain
3/29/2024 11:00,34,174,32204,112459,208,144663,FRIDAY,0,0,4.4,86,24.1,1002.8,Rain
3/29/2024 12:00,49,253,46366,241586,302,287952,FRIDAY,0,0,3.3,89,25.9,1002.1,Rain
3/29/2024 13:00,117,347,216150,223915,464,440065,FRIDAY,0,0,3.9,89,25.9,1001.5,Rain
3/29/2024 14:00,102,379,192971,292995,481,485966,FRIDAY,0,0,3.3,89,25.9,1000.8,Rain
3/29/2024 15:00,163,406,356585,264348,569,620933,FRIDAY,0,0,4.4,86,31.7,1000,Rain
3/29/2024 16:00,167,542,167338,382970,709,550308,FRIDAY,0,0,4.4,86,27.7,1000,Rain
3/29/2024 17:00,228,729,234485,542588,957,777073,FRIDAY,0,0,7.8,76,22.3,997.3,Rain
3/29/2024 18:00,187,584,201298,409667,771,610965,FRIDAY,0,0,10,41,31.7,996.9,Rain
3/29/2024 19:00,143,466,136550,310804,609,447354,FRIDAY,0,0,10,37,31.7,996.7,Cloudy
3/29/2024 20:00,99,288,271490,178698,387,450188,FRIDAY,0,0,10,33,35.3,996.9,Cloudy
3/29/2024 21:00,65,237,275553,153898,302,429451,FRIDAY,0,0,10,33,38.9,996.9,Cloudy
3/29/2024 22:00,83,187,82291,122884,270,205175,FRIDAY,0,0,9.4,32,35.3,997.8,Cloudy
3/29/2024 23:00,54,117,61658,76702,171,138360,FRIDAY,0,0,8.9,34,42.5,998.5,Cloudy
3/30/2024 0:00,60,96,63518,70325,156,133843,SATURDAY,1,0,8.3,39,40.7,999.4,Cloudy
3/30/2024 1:00,62,77,74663,42853,139,117516,SATURDAY,1,0,6.7,41,44.6,1000.1,Cloudy
3/30/2024 2:00,27,38,41554,29896,65,71450,SATURDAY,1,0,6.7,41,44.6,1000.1,Cloudy
3/30/2024 3:00,12,8,13202,5520,20,18722,SATURDAY,1,0,5.6,44,29.5,1000.8,Fair
3/30/2024 4:00,5,11,3417,6028,16,9445,SATURDAY,1,0,5,46,29.5,1000.9,Fair
3/30/2024 5:00,6,22,4723,16361,28,21084,SATURDAY,1,0,4.4,48,25.9,1000.7,Fair
3/30/2024 6:00,12,48,8566,26726,60,35292,SATURDAY,1,0,4.4,48,25.9,1000.7,Fair
3/30/2024 7:00,24,82,25212,75793,106,101005,SATURDAY,1,0,4.4,48,29.5,1000.7,Fair
3/30/2024 8:00,48,160,96705,113123,208,209828,SATURDAY,1,0,4.4,48,27.7,1000.9,Fair
3/30/2024 9:00,87,220,164418,162869,307,327287,SATURDAY,1,0,3.9,50,33.5,1001.5,Fair
3/30/2024 10:00,164,347,349770,247151,511,596921,SATURDAY,1,0,3.9,50,33.5,1001.8,Fair
3/30/2024 11:00,214,376,384619,271695,590,656314,SATURDAY,1,0,3.9,50,37.1,1001.8,Fair
3/30/2024 12:00,307,433,589699,408138,740,997837,SATURDAY,1,0,5.6,44,33.5,1002.5,Fair
3/30/2024 13:00,358,472,663392,367669,830,1031061,SATURDAY,1,0,6.7,41,44.6,1003,Fair
3/30/2024 14:00,441,523,880808,438074,964,1318882,SATURDAY,1,0,7.8,40,29.5,1003.2,Fair
3/30/2024 15:00,442,514,920832,456521,956,1377353,SATURDAY,1,0,8.3,40,22.3,1003.1,Fair
3/30/2024 16:00,450,514,1042148,467522,964,1509670,SATURDAY,1,0,8.3,40,22.3,1003.1,Fair
3/30/2024 17:00,430,501,1124865,417317,931,1542182,SATURDAY,1,0,11.1,34,35.3,1002.6,Fair
3/30/2024 18:00,429,568,641758,478474,997,1120232,SATURDAY,1,0,12.8,31,25.9,1001.9,Fair
3/30/2024 19:00,231,348,501990,329585,579,831575,SATURDAY,1,0,12.8,31,22.3,1001.8,Fair
3/30/2024 20:00,164,273,218213,251916,437,470129,SATURDAY,1,0,12.8,31,22.3,1001.8,Fair
3/30/2024 21:00,146,234,419602,316283,380,735885,SATURDAY,1,0,13.9,25,27.7,1001.8,Fair
3/30/2024 22:00,124,186,167067,177418,310,344485,SATURDAY,1,0,12.8,29,20.5,1002.8,Cloudy
3/30/2024 23:00,141,138,233941,330838,279,564779,SATURDAY,1,0,12.2,32,20.5,1003.6,Fair
3/31/2024 0:00,62,105,268594,59907,167,328501,SUNDAY,1,0,11.1,36,18.4,1004.4,Fair
3/31/2024 1:00,79,71,119125,60925,150,180050,SUNDAY,1,0,11.1,36,18.4,1004.4,Cloudy
3/31/2024 2:00,54,43,71898,33532,97,105430,SUNDAY,1,0,10,39,18.4,1004.7,Cloudy
3/31/2024 3:00,7,23,8542,11538,30,20080,SUNDAY,1,0,10,39,18.4,1004.7,Cloudy
3/31/2024 4:00,10,11,13029,8850,21,21879,SUNDAY,1,0,8.9,44,11.2,1005.1,Cloudy
3/31/2024 5:00,7,13,5979,7346,20,13325,SUNDAY,1,0,8.3,42,13,1005.5,Cloudy
3/31/2024 6:00,8,39,2615,21329,47,23944,SUNDAY,1,0,8.3,42,13,1005.5,Cloudy
3/31/2024 7:00,20,57,16206,40369,77,56575,SUNDAY,1,0,7.2,37,14.8,1006.3,Cloudy
3/31/2024 8:00,44,135,48083,99864,179,147947,SUNDAY,1,0,6.7,38,11.2,1007.2,Cloudy
3/31/2024 9:00,90,212,106059,153225,302,259284,SUNDAY,1,0,6.1,39,9.4,1007.2,Cloudy
3/31/2024 10:00,156,335,211863,268700,491,480563,SUNDAY,1,0,6.1,39,9.4,1007.2,Cloudy
3/31/2024 11:00,245,405,412175,294739,650,706914,SUNDAY,1,0,6.1,39,14.8,1009.1,Cloudy
3/31/2024 12:00,260,412,448569,327962,672,776531,SUNDAY,1,0,7.2,40,11.2,1009.4,Cloudy
3/31/2024 13:00,320,493,602427,401679,813,1004106,SUNDAY,1,0,8.3,40,7.6,1009.6,Cloudy
3/31/2024 14:00,343,434,745724,362038,777,1107762,SUNDAY,1,0,10.6,39,5.4,1009.6,Cloudy
3/31/2024 15:00,382,483,733845,415707,865,1149552,SUNDAY,1,0,10.6,39,5.4,1009.6,Cloudy
3/31/2024 16:00,363,467,689776,414005,830,1103781,SUNDAY,1,0,13.3,34,22.3,1009,Cloudy
3/31/2024 17:00,361,476,648571,393244,837,1041815,SUNDAY,1,0,13.9,33,24.1,1008.9,Cloudy
3/31/2024 18:00,295,513,508362,405928,808,914290,SUNDAY,1,0,14.4,32,24.1,1008.9,Cloudy
3/31/2024 19:00,172,395,230746,269211,567,499957,SUNDAY,1,0,15,28,22.3,1009,Cloudy
3/31/2024 20:00,102,235,145257,152094,337,297351,SUNDAY,1,0,15,28,22.3,1009,Fair
3/31/2024 21:00,65,195,71311,122813,260,194124,SUNDAY,1,0,15,28,5.4,1010.4,Fair
3/31/2024 22:00,52,145,80025,88941,197,168966,SUNDAY,1,0,9.4,61,11.2,1011.3,Fair
3/31/2024 23:00,27,76,39276,41309,103,80585,SUNDAY,1,0,6.7,73,11.2,1012.3,Fair
4/1/2024 0:00,25,47,31124,31782,72,62906,MONDAY,0,0,7.2,71,7.6,1013.1,Fair
4/1/2024 1:00,6,23,3360,13890,29,17250,MONDAY,0,0,7.2,71,7.6,1013.1,Fair
4/1/2024 2:00,9,12,16522,6094,21,22616,MONDAY,0,0,5.6,79,11.2,1013.6,Fair
4/1/2024 3:00,7,5,8785,3206,12,11991,MONDAY,0,0,8.9,50,9.4,1014.8,Fair
4/1/2024 4:00,7,14,6811,7791,21,14602,MONDAY,0,0,8.3,52,7.6,1015.2,Fair
4/1/2024 5:00,7,57,4263,34581,64,38844,MONDAY,0,0,8.3,52,7.6,1015.2,Fair
4/1/2024 6:00,27,217,19497,142834,244,162331,MONDAY,0,0,4.4,79,7.6,1015.8,Fair
4/1/2024 7:00,44,462,54341,330196,506,384537,MONDAY,0,0,5,76,5.4,1016,Cloudy
4/1/2024 8:00,84,903,86570,708388,987,794958,MONDAY,0,0,3.9,79,7.6,1015.2,Cloudy
4/1/2024 9:00,89,560,102489,379402,649,481891,MONDAY,0,0,4.4,76,0,1015.8,Cloudy
4/1/2024 10:00,69,325,95462,216016,394,311478,MONDAY,0,0,4.4,76,0,1015.8,Cloudy
4/1/2024 11:00,88,349,120559,303360,437,423919,MONDAY,0,0,6.1,73,5.4,1017.2,Cloudy
4/1/2024 12:00,93,399,117777,235140,492,352917,MONDAY,0,0,6.7,76,5.4,1016.6,Cloudy
4/1/2024 13:00,102,393,129454,257545,495,386999,MONDAY,0,0,7.2,74,13,1017,Cloudy
4/1/2024 14:00,129,415,163354,356213,544,519567,MONDAY,0,0,7.2,80,16.6,1016.4,Cloudy
4/1/2024 15:00,197,572,395819,374833,769,770652,MONDAY,0,0,7.2,80,16.6,1016.4,Cloudy
4/1/2024 16:00,194,826,375302,582684,1020,957986,MONDAY,0,0,7.8,76,14.8,1015.1,Cloudy
4/1/2024 17:00,257,1089,354985,880382,1346,1235367,MONDAY,0,0,8.3,71,13,1014.3,Cloudy
4/1/2024 18:00,225,880,323853,604793,1105,928646,MONDAY,0,0,9.4,69,14.8,1012.9,Cloudy
4/1/2024 19:00,144,572,141398,370599,716,511997,MONDAY,0,0,7.8,79,13,1012.6,Cloudy
4/1/2024 20:00,85,365,101194,230627,450,331821,MONDAY,0,0,7.8,79,13,1012.6,Cloudy
4/1/2024 21:00,54,249,53809,161517,303,215326,MONDAY,0,0,7.8,83,7.6,1012.6,Cloudy
4/1/2024 22:00,43,158,32742,89976,201,122718,MONDAY,0,0,6.7,89,9.4,1013,Cloudy
4/1/2024 23:00,39,93,45570,61882,132,107452,MONDAY,0,0,5.6,92,5.4,1013.4,Cloudy
4/2/2024 0:00,15,55,36899,52737,70,89636,TUESDAY,0,0,5.6,92,7.6,1014.1,Cloudy
4/2/2024 1:00,12,21,24815,13620,33,38435,TUESDAY,0,0,5.6,92,7.6,1014.1,Cloudy
4/2/2024 2:00,5,25,5546,15156,30,20702,TUESDAY,0,0,6.1,89,0,1014.7,Cloudy
4/2/2024 3:00,5,8,9296,4998,13,14294,TUESDAY,0,0,5.6,92,7.6,1014.6,Cloudy
4/2/2024 4:00,3,16,1538,8106,19,9644,TUESDAY,0,0,5.6,89,5.4,1014.8,Cloudy
4/2/2024 5:00,8,71,3477,45362,79,48839,TUESDAY,0,0,5.6,89,5.4,1014.8,Cloudy
4/2/2024 6:00,31,205,20400,146320,236,166720,TUESDAY,0,0,5,93,14.8,1015,Cloudy
4/2/2024 7:00,71,615,48203,434541,686,482744,TUESDAY,0,0,5,96,13,1015.7,Cloudy
4/2/2024 8:00,114,1123,109863,786247,1237,896110,TUESDAY,0,0,5,93,14.8,1016,Cloudy
4/2/2024 9:00,90,648,87218,445788,738,533006,TUESDAY,0,0,5,93,14.8,1016,Cloudy
4/2/2024 10:00,78,362,143701,263049,440,406750,TUESDAY,0,0,5.6,89,14.8,1016.8,Cloudy
4/2/2024 11:00,96,352,217411,238627,448,456038,TUESDAY,0,0,6.1,82,18.4,1017.5,Cloudy
4/2/2024 12:00,114,380,131609,232850,494,364459,TUESDAY,0,0,6.7,79,20.5,1017.6,Cloudy
4/2/2024 13:00,108,377,247936,222354,485,470290,TUESDAY,0,0,7.2,71,20.5,1018.3,Cloudy
4/2/2024 14:00,99,430,206508,262488,529,468996,TUESDAY,0,0,7.2,74,20.5,1018.6,Cloudy
4/2/2024 15:00,120,549,139097,338388,669,477485,TUESDAY,0,0,7.2,74,20.5,1018.6,Cloudy
4/2/2024 16:00,124,870,113697,570170,994,683867,TUESDAY,0,0,8.3,65,22.3,1017.3,Cloudy
4/2/2024 17:00,236,1111,268106,790415,1347,1058521,TUESDAY,0,0,7.2,74,20.5,1016.9,Cloudy
4/2/2024 18:00,148,738,147713,475485,886,623198,TUESDAY,0,0,7.2,74,24.1,1016.3,Rain
4/2/2024 19:00,73,381,49179,232853,454,282032,TUESDAY,0,0,7.2,74,24.1,1016.3,Rain
4/2/2024 20:00,40,258,29484,163862,298,193346,TUESDAY,0,0,6.1,82,25.9,1015.9,Rain
4/2/2024 21:00,41,199,122448,120287,240,242735,TUESDAY,0,0,6.1,82,25.9,1015.9,Rain
4/2/2024 22:00,47,167,49888,96634,214,146522,TUESDAY,0,0,5.6,92,20.5,1015.7,Rain
4/2/2024 23:00,27,91,28580,51103,118,79683,TUESDAY,0,0,5.6,92,20.5,1015.7,Rain
4/3/2024 0:00,8,25,5417,12968,33,18385,WEDNESDAY,0,0,5.6,92,18.4,1016.2,Rain
4/3/2024 1:00,19,19,21952,8501,38,30453,WEDNESDAY,0,0,5.6,82,27.7,1016.5,Rain
4/3/2024 2:00,6,14,3553,7835,20,11388,WEDNESDAY,0,0,5,79,16.6,1016.6,Cloudy
4/3/2024 3:00,2,12,1335,5978,14,7313,WEDNESDAY,0,0,4.4,79,9.4,1016.1,Cloudy
4/3/2024 4:00,5,11,4383,4854,16,9237,WEDNESDAY,0,0,4.4,79,0,1015.2,Cloudy
4/3/2024 5:00,14,72,12565,43819,86,56384,WEDNESDAY,0,0,5,73,0,1015.4,Cloudy
4/3/2024 6:00,29,212,20433,134557,241,154990,WEDNESDAY,0,0,5,73,0,1015.4,Cloudy
4/3/2024 7:00,60,549,67078,391244,609,458322,WEDNESDAY,0,0,4.4,79,13,1013.9,Cloudy
4/3/2024 8:00,138,1075,135532,702137,1213,837669,WEDNESDAY,0,0,5,79,24.1,1013.2,Cloudy
4/3/2024 9:00,71,600,56145,379113,671,435258,WEDNESDAY,0,0,5,82,20.5,1014.1,Cloudy
4/3/2024 10:00,56,322,46513,236545,378,283058,WEDNESDAY,0,0,5,82,20.5,1014.1,Cloudy
4/3/2024 11:00,54,285,55644,183678,339,239322,WEDNESDAY,0,0,5.6,79,27.7,1014.4,Cloudy
4/3/2024 12:00,35,186,44497,110619,221,155116,WEDNESDAY,0,0,5.6,76,27.7,1015.2,Cloudy
4/3/2024 13:00,25,196,16850,107837,221,124687,WEDNESDAY,0,0,6.1,70,27.7,1014.8,Rain
4/3/2024 14:00,51,298,39716,160347,349,200063,WEDNESDAY,0,0,6.1,76,31.7,1014.5,Rain
4/3/2024 15:00,34,237,18579,136458,271,155037,WEDNESDAY,0,0,6.1,76,31.7,1014.5,Rain
4/3/2024 16:00,43,335,30565,301146,378,331711,WEDNESDAY,0,0,5,86,33.5,1014.9,Rain
4/3/2024 17:00,57,462,43257,301544,519,344801,WEDNESDAY,0,0,5,89,38.9,1013.7,Rain
4/3/2024 18:00,58,359,48375,228427,417,276802,WEDNESDAY,0,0,5,89,38.9,1013.7,Rain
4/3/2024 19:00,20,186,14236,99096,206,113332,WEDNESDAY,0,0,4.4,89,38.9,1012.3,Rain
4/3/2024 20:00,16,130,8320,70117,146,78437,WEDNESDAY,0,0,3.9,89,42.5,1011,Rain
4/3/2024 21:00,11,81,5439,44358,92,49797,WEDNESDAY,0,0,3.9,89,48.2,1011,Rain
4/3/2024 22:00,9,40,95916,18606,49,114522,WEDNESDAY,0,0,3.9,89,48.2,1010.2,Rain
4/3/2024 23:00,5,34,1851,18593,39,20444,WEDNESDAY,0,0,3.9,89,48.2,1010.2,Rain
4/4/2024 0:00,1,6,1059,4054,7,5113,THURSDAY,0,0,3.9,89,46.4,1008.7,Rain
4/4/2024 1:00,2,6,594,2469,8,3063,THURSDAY,0,0,3.9,93,51.8,1007.7,Rain
4/4/2024 2:00,0,4,0,4081,4,4081,THURSDAY,0,0,3.9,93,46.4,1006.3,Rain
4/4/2024 3:00,0,3,0,2339,3,2339,THURSDAY,0,0,3.9,93,51.8,1006.3,Rain
4/4/2024 4:00,1,6,315,3719,7,4034,THURSDAY,0,0,3.3,93,51.8,1005.5,Rain
4/4/2024 5:00,3,17,2131,10035,20,12166,THURSDAY,0,0,3.3,93,53.6,1003.7,Rain
4/4/2024 6:00,6,54,4149,31629,60,35778,THURSDAY,0,0,2.2,97,64.8,1000.2,Rain
4/4/2024 7:00,9,127,10084,76794,136,86878,THURSDAY,0,0,2.2,97,61.2,1000.2,Rain
4/4/2024 8:00,15,206,13114,125717,221,138831,THURSDAY,0,0,2.2,97,53.6,999.9,Rain
4/4/2024 9:00,13,116,8681,62813,129,71494,THURSDAY,0,0,2.2,100,63,998.7,Rain
4/4/2024 10:00,15,78,6998,36173,93,43171,THURSDAY,0,0,2.2,97,63,997.3,Snow
4/4/2024 11:00,11,96,7655,53698,107,61353,THURSDAY,0,0,2.2,97,50,993.8,Rain
4/4/2024 12:00,12,113,7570,67374,125,74944,THURSDAY,0,0,2.2,97,55.4,993.1,Rain
4/4/2024 13:00,21,117,13725,57059,138,70784,THURSDAY,0,0,2.2,97,51.8,993.1,Rain
4/4/2024 14:00,17,153,14051,88301,170,102352,THURSDAY,0,0,2.8,96,50,992.5,Rain
4/4/2024 15:00,32,170,24684,96289,202,120973,THURSDAY,0,0,3.3,93,48.2,990.4,Rain
4/4/2024 16:00,24,257,18449,161317,281,179766,THURSDAY,0,0,3.3,97,50,989.5,Rain
4/4/2024 17:00,38,323,27696,256601,361,284297,THURSDAY,0,0,3.9,93,48.2,989,Rain
4/4/2024 18:00,46,320,74803,218305,366,293108,THURSDAY,0,0,3.9,93,48.2,989,Rain
4/4/2024 19:00,32,282,28445,160795,314,189240,THURSDAY,0,0,3.3,89,40.7,989.5,Rain
4/4/2024 20:00,25,235,16219,129197,260,145416,THURSDAY,0,0,2.2,92,25.9,991.7,Rain
4/4/2024 21:00,31,168,25894,100190,199,126084,THURSDAY,0,0,1.7,92,24.1,993.1,Rain
4/4/2024 22:00,27,127,25911,74492,154,100403,THURSDAY,0,0,1.7,92,24.1,993.1,Rain
4/4/2024 23:00,16,79,8765,46956,95,55721,THURSDAY,0,0,1.7,92,27.7,994.8,Rain
4/5/2024 0:00,10,40,40564,20547,50,61111,FRIDAY,0,0,1.7,92,27.7,994.8,Snow
4/5/2024 1:00,11,20,7070,11432,31,18502,FRIDAY,0,0,1.7,89,27.7,995.6,Snow
4/5/2024 2:00,11,16,14142,7688,27,21830,FRIDAY,0,0,2.2,85,20.5,995.6,Snow
4/5/2024 3:00,2,6,2187,2933,8,5120,FRIDAY,0,0,2.2,85,20.5,995.6,Snow
4/5/2024 4:00,2,15,14458,8318,17,22776,FRIDAY,0,0,2.2,85,27.7,996.1,Cloudy
4/5/2024 5:00,7,56,6501,34280,63,40781,FRIDAY,0,0,2.2,85,20.5,996.2,Cloudy
4/5/2024 6:00,17,112,10545,71921,129,82466,FRIDAY,0,0,2.2,85,20.5,996.5,Cloudy
4/5/2024 7:00,52,327,38969,212571,379,251540,FRIDAY,0,0,2.2,85,20.5,996.5,Cloudy
4/5/2024 8:00,93,725,100224,477265,818,577489,FRIDAY,0,0,2.2,85,22.3,996.9,Cloudy
4/5/2024 9:00,74,519,68466,325128,593,393594,FRIDAY,0,0,2.2,85,22.3,996.9,Cloudy
4/5/2024 10:00,77,338,92575,212260,415,304835,FRIDAY,0,0,2.2,82,25.9,997.6,Cloudy
4/5/2024 11:00,81,320,102963,197736,401,300699,FRIDAY,0,0,2.8,78,24.1,997.6,Cloudy
4/5/2024 12:00,88,424,108242,244495,512,352737,FRIDAY,0,0,3.3,73,24.1,997.6,Cloudy
4/5/2024 13:00,103,409,107856,255408,512,363264,FRIDAY,0,0,3.3,73,24.1,997.6,Cloudy
4/5/2024 14:00,95,461,205402,359802,556,565204,FRIDAY,0,0,5,65,24.1,997.7,Cloudy
4/5/2024 15:00,147,541,170900,339374,688,510274,FRIDAY,0,0,6.7,60,22.3,998.3,Cloudy
4/5/2024 16:00,146,704,156285,488192,850,644477,FRIDAY,0,0,6.7,55,24.1,998.5,Cloudy
4/5/2024 17:00,191,815,311277,546978,1006,858255,FRIDAY,0,0,6.7,55,24.1,998.5,Cloudy
4/5/2024 18:00,172,682,170438,483787,854,654225,FRIDAY,0,0,6.7,58,29.5,998.9,Cloudy
4/5/2024 19:00,127,489,202334,325722,616,528056,FRIDAY,0,0,6.7,58,29.5,998.9,Cloudy
4/5/2024 20:00,100,337,112847,226333,437,339180,FRIDAY,0,0,7.2,56,27.7,999.4,Cloudy
4/5/2024 21:00,76,229,113250,140297,305,253547,FRIDAY,0,0,6.7,60,24.1,1000.3,Cloudy
4/5/2024 22:00,66,191,51253,136824,257,188077,FRIDAY,0,0,6.1,65,24.1,1000.9,Cloudy
4/5/2024 23:00,52,161,52697,92088,213,144785,FRIDAY,0,0,6.1,65,31.7,1000.9,Cloudy
4/6/2024 0:00,54,113,39113,71835,167,110948,SATURDAY,1,0,5.6,67,20.5,1001.9,Cloudy
4/6/2024 1:00,58,78,181132,51409,136,232541,SATURDAY,1,0,5,73,24.1,1002.1,Cloudy
4/6/2024 2:00,28,41,25760,24205,69,49965,SATURDAY,1,0,5,73,16.6,1002,Cloudy
4/6/2024 3:00,11,19,11935,9802,30,21737,SATURDAY,1,0,5,73,20.5,1002.1,Cloudy
4/6/2024 4:00,5,14,3329,8990,19,12319,SATURDAY,1,0,5,73,20.5,1002.1,Cloudy
4/6/2024 5:00,6,32,4915,23091,38,28006,SATURDAY,1,0,4.4,76,16.6,1002.2,Cloudy
4/6/2024 6:00,18,48,30996,26019,66,57015,SATURDAY,1,0,3.9,82,16.6,1002.4,Cloudy
4/6/2024 7:00,24,100,49765,63680,124,113445,SATURDAY,1,0,3.9,79,18.4,1002.7,Cloudy
4/6/2024 8:00,53,175,142394,109314,228,251708,SATURDAY,1,0,3.3,79,18.4,1003,Cloudy
4/6/2024 9:00,90,321,81522,224789,411,306311,SATURDAY,1,0,3.3,79,18.4,1003,Cloudy
4/6/2024 10:00,123,403,138146,266092,526,404238,SATURDAY,1,0,2.8,78,11.2,1004.5,Cloudy
4/6/2024 11:00,127,408,140058,274319,535,414377,SATURDAY,1,0,3.9,70,18.4,1004.7,Cloudy
4/6/2024 12:00,111,374,376873,241015,485,617888,SATURDAY,1,0,3.9,70,18.4,1004.7,Cloudy
4/6/2024 13:00,96,384,197844,264335,480,462179,SATURDAY,1,0,4.4,68,20.5,1004.9,Rain
4/6/2024 14:00,148,377,181945,247855,525,429800,SATURDAY,1,0,5.6,62,20.5,1005.8,Rain
4/6/2024 15:00,146,368,268623,259275,514,527898,SATURDAY,1,0,5.6,62,20.5,1005.8,Rain
4/6/2024 16:00,90,347,85378,319327,437,404705,SATURDAY,1,0,5.6,76,18.4,1006.3,Rain
4/6/2024 17:00,150,353,343325,334139,503,677464,SATURDAY,1,0,5.6,76,18.4,1006.3,Rain
4/6/2024 18:00,90,347,134440,244441,437,378881,SATURDAY,1,0,6.1,76,22.3,1006.9,Rain
4/6/2024 19:00,57,199,41575,125193,256,166768,SATURDAY,1,0,6.1,76,27.7,1006.9,Rain
4/6/2024 20:00,49,197,51182,134796,246,185978,SATURDAY,1,0,5.6,79,20.5,1007.8,Rain
4/6/2024 21:00,44,159,30876,94421,203,125297,SATURDAY,1,0,5.6,79,20.5,1007.8,Rain
4/6/2024 22:00,37,125,30624,66531,162,97155,SATURDAY,1,0,4.4,86,20.5,1009.5,Cloudy
4/6/2024 23:00,66,112,249757,167302,178,417059,SATURDAY,1,0,4.4,86,20.5,1009.5,Rain
4/7/2024 0:00,46,82,48521,95299,128,143820,SUNDAY,1,0,4.4,83,27.7,1010.9,Rain
4/7/2024 1:00,49,77,51678,59777,126,111455,SUNDAY,1,0,3.9,86,24.1,1011.4,Rain
4/7/2024 2:00,36,43,40362,36524,79,76886,SUNDAY,1,0,3.3,89,20.5,1011.9,Rain
4/7/2024 3:00,6,20,6802,11030,26,17832,SUNDAY,1,0,3.3,89,20.5,1011.9,Rain
4/7/2024 4:00,6,7,3584,3687,13,7271,SUNDAY,1,0,3.3,83,20.5,1012.2,Cloudy
4/7/2024 5:00,6,22,6533,13857,28,20390,SUNDAY,1,0,3.3,83,20.5,1012.7,Cloudy
4/7/2024 6:00,12,38,14638,25705,50,40343,SUNDAY,1,0,3.3,79,18.4,1012.9,Cloudy
4/7/2024 7:00,22,70,17786,46602,92,64388,SUNDAY,1,0,3.3,79,18.4,1012.9,Cloudy
4/7/2024 8:00,45,159,64017,103764,204,167781,SUNDAY,1,0,3.3,76,24.1,1013.2,Cloudy
4/7/2024 9:00,81,278,210228,176106,359,386334,SUNDAY,1,0,3.3,73,20.5,1013.7,Cloudy
4/7/2024 10:00,95,340,203097,245341,435,448438,SUNDAY,1,0,2.8,72,20.5,1015.2,Cloudy
4/7/2024 11:00,144,383,258385,352685,527,611070,SUNDAY,1,0,3.3,67,18.4,1015.9,Cloudy
4/7/2024 12:00,175,448,291936,303092,623,595028,SUNDAY,1,0,4.4,65,27.7,1016.2,Cloudy
4/7/2024 13:00,184,464,394758,306260,648,701018,SUNDAY,1,0,5.6,59,24.1,1016.6,Cloudy
4/7/2024 14:00,219,480,443038,369740,699,812778,SUNDAY,1,0,5.6,59,24.1,1016.6,Cloudy
4/7/2024 15:00,223,438,386904,330854,661,717758,SUNDAY,1,0,7.2,56,16.6,1017.2,Cloudy
4/7/2024 16:00,202,455,333621,319993,657,653614,SUNDAY,1,0,6.1,62,18.4,1017.4,Cloudy
4/7/2024 17:00,159,503,241209,332697,662,573906,SUNDAY,1,0,6.1,65,14.8,1017.4,Cloudy
4/7/2024 18:00,151,436,195464,271081,587,466545,SUNDAY,1,0,6.1,65,14.8,1017.4,Cloudy
4/7/2024 19:00,80,336,168752,220378,416,389130,SUNDAY,1,0,6.1,70,14.8,1017.1,Cloudy
4/7/2024 20:00,102,281,82254,175121,383,257375,SUNDAY,1,0,5.6,73,13,1017.3,Cloudy
4/7/2024 21:00,55,182,72090,111820,237,183910,SUNDAY,1,0,5.6,70,13,1017.8,Cloudy
4/7/2024 22:00,28,124,22559,74588,152,97147,SUNDAY,1,0,5,73,9.4,1018,Cloudy
4/7/2024 23:00,22,76,29655,41138,98,70793,SUNDAY,1,0,5,73,9.4,1018,Cloudy
4/8/2024 0:00,12,41,7473,26978,53,34451,MONDAY,0,0,5,65,7.6,1018.3,Fair
4/8/2024 1:00,6,29,15074,14466,35,29540,MONDAY,0,0,4.4,73,7.6,1018.4,Fair
4/8/2024 2:00,11,19,6285,10180,30,16465,MONDAY,0,0,3.3,79,9.4,1018.6,Fair
4/8/2024 3:00,2,13,754,6489,15,7243,MONDAY,0,0,3.9,79,7.6,1018.7,Clear
4/8/2024 4:00,3,13,5959,7854,16,13813,MONDAY,0,0,3.9,79,7.6,1018.7,Clear
4/8/2024 5:00,11,63,7146,40276,74,47422,MONDAY,0,0,5,60,16.6,1018.6,Clear
4/8/2024 6:00,18,185,10713,108633,203,119346,MONDAY,0,0,5,57,16.6,1018.6,Clear
4/8/2024 7:00,50,476,41368,329644,526,371012,MONDAY,0,0,5,57,16.6,1018.6,Clear
4/8/2024 8:00,104,879,91133,594120,983,685253,MONDAY,0,0,4.4,57,13,1019,Clear
4/8/2024 9:00,98,503,113798,314452,601,428250,MONDAY,0,0,4.4,57,13,1019,Clear
4/8/2024 10:00,118,322,294157,205872,440,500029,MONDAY,0,0,5,57,16.6,1019.8,Cloudy
4/8/2024 11:00,112,375,176527,264595,487,441122,MONDAY,0,0,6.7,51,18.4,1019.7,Fair
4/8/2024 12:00,172,430,270942,304815,602,575757,MONDAY,0,0,9.4,44,18.4,1019.9,Fair
4/8/2024 13:00,201,510,299481,444844,711,744325,MONDAY,0,0,9.4,44,18.4,1019.9,Fair
4/8/2024 14:00,285,587,501969,552694,872,1054663,MONDAY,0,0,13.9,28,7.6,1019.4,Fair
4/8/2024 15:00,243,597,515979,441321,840,957300,MONDAY,0,0,13.9,34,7.6,1018.9,Fair
4/8/2024 16:00,243,651,476974,580479,894,1057453,MONDAY,0,0,14.4,34,14.8,1018.2,Fair
4/8/2024 17:00,340,996,552577,771234,1336,1323811,MONDAY,0,0,16.7,32,14.8,1017.4,Fair
4/8/2024 18:00,310,796,464400,635375,1106,1099775,MONDAY,0,0,16.7,32,18.4,1017.4,Fair
4/8/2024 19:00,184,542,222634,349776,726,572410,MONDAY,0,0,18.3,19,14.8,1015.7,Fair
4/8/2024 20:00,125,383,178062,254538,508,432600,MONDAY,0,0,18.3,22,20.5,1015.4,Cloudy
4/8/2024 21:00,68,263,59991,178726,331,238717,MONDAY,0,0,18.3,20,14.8,1015.4,Cloudy
4/8/2024 22:00,75,167,76384,105111,242,181495,MONDAY,0,0,17.8,23,9.4,1015.5,Cloudy
4/8/2024 23:00,51,91,82548,54016,142,136564,MONDAY,0,0,17.8,23,9.4,1015.5,Cloudy
4/9/2024 0:00,33,62,40603,40445,95,81048,TUESDAY,0,0,16.1,27,16.6,1016,Cloudy
4/9/2024 1:00,15,33,32596,52097,48,84693,TUESDAY,0,0,15,28,13,1015.9,Cloudy
4/9/2024 2:00,9,21,34457,10647,30,45104,TUESDAY,0,0,13.9,30,9.4,1016,Cloudy
4/9/2024 3:00,0,10,0,6102,10,6102,TUESDAY,0,0,13.9,30,9.4,1016,Cloudy
4/9/2024 4:00,3,14,4375,8574,17,12949,TUESDAY,0,0,13.3,31,14.8,1016.3,Cloudy
4/9/2024 5:00,13,68,6775,36736,81,43511,TUESDAY,0,0,11.7,36,11.2,1016.1,Cloudy
4/9/2024 6:00,32,223,33193,147777,255,180970,TUESDAY,0,0,12.2,34,13,1015.8,Cloudy
4/9/2024 7:00,97,615,68396,522665,712,591061,TUESDAY,0,0,11.1,36,9.4,1015.6,Cloudy
4/9/2024 8:00,162,1164,291361,812482,1326,1103843,TUESDAY,0,0,11.1,36,9.4,1015.6,Cloudy
4/9/2024 9:00,107,708,148080,564549,815,712629,TUESDAY,0,0,11.1,38,9.4,1015.3,Cloudy
4/9/2024 10:00,111,420,162142,275716,531,437858,TUESDAY,0,0,11.1,39,13,1015.8,Cloudy
4/9/2024 11:00,149,405,204955,364082,554,569037,TUESDAY,0,0,12.2,38,14.8,1016.4,Fair
4/9/2024 12:00,173,443,259441,318200,616,577641,TUESDAY,0,0,12.2,38,14.8,1016.4,Fair
4/9/2024 13:00,210,444,441185,396732,654,837917,TUESDAY,0,0,14.4,33,13,1016.6,Fair
4/9/2024 14:00,186,492,425599,406817,678,832416,TUESDAY,0,0,15,34,16.6,1017.3,Fair
4/9/2024 15:00,214,628,311360,577690,842,889050,TUESDAY,0,0,14.4,39,20.5,1017.6,Fair
4/9/2024 16:00,279,896,426675,699230,1175,1125905,TUESDAY,0,0,11.7,52,24.1,1017.8,Fair
4/9/2024 17:00,426,1242,579101,954877,1668,1533978,TUESDAY,0,0,10.6,59,25.9,1018.2,Fair
4/9/2024 18:00,320,948,681156,676238,1268,1357394,TUESDAY,0,0,10.6,59,25.9,1018.2,Fair
4/9/2024 19:00,167,638,151719,454078,805,605797,TUESDAY,0,0,9.4,69,24.1,1018.2,Fair
4/9/2024 20:00,98,413,84396,265963,511,350359,TUESDAY,0,0,8.9,71,18.4,1018.2,Cloudy
4/9/2024 21:00,69,358,68542,214180,427,282722,TUESDAY,0,0,8.3,71,18.4,1018.3,Cloudy
4/9/2024 22:00,45,174,39768,110131,219,149899,TUESDAY,0,0,7.2,76,16.6,1018.8,Cloudy
4/9/2024 23:00,27,87,23972,50356,114,74328,TUESDAY,0,0,7.2,76,16.6,1018.8,Cloudy
4/10/2024 0:00,21,52,19160,20745,73,39905,WEDNESDAY,0,0,6.7,85,13,1019.4,Fair
4/10/2024 1:00,11,20,12910,10217,31,23127,WEDNESDAY,0,0,6.1,82,18.4,1019.6,Fair
4/10/2024 2:00,12,11,17075,7156,23,24231,WEDNESDAY,0,0,6.1,86,7.6,1019.8,Fair
4/10/2024 3:00,7,6,8829,2308,13,11137,WEDNESDAY,0,0,6.1,79,9.4,1020.2,Fair
4/10/2024 4:00,1,10,686,6840,11,7526,WEDNESDAY,0,0,6.1,79,9.4,1020.2,Fair
4/10/2024 5:00,17,66,11462,40024,83,51486,WEDNESDAY,0,0,5.6,85,9.4,1020.8,Fair
4/10/2024 6:00,41,252,42302,175597,293,217899,WEDNESDAY,0,0,4.4,93,11.2,1020.4,Fair
4/10/2024 7:00,97,668,82163,476024,765,558187,WEDNESDAY,0,0,4.4,89,11.2,1020,Fair
4/10/2024 8:00,158,1146,162504,823529,1304,986033,WEDNESDAY,0,0,4.4,89,11.2,1020,Fair
4/10/2024 9:00,123,717,100846,492566,840,593412,WEDNESDAY,0,0,5,79,7.6,1020.6,Fair
4/10/2024 10:00,114,422,332329,280682,536,613011,WEDNESDAY,0,0,5.6,82,9.4,1020.7,Fair
4/10/2024 11:00,111,410,141019,280853,521,421872,WEDNESDAY,0,0,6.7,73,5.4,1021.3,Cloudy
4/10/2024 12:00,121,437,179731,373923,558,553654,WEDNESDAY,0,0,7.8,65,5.4,1021,Cloudy
4/10/2024 13:00,148,403,424803,342081,551,766884,WEDNESDAY,0,0,7.8,65,5.4,1021,Cloudy
4/10/2024 14:00,168,484,200957,317494,652,518451,WEDNESDAY,0,0,9.4,69,20.5,1020.8,Cloudy
4/10/2024 15:00,198,583,264108,356745,781,620853,WEDNESDAY,0,0,10,66,20.5,1020.4,Cloudy
4/10/2024 16:00,228,965,253449,668946,1193,922395,WEDNESDAY,0,0,10.6,66,20.5,1019.9,Cloudy
4/10/2024 17:00,398,1311,530155,976800,1709,1506955,WEDNESDAY,0,0,11.1,69,14.8,1019.6,Cloudy
4/10/2024 18:00,285,951,474749,727065,1236,1201814,WEDNESDAY,0,0,11.1,69,14.8,1019.6,Cloudy
4/10/2024 19:00,143,590,137927,393547,733,531474,WEDNESDAY,0,0,12.2,69,9.4,1019.2,Cloudy
4/10/2024 20:00,120,397,113436,260407,517,373843,WEDNESDAY,0,0,13.9,55,24.1,1018.9,Rain
4/10/2024 21:00,101,318,154279,221226,419,375505,WEDNESDAY,0,0,13.3,62,18.4,1019,Rain
4/10/2024 22:00,112,201,115135,136661,313,251796,WEDNESDAY,0,0,13.3,62,18.4,1019,Cloudy
4/10/2024 23:00,50,101,50822,69027,151,119849,WEDNESDAY,0,0,10,83,16.6,1019.6,Rain
4/11/2024 0:00,25,58,15944,37758,83,53702,THURSDAY,0,0,8.9,86,18.4,1020.1,Rain
4/11/2024 1:00,19,35,51957,24545,54,76502,THURSDAY,0,0,8.3,90,11.2,1020.1,Rain
4/11/2024 2:00,2,11,2652,5687,13,8339,THURSDAY,0,0,7.8,93,11.2,1020.3,Rain
4/11/2024 3:00,10,6,42018,2917,16,44935,THURSDAY,0,0,7.8,93,11.2,1020.3,Rain
4/11/2024 4:00,1,11,659,7080,12,7739,THURSDAY,0,0,7.2,93,13,1019.1,Cloudy
4/11/2024 5:00,13,78,97017,49966,91,146983,THURSDAY,0,0,7.2,93,11.2,1019.1,Rain
4/11/2024 6:00,29,214,17194,152160,243,169354,THURSDAY,0,0,7.2,93,13,1018.5,Cloudy
4/11/2024 7:00,75,581,64975,491077,656,556052,THURSDAY,0,0,7.2,97,14.8,1018.2,Cloudy
4/11/2024 8:00,150,1058,119004,710789,1208,829793,THURSDAY,0,0,7.2,97,14.8,1018.2,Cloudy
4/11/2024 9:00,93,675,78692,414456,768,493148,THURSDAY,0,0,7.2,100,13,1018.2,Cloudy
4/11/2024 10:00,89,392,102726,240310,481,343036,THURSDAY,0,0,7.2,100,9.4,1018.4,Cloudy
4/11/2024 11:00,55,286,67892,168287,341,236179,THURSDAY,0,0,7.8,100,13,1018.7,Cloudy
4/11/2024 12:00,43,250,38770,142379,293,181149,THURSDAY,0,0,7.8,100,11.2,1019,Cloudy
4/11/2024 13:00,55,314,79225,192096,369,271321,THURSDAY,0,0,7.8,100,11.2,1019,Cloudy
4/11/2024 14:00,72,329,65704,213578,401,279282,THURSDAY,0,0,8.3,100,11.2,1019.1,Cloudy
4/11/2024 15:00,106,457,92176,301721,563,393897,THURSDAY,0,0,8.3,100,11.2,1019.1,Rain
4/11/2024 16:00,160,763,293005,539463,923,832468,THURSDAY,0,0,8.9,96,13,1018,Rain
4/11/2024 17:00,225,1110,216462,793496,1335,1009958,THURSDAY,0,0,8.9,96,13,1018,Rain
4/11/2024 18:00,253,892,273673,618489,1145,892162,THURSDAY,0,0,8.3,93,14.8,1017.4,Cloudy
4/11/2024 19:00,144,572,140864,372535,716,513399,THURSDAY,0,0,8.3,93,14.8,1017.4,Cloudy
4/11/2024 20:00,75,354,76885,251604,429,328489,THURSDAY,0,0,8.3,97,9.4,1017.3,Cloudy
4/11/2024 21:00,90,274,93885,184560,364,278445,THURSDAY,0,0,8.3,97,9.4,1017.3,Cloudy
4/11/2024 22:00,98,232,139016,160101,330,299117,THURSDAY,0,0,7.8,96,13,1016.3,Cloudy
4/11/2024 23:00,57,119,52015,69962,176,121977,THURSDAY,0,0,7.2,97,13,1015.2,Cloudy
4/12/2024 0:00,30,57,26788,41452,87,68240,FRIDAY,0,0,7.8,96,11.2,1014.7,Cloudy
4/12/2024 1:00,33,22,118041,14723,55,132764,FRIDAY,0,0,8.3,100,9.4,1014.2,Cloudy
4/12/2024 2:00,17,19,12129,10076,36,22205,FRIDAY,0,0,8.3,100,9.4,1014.2,Cloudy
4/12/2024 3:00,2,8,1903,5171,10,7074,FRIDAY,0,0,9.4,100,16.6,1013,Cloudy
4/12/2024 4:00,3,25,3650,17405,28,21055,FRIDAY,0,0,11.7,100,16.6,1011.7,Cloudy
4/12/2024 5:00,0,18,0,9879,18,9879,FRIDAY,0,0,12.8,100,20.5,1010.6,Rain
4/12/2024 6:00,6,65,3260,38384,71,41644,FRIDAY,0,0,10,100,24.1,1009.1,Cloudy
4/12/2024 7:00,24,164,17624,103195,188,120819,FRIDAY,0,0,13.9,100,25.9,1007.6,Cloudy
4/12/2024 8:00,32,254,29617,162408,286,192025,FRIDAY,0,0,13.9,100,25.9,1007.6,Rain
4/12/2024 9:00,33,193,24639,103210,226,127849,FRIDAY,0,0,14.4,97,27.7,1004.9,Rain
4/12/2024 10:00,27,165,25219,97294,192,122513,FRIDAY,0,0,15,93,38.9,1003.2,Rain
4/12/2024 11:00,56,269,53073,161159,325,214232,FRIDAY,0,0,15,93,38.9,1003.2,Rain
4/12/2024 12:00,84,346,94329,219523,430,313852,FRIDAY,0,0,15,93,40.7,1002.3,Rain
4/12/2024 13:00,75,391,77563,213129,466,290692,FRIDAY,0,0,15.6,93,44.6,1000.6,Rain
4/12/2024 14:00,100,346,99988,273814,446,373802,FRIDAY,0,0,15.6,96,37.1,999.2,Rain
4/12/2024 15:00,124,476,211067,300543,600,511610,FRIDAY,0,0,15.6,93,35.3,997.9,Rain
4/12/2024 16:00,186,636,283585,437992,822,721577,FRIDAY,0,0,15,96,37.1,997,Cloudy
4/12/2024 17:00,246,775,390460,550074,1021,940534,FRIDAY,0,0,15,96,37.1,997,Cloudy
4/12/2024 18:00,269,777,509409,635322,1046,1144731,FRIDAY,0,0,15.6,86,33.5,996.3,Rain
4/12/2024 19:00,222,577,260175,400780,799,660955,FRIDAY,0,0,14.4,90,35.3,994.5,Rain
4/12/2024 20:00,144,412,303684,391546,556,695230,FRIDAY,0,0,14.4,87,35.3,994.3,Rain
4/12/2024 21:00,151,326,247510,199192,477,446702,FRIDAY,0,0,14.4,87,35.3,994.3,Rain
4/12/2024 22:00,138,249,199879,167250,387,367129,FRIDAY,0,0,12.8,87,27.7,995.5,Cloudy
4/12/2024 23:00,117,196,172289,125554,313,297843,FRIDAY,0,0,11.7,89,29.5,997,Cloudy
4/13/2024 0:00,117,145,247394,89630,262,337024,SATURDAY,1,0,11.1,86,24.1,998.3,Fair
4/13/2024 1:00,119,92,193625,63236,211,256861,SATURDAY,1,0,10.6,83,25.9,999,Fair
4/13/2024 2:00,82,50,177679,41101,132,218780,SATURDAY,1,0,10.6,80,20.5,999.3,Fair
4/13/2024 3:00,18,14,73756,20009,32,93765,SATURDAY,1,0,10,83,14.8,999.4,Fair
4/13/2024 4:00,6,14,11599,6900,20,18499,SATURDAY,1,0,10,83,14.8,999.4,Fair
4/13/2024 5:00,4,22,2511,14919,26,17430,SATURDAY,1,0,8.9,86,11.2,999.1,Fair
4/13/2024 6:00,30,81,38825,55078,111,93903,SATURDAY,1,0,7.8,89,14.8,998.6,Fair
4/13/2024 7:00,75,149,94656,105381,224,200037,SATURDAY,1,0,7.8,89,14.8,998.6,Fair
4/13/2024 8:00,112,261,246196,164462,373,410658,SATURDAY,1,0,7.8,89,18.4,997.6,Fair
4/13/2024 9:00,191,421,348793,306243,612,655036,SATURDAY,1,0,7.8,89,18.4,997.6,Fair
4/13/2024 10:00,277,460,666068,338926,737,1004994,SATURDAY,1,0,8.9,86,20.5,997.5,Fair
4/13/2024 11:00,319,609,632993,443851,928,1076844,SATURDAY,1,0,8.9,86,20.5,997.5,Fair
4/13/2024 12:00,403,617,821912,503156,1020,1325068,SATURDAY,1,0,10.6,80,16.6,997.3,Fair
4/13/2024 13:00,405,625,607038,496166,1030,1103204,SATURDAY,1,0,12.8,62,25.9,997,Cloudy
4/13/2024 14:00,471,630,777682,625743,1101,1403425,SATURDAY,1,0,12.2,57,20.5,997,Cloudy
4/13/2024 15:00,458,591,777395,481974,1049,1259369,SATURDAY,1,0,11.7,59,24.1,996.8,Cloudy
4/13/2024 16:00,361,572,584597,461058,933,1045655,SATURDAY,1,0,12.8,52,25.9,996.6,Cloudy
4/13/2024 17:00,340,554,563776,404923,894,968699,SATURDAY,1,0,12.8,43,25.9,996.6,Cloudy
4/13/2024 18:00,306,533,489898,391918,839,881816,SATURDAY,1,0,12.8,45,33.5,996.4,Cloudy
4/13/2024 19:00,244,449,278482,317803,693,596285,SATURDAY,1,0,12.8,45,33.5,996.4,Cloudy
4/13/2024 20:00,119,322,107023,356462,441,463485,SATURDAY,1,0,11.7,48,29.5,997.6,Cloudy
4/13/2024 21:00,150,266,417775,165258,416,583033,SATURDAY,1,0,11.1,44,29.5,998.4,Cloudy
4/13/2024 22:00,127,246,241230,166415,373,407645,SATURDAY,1,0,11.1,44,38.9,998.4,Cloudy
4/13/2024 23:00,93,159,95027,111341,252,206368,SATURDAY,1,0,10.6,48,20.5,1001.3,Cloudy
4/14/2024 0:00,93,138,189197,92250,231,281447,SUNDAY,1,0,9.4,54,25.9,1002.7,Cloudy
4/14/2024 1:00,110,108,158189,69256,218,227445,SUNDAY,1,0,8.9,58,22.3,1003.6,Cloudy
4/14/2024 2:00,56,54,148624,35128,110,183752,SUNDAY,1,0,8.9,58,22.3,1003.6,Cloudy
4/14/2024 3:00,17,13,11994,6909,30,18903,SUNDAY,1,0,8.9,63,18.4,1004.9,Cloudy
4/14/2024 4:00,8,15,7245,8458,23,15703,SUNDAY,1,0,8.9,61,22.3,1005.4,Cloudy
4/14/2024 5:00,8,19,7553,19174,27,26727,SUNDAY,1,0,8.3,65,22.3,1006.1,Cloudy
4/14/2024 6:00,26,58,17615,35946,84,53561,SUNDAY,1,0,8.3,65,22.3,1006.6,Cloudy
4/14/2024 7:00,62,90,85477,62912,152,148389,SUNDAY,1,0,8.3,65,22.3,1006.6,Cloudy
4/14/2024 8:00,140,194,398142,142017,334,540159,SUNDAY,1,0,7.8,68,18.4,1008.1,Cloudy
4/14/2024 9:00,208,357,445656,337680,565,783336,SUNDAY,1,0,7.8,68,20.5,1008.9,Cloudy
4/14/2024 10:00,362,453,626697,447707,815,1074404,SUNDAY,1,0,8.3,61,22.3,1009.9,Cloudy
4/14/2024 11:00,410,527,842459,518670,937,1361129,SUNDAY,1,0,9.4,54,22.3,1010.5,Fair
4/14/2024 12:00,591,622,1103971,792832,1213,1896803,SUNDAY,1,0,9.4,54,22.3,1010.5,Fair
4/14/2024 13:00,472,609,1249461,558203,1081,1807664,SUNDAY,1,0,11.7,47,27.7,1010.8,Fair
4/14/2024 14:00,375,526,746111,405402,901,1151513,SUNDAY,1,0,12.8,40,14.8,1010.3,Fair
4/14/2024 15:00,479,565,915855,472559,1044,1388414,SUNDAY,1,0,13.9,39,27.7,1010,Fair
4/14/2024 16:00,461,611,689870,509571,1072,1199441,SUNDAY,1,0,13.9,39,27.7,1010,Cloudy
4/14/2024 17:00,190,393,297070,366788,583,663858,SUNDAY,1,0,13.9,42,31.7,1009.3,Cloudy
4/14/2024 18:00,146,273,333516,179874,419,513390,SUNDAY,1,0,15,42,22.3,1007.8,Cloudy
4/14/2024 19:00,150,283,223911,206126,433,430037,SUNDAY,1,0,13.9,45,27.7,1007.1,Cloudy
4/14/2024 20:00,123,257,422733,245840,380,668573,SUNDAY,1,0,13.3,49,16.6,1007.2,Rain
4/14/2024 21:00,100,252,189049,186364,352,375413,SUNDAY,1,0,13.3,49,16.6,1007.2,Rain
4/14/2024 22:00,66,152,104627,105793,218,210420,SUNDAY,1,0,11.1,71,7.6,1006.9,Cloudy
4/14/2024 23:00,45,112,138867,118693,157,257560,SUNDAY,1,0,10,80,13,1006.2,Cloudy
4/15/2024 0:00,31,52,87370,42042,83,129412,MONDAY,0,1,9.4,90,0,1007.1,Cloudy
4/15/2024 1:00,28,27,84711,29292,55,114003,MONDAY,0,1,10,80,11.2,1006.6,Cloudy
4/15/2024 2:00,18,22,28370,19250,40,47620,MONDAY,0,1,10,80,11.2,1006.6,Cloudy
4/15/2024 3:00,9,13,25597,8780,22,34377,MONDAY,0,1,9.4,83,7.6,1005.9,Cloudy
4/15/2024 4:00,9,25,9949,12108,34,22057,MONDAY,0,1,9.4,83,0,1004.9,Cloudy
4/15/2024 5:00,28,51,40021,35754,79,75775,MONDAY,0,1,8.9,86,11.2,1005.2,Cloudy
4/15/2024 6:00,70,163,65750,128503,233,194253,MONDAY,0,1,9.4,83,7.6,1005.3,Cloudy
4/15/2024 7:00,107,324,127294,219520,431,346814,MONDAY,0,1,9.4,83,7.6,1005.3,Cloudy
4/15/2024 8:00,196,655,300639,524362,851,825001,MONDAY,0,1,8.9,89,9.4,1006.9,Cloudy
4/15/2024 9:00,306,554,816549,430720,860,1247269,MONDAY,0,1,8.3,90,5.4,1007,Cloudy
4/15/2024 10:00,445,489,1405624,486918,934,1892542,MONDAY,0,1,8.3,93,0,1007.7,Cloudy
4/15/2024 11:00,405,464,1240080,478342,869,1718422,MONDAY,0,1,8.3,93,0,1007.7,Fair
4/15/2024 12:00,480,553,1012937,519137,1033,1532074,MONDAY,0,1,12.8,74,7.6,1008.9,Fair
4/15/2024 13:00,532,592,1209432,520507,1124,1729939,MONDAY,0,1,14.4,70,13,1009.4,Fair
4/15/2024 14:00,674,671,1637209,558199,1345,2195408,MONDAY,0,1,15.6,64,7.6,1009.1,Fair
4/15/2024 15:00,712,786,1854875,644392,1498,2499267,MONDAY,0,1,17.2,58,16.6,1008.5,Fair
4/15/2024 16:00,753,843,1508915,693180,1596,2202095,MONDAY,0,1,17.2,58,16.6,1008.5,Fair
4/15/2024 17:00,718,978,1502733,896028,1696,2398761,MONDAY,0,1,21.1,39,22.3,1007.7,Fair
4/15/2024 18:00,545,883,1232757,688217,1428,1920974,MONDAY,0,1,22.2,31,33.5,1007.2,Fair
4/15/2024 19:00,361,636,548311,468654,997,1016965,MONDAY,0,1,22.2,31,31.7,1007.5,Fair
4/15/2024 20:00,189,413,367356,390207,602,757563,MONDAY,0,1,20.6,35,24.1,1008.5,Fair
4/15/2024 21:00,149,348,279786,299291,497,579077,MONDAY,0,1,20.6,35,24.1,1008.5,Fair
4/15/2024 22:00,80,190,70306,122499,270,192805,MONDAY,0,1,18.9,32,24.1,1010.4,Fair
4/15/2024 23:00,55,116,108488,175307,171,283795,MONDAY,0,1,17.2,33,22.3,1011.8,Fair
4/16/2024 0:00,19,62,60564,35602,81,96166,TUESDAY,0,0,14.4,53,14.8,1013.4,Fair
4/16/2024 1:00,12,27,14504,24229,39,38733,TUESDAY,0,0,12.2,61,11.2,1014.5,Fair
4/16/2024 2:00,7,11,7586,4484,18,12070,TUESDAY,0,0,12.2,61,11.2,1014.5,Fair
4/16/2024 3:00,8,6,30015,4564,14,34579,TUESDAY,0,0,12.8,55,9.4,1015.1,Fair
4/16/2024 4:00,12,15,147147,7593,27,154740,TUESDAY,0,0,12.2,57,9.4,1015.4,Fair
4/16/2024 5:00,14,75,14575,46100,89,60675,TUESDAY,0,0,11.7,59,11.2,1015,Fair
4/16/2024 6:00,42,260,30695,181764,302,212459,TUESDAY,0,0,11.7,59,11.2,1015,Fair
4/16/2024 7:00,98,634,105674,435120,732,540794,TUESDAY,0,0,10.6,63,9.4,1015.5,Fair
4/16/2024 8:00,214,1177,292173,888938,1391,1181111,TUESDAY,0,0,10,63,11.2,1015.7,Fair
4/16/2024 9:00,152,668,248910,506361,820,755271,TUESDAY,0,0,10.6,63,13,1016.5,Fair
4/16/2024 10:00,179,418,348204,309552,597,657756,TUESDAY,0,0,10.6,59,13,1017.1,Cloudy
4/16/2024 11:00,217,402,500057,276762,619,776819,TUESDAY,0,0,10.6,59,13,1017.1,Fair
4/16/2024 12:00,257,522,428360,358135,779,786495,TUESDAY,0,0,13.3,45,16.6,1018,Fair
4/16/2024 13:00,239,469,376200,345468,708,721668,TUESDAY,0,0,15,41,14.8,1018.4,Fair
4/16/2024 14:00,299,491,539975,359156,790,899131,TUESDAY,0,0,16.1,36,14.8,1018.2,Fair
4/16/2024 15:00,328,663,659838,487186,991,1147024,TUESDAY,0,0,17.2,34,22.3,1017.4,Fair
4/16/2024 16:00,392,1020,919985,903430,1412,1823415,TUESDAY,0,0,17.2,34,22.3,1017.4,Fair
4/16/2024 17:00,607,1428,1064199,1185044,2035,2249243,TUESDAY,0,0,18.9,27,25.9,1017,Fair
4/16/2024 18:00,568,1203,929694,1028400,1771,1958094,TUESDAY,0,0,19.4,28,14.8,1017.2,Fair
4/16/2024 19:00,351,836,769026,685405,1187,1454431,TUESDAY,0,0,19.4,25,14.8,1016.8,Fair
4/16/2024 20:00,238,567,294581,494392,805,788973,TUESDAY,0,0,20,23,13,1017,Fair
4/16/2024 21:00,159,406,381580,295641,565,677221,TUESDAY,0,0,20,23,13,1017,Fair
4/16/2024 22:00,136,265,145712,198632,401,344344,TUESDAY,0,0,18.3,26,18.4,1017.7,Cloudy
4/16/2024 23:00,95,192,209318,149763,287,359081,TUESDAY,0,0,18.3,26,18.4,1017.7,Fair
4/17/2024 0:00,23,80,28159,68088,103,96247,WEDNESDAY,0,0,17.2,29,5.4,1019.2,Fair
4/17/2024 1:00,26,43,78660,35352,69,114012,WEDNESDAY,0,0,12.2,57,5.4,1019.6,Fair
4/17/2024 2:00,16,15,24146,12635,31,36781,WEDNESDAY,0,0,12.2,57,5.4,1019.6,Fair
4/17/2024 3:00,3,5,6034,1903,8,7937,WEDNESDAY,0,0,11.7,52,14.8,1021.7,Clear
4/17/2024 4:00,8,16,6029,12911,24,18940,WEDNESDAY,0,0,9.4,63,13,1022.4,Clear
4/17/2024 5:00,12,70,7744,40920,82,48664,WEDNESDAY,0,0,9.4,66,20.5,1022.5,Clear
4/17/2024 6:00,39,251,37433,259892,290,297325,WEDNESDAY,0,0,7.8,73,14.8,1022.3,Fair
4/17/2024 7:00,100,597,85137,421976,697,507113,WEDNESDAY,0,0,7.8,73,14.8,1022.3,Fair
4/17/2024 8:00,168,1126,183018,846061,1294,1029079,WEDNESDAY,0,0,6.7,70,9.4,1023.1,Fair
4/17/2024 9:00,129,728,205087,515462,857,720549,WEDNESDAY,0,0,6.1,70,7.6,1024,Fair
4/17/2024 10:00,125,402,376710,256787,527,633497,WEDNESDAY,0,0,7.2,63,11.2,1024.3,Fair
4/17/2024 11:00,186,460,351117,301027,646,652144,WEDNESDAY,0,0,7.2,63,11.2,1024.3,Fair
4/17/2024 12:00,174,436,331159,273845,610,605004,WEDNESDAY,0,0,8.3,56,9.4,1024.4,Fair
4/17/2024 13:00,190,482,381780,411900,672,793680,WEDNESDAY,0,0,8.9,51,11.2,1024.1,Fair
4/17/2024 14:00,189,513,409106,348932,702,758038,WEDNESDAY,0,0,8.9,58,14.8,1023.4,Fair
4/17/2024 15:00,249,639,434344,428691,888,863035,WEDNESDAY,0,0,9.4,56,14.8,1023.1,Fair
4/17/2024 16:00,249,895,305295,654048,1144,959343,WEDNESDAY,0,0,9.4,56,14.8,1023.1,Fair
4/17/2024 17:00,391,1300,479222,1132832,1691,1612054,WEDNESDAY,0,0,9.4,59,20.5,1021.8,Cloudy
4/17/2024 18:00,297,996,394016,794660,1293,1188676,WEDNESDAY,0,0,9.4,59,20.5,1021.8,Cloudy
4/17/2024 19:00,189,675,179023,562039,864,741062,WEDNESDAY,0,0,8.9,61,33.5,1020.3,Cloudy
4/17/2024 20:00,115,462,204504,361013,577,565517,WEDNESDAY,0,0,8.9,61,33.5,1020.3,Cloudy
4/17/2024 21:00,158,379,198277,284786,537,483063,WEDNESDAY,0,0,8.9,66,25.9,1020,Cloudy
4/17/2024 22:00,71,229,82368,153365,300,235733,WEDNESDAY,0,0,9.4,66,20.5,1020.1,Cloudy
4/17/2024 23:00,71,143,103440,98597,214,202037,WEDNESDAY,0,0,8.9,71,20.5,1020.5,Cloudy
4/18/2024 0:00,28,75,91019,75216,103,166235,THURSDAY,0,0,8.9,71,22.3,1020.5,Cloudy
4/18/2024 1:00,25,51,115674,43278,76,158952,THURSDAY,0,0,8.3,74,22.3,1021.7,Cloudy
4/18/2024 2:00,19,29,26826,30095,48,56921,THURSDAY,0,0,8.3,74,14.8,1022,Cloudy
4/18/2024 3:00,7,8,8437,6507,15,14944,THURSDAY,0,0,8.3,71,13,1022.2,Cloudy
4/18/2024 4:00,4,18,5927,10899,22,16826,THURSDAY,0,0,7.8,71,18.4,1021.9,Cloudy
4/18/2024 5:00,15,80,8945,57878,95,66823,THURSDAY,0,0,7.8,71,18.4,1021.9,Cloudy
4/18/2024 6:00,35,222,23521,151534,257,175055,THURSDAY,0,0,8.3,65,9.4,1020.2,Cloudy
4/18/2024 7:00,96,509,77635,429216,605,506851,THURSDAY,0,0,7.8,76,13,1020,Cloudy
4/18/2024 8:00,122,1041,94910,697624,1163,792534,THURSDAY,0,0,7.8,71,22.3,1020.1,Cloudy
4/18/2024 9:00,74,575,76874,368048,649,444922,THURSDAY,0,0,7.8,71,22.3,1020.1,Cloudy
4/18/2024 10:00,81,413,88483,270483,494,358966,THURSDAY,0,0,7.2,76,25.9,1021.1,Cloudy
4/18/2024 11:00,125,418,159916,268621,543,428537,THURSDAY,0,0,7.2,74,24.1,1021.9,Cloudy
4/18/2024 12:00,129,485,223623,373886,614,597509,THURSDAY,0,0,7.2,74,24.1,1021.9,Cloudy
4/18/2024 13:00,160,415,161584,383867,575,545451,THURSDAY,0,0,7.8,73,16.6,1022,Cloudy
4/18/2024 14:00,128,404,156436,250304,532,406740,THURSDAY,0,0,7.8,73,18.4,1021.8,Cloudy
4/18/2024 15:00,81,325,86284,209740,406,296024,THURSDAY,0,0,7.8,76,18.4,1021.7,Cloudy
4/18/2024 16:00,91,347,102435,209426,438,311861,THURSDAY,0,0,7.8,76,18.4,1021.7,Cloudy
4/18/2024 17:00,138,662,121472,424129,800,545601,THURSDAY,0,0,8.3,74,18.4,1021.9,Cloudy
4/18/2024 18:00,108,523,258188,362893,631,621081,THURSDAY,0,0,7.8,76,16.6,1021.8,Rain
4/18/2024 19:00,89,470,139420,325164,559,464584,THURSDAY,0,0,7.2,82,13,1021.9,Rain
4/18/2024 20:00,69,392,62587,269408,461,331995,THURSDAY,0,0,7.2,86,13,1022.4,Rain
4/18/2024 21:00,79,330,71375,230660,409,302035,THURSDAY,0,0,7.2,86,13,1022.4,Rain
4/18/2024 22:00,76,239,125930,152964,315,278894,THURSDAY,0,0,7.2,86,13,1022.5,Rain
4/18/2024 23:00,40,156,70079,147365,196,217444,THURSDAY,0,0,7.2,80,9.4,1022.5,Rain
4/19/2024 0:00,36,79,44884,134313,115,179197,FRIDAY,0,0,6.7,89,9.4,1022.5,Rain
4/19/2024 1:00,33,45,39132,27359,78,66491,FRIDAY,0,0,6.7,89,9.4,1022.5,Cloudy
4/19/2024 2:00,14,35,21232,23112,49,44344,FRIDAY,0,0,7.2,86,11.2,1023.2,Cloudy
4/19/2024 3:00,8,12,20303,5248,20,25551,FRIDAY,0,0,7.2,86,11.2,1023.2,Cloudy
4/19/2024 4:00,10,10,10179,5358,20,15537,FRIDAY,0,0,7.2,86,11.2,1022.8,Cloudy
4/19/2024 5:00,14,55,26241,36398,69,62639,FRIDAY,0,0,6.7,89,11.2,1022.4,Cloudy
4/19/2024 6:00,37,188,70948,125104,225,196052,FRIDAY,0,0,6.7,89,11.2,1022.4,Cloudy
4/19/2024 7:00,74,443,104243,285687,517,389930,FRIDAY,0,0,6.7,85,13,1022.3,Cloudy
4/19/2024 8:00,131,801,109004,534703,932,643707,FRIDAY,0,0,6.7,85,9.4,1022.7,Cloudy
4/19/2024 9:00,117,660,144716,408290,777,553006,FRIDAY,0,0,6.7,85,9.4,1022.3,Cloudy
4/19/2024 10:00,116,479,185285,303035,595,488320,FRIDAY,0,0,6.7,85,9.4,1022.3,Cloudy
4/19/2024 11:00,160,462,210992,318410,622,529402,FRIDAY,0,0,7.2,80,5.4,1023.5,Cloudy
4/19/2024 12:00,199,529,257956,353822,728,611778,FRIDAY,0,0,7.8,83,11.2,1023.1,Cloudy
4/19/2024 13:00,240,576,489517,412517,816,902034,FRIDAY,0,0,8.9,80,13,1022.6,Cloudy
4/19/2024 14:00,261,516,420583,347477,777,768060,FRIDAY,0,0,10,71,11.2,1022.6,Cloudy
4/19/2024 15:00,323,623,511623,467227,946,978850,FRIDAY,0,0,10,71,11.2,1022.6,Cloudy
4/19/2024 16:00,314,926,693875,685349,1240,1379224,FRIDAY,0,0,10.6,66,29.5,1021.3,Cloudy
4/19/2024 17:00,402,1093,701784,1081064,1495,1782848,FRIDAY,0,0,10.6,68,29.5,1020.3,Cloudy
4/19/2024 18:00,377,924,895513,714976,1301,1610489,FRIDAY,0,0,11.1,66,31.7,1019.9,Cloudy
4/19/2024 19:00,238,655,356636,588256,893,944892,FRIDAY,0,0,11.1,66,37.1,1019.9,Cloudy
4/19/2024 20:00,199,482,457143,504082,681,961225,FRIDAY,0,0,11.7,61,35.3,1018.3,Cloudy
4/19/2024 21:00,152,388,214851,275628,540,490479,FRIDAY,0,0,11.7,56,35.3,1017.9,Cloudy
4/19/2024 22:00,120,278,322497,238044,398,560541,FRIDAY,0,0,11.7,48,27.7,1018.2,Cloudy
4/19/2024 23:00,101,187,154202,141634,288,295836,FRIDAY,0,0,10,58,24.1,1018.1,Cloudy
4/20/2024 0:00,99,134,202177,94545,233,296722,SATURDAY,1,0,10,58,24.1,1018.1,Cloudy
4/20/2024 1:00,112,144,163447,129780,256,293227,SATURDAY,1,0,9.4,56,20.5,1018.8,Cloudy
4/20/2024 2:00,47,53,130529,38097,100,168626,SATURDAY,1,0,9.4,59,20.5,1018.1,Cloudy
4/20/2024 3:00,23,27,112648,27960,50,140608,SATURDAY,1,0,8.9,66,20.5,1017.5,Cloudy
4/20/2024 4:00,5,29,5034,21807,34,26841,SATURDAY,1,0,8.9,71,18.4,1017.1,Cloudy
4/20/2024 5:00,9,25,14685,16218,34,30903,SATURDAY,1,0,8.9,71,18.4,1017.1,Cloudy
4/20/2024 6:00,14,67,26852,35064,81,61916,SATURDAY,1,0,8.9,80,13,1015.6,Cloudy
4/20/2024 7:00,18,87,17972,64481,105,82453,SATURDAY,1,0,8.9,83,16.6,1015.5,Rain
4/20/2024 8:00,11,84,26483,66896,95,93379,SATURDAY,1,0,8.9,83,16.6,1015.5,Rain
4/20/2024 9:00,40,162,31550,103503,202,135053,SATURDAY,1,0,8.9,89,13,1014.6,Rain
4/20/2024 10:00,46,215,41649,132787,261,174436,SATURDAY,1,0,8.9,89,13,1014.6,Rain
4/20/2024 11:00,102,318,138991,197496,420,336487,SATURDAY,1,0,8.9,93,13,1014.1,Rain
4/20/2024 12:00,170,451,219457,323968,621,543425,SATURDAY,1,0,8.9,96,11.2,1013.6,Rain
4/20/2024 13:00,240,581,354171,495354,821,849525,SATURDAY,1,0,10,96,9.4,1013.2,Rain
4/20/2024 14:00,363,658,559329,515343,1021,1074672,SATURDAY,1,0,10,100,13,1012.9,Rain
4/20/2024 15:00,423,649,884089,506873,1072,1390962,SATURDAY,1,0,10,100,13,1012.9,Rain
4/20/2024 16:00,386,668,790404,656806,1054,1447210,SATURDAY,1,0,12.2,86,14.8,1011.2,Rain
4/20/2024 17:00,394,655,667480,583371,1049,1250851,SATURDAY,1,0,13.3,80,11.2,1010.8,Rain
4/20/2024 18:00,407,646,917022,544447,1053,1461469,SATURDAY,1,0,13.9,77,14.8,1009.4,Rain
4/20/2024 19:00,303,629,700846,470154,932,1171000,SATURDAY,1,0,13.9,77,14.8,1009.4,Rain
4/20/2024 20:00,197,338,293787,247796,535,541583,SATURDAY,1,0,14.4,72,9.4,1008.6,Cloudy
4/20/2024 21:00,154,327,332336,710941,481,1043277,SATURDAY,1,0,15,72,14.8,1008.6,Cloudy
4/20/2024 22:00,134,261,398336,220922,395,619258,SATURDAY,1,0,14.4,46,7.6,1008.8,Cloudy
4/20/2024 23:00,179,204,463579,141014,383,604593,SATURDAY,1,0,15,46,14.8,1009.8,Cloudy
4/21/2024 0:00,129,142,172164,87850,271,260014,SUNDAY,1,0,15,41,14.8,1009.8,Cloudy
4/21/2024 1:00,125,107,145132,67073,232,212205,SUNDAY,1,0,10,48,25.9,1012.7,Cloudy
4/21/2024 2:00,56,68,84404,45360,124,129764,SUNDAY,1,0,9.4,50,20.5,1013.3,Fair
4/21/2024 3:00,8,26,6655,16802,34,23457,SUNDAY,1,0,8.3,48,20.5,1014,Fair
4/21/2024 4:00,11,15,12558,6563,26,19121,SUNDAY,1,0,7.8,49,18.4,1013.9,Fair
4/21/2024 5:00,5,31,9764,30766,36,40530,SUNDAY,1,0,7.8,49,18.4,1013.9,Fair
4/21/2024 6:00,15,55,18125,39790,70,57915,SUNDAY,1,0,6.7,49,20.5,1014.2,Clear
4/21/2024 7:00,28,108,31327,62780,136,94107,SUNDAY,1,0,5.6,53,18.4,1013.7,Clear
4/21/2024 8:00,96,244,120037,164676,340,284713,SUNDAY,1,0,5,55,16.6,1013.9,Clear
4/21/2024 9:00,177,329,287000,234659,506,521659,SUNDAY,1,0,5,55,16.6,1013.9,Fair
4/21/2024 10:00,261,498,638708,369477,759,1008185,SUNDAY,1,0,5,55,16.6,1013.9,Cloudy
4/21/2024 11:00,314,558,491825,512124,872,1003949,SUNDAY,1,0,6.7,53,16.6,1015.3,Fair
4/21/2024 12:00,333,640,663581,447185,973,1110766,SUNDAY,1,0,8.3,48,11.2,1015.1,Fair
4/21/2024 13:00,344,581,560497,433975,925,994472,SUNDAY,1,0,10,44,9.4,1014.5,Fair
4/21/2024 14:00,367,546,635020,506916,913,1141936,SUNDAY,1,0,10,42,7.6,1013.7,Cloudy
4/21/2024 15:00,304,545,635448,417757,849,1053205,SUNDAY,1,0,10,42,7.6,1013.7,Cloudy
4/21/2024 16:00,305,604,555017,461363,909,1016380,SUNDAY,1,0,10.6,38,25.9,1012.7,Cloudy
4/21/2024 17:00,225,675,271766,578285,900,850051,SUNDAY,1,0,11.1,35,24.1,1012.3,Cloudy
4/21/2024 18:00,207,547,240107,437098,754,677205,SUNDAY,1,0,10.6,38,20.5,1011.6,Cloudy
4/21/2024 19:00,170,486,185008,329289,656,514297,SUNDAY,1,0,10.6,38,20.5,1011.6,Cloudy
4/21/2024 20:00,97,274,180712,177114,371,357826,SUNDAY,1,0,10.6,36,22.3,1010.9,Cloudy
4/21/2024 21:00,97,257,186629,149966,354,336595,SUNDAY,1,0,10,36,22.3,1010.9,Cloudy
4/21/2024 22:00,61,187,124232,119273,248,243505,SUNDAY,1,0,10,33,25.9,1011,Cloudy
4/21/2024 23:00,31,96,27614,56895,127,84509,SUNDAY,1,0,8.9,37,22.3,1011.7,Cloudy
4/22/2024 0:00,22,76,23278,46504,98,69782,MONDAY,0,0,8.9,37,22.3,1011.7,Cloudy
4/22/2024 1:00,25,44,21802,45318,69,67120,MONDAY,0,0,8.3,40,14.8,1012.3,Cloudy
4/22/2024 2:00,10,15,5704,5506,25,11210,MONDAY,0,0,7.8,43,16.6,1012.4,Cloudy
4/22/2024 3:00,0,11,0,9135,11,9135,MONDAY,0,0,7.2,45,20.5,1012.6,Fair
4/22/2024 4:00,2,11,2493,7492,13,9985,MONDAY,0,0,7.2,45,20.5,1012.6,Fair
4/22/2024 5:00,14,72,9218,44537,86,53755,MONDAY,0,0,6.7,47,16.6,1012.4,Fair
4/22/2024 6:00,24,222,19981,133662,246,153643,MONDAY,0,0,6.1,49,14.8,1012.4,Fair
4/22/2024 7:00,71,529,57663,370056,600,427719,MONDAY,0,0,5.6,53,14.8,1012.9,Clear
4/22/2024 8:00,91,925,116547,635868,1016,752415,MONDAY,0,0,5.6,53,14.8,1013.1,Clear
4/22/2024 9:00,73,575,63197,402266,648,465463,MONDAY,0,0,5.6,53,14.8,1013.1,Clear
4/22/2024 10:00,77,363,83777,241826,440,325603,MONDAY,0,0,6.1,53,18.4,1015.1,Cloudy
4/22/2024 11:00,103,337,261137,233417,440,494554,MONDAY,0,0,6.7,53,18.4,1015.7,Fair
4/22/2024 12:00,118,425,178368,261986,543,440354,MONDAY,0,0,7.8,38,20.5,1015.9,Fair
4/22/2024 13:00,121,426,170138,278199,547,448337,MONDAY,0,0,8.3,31,20.5,1016.5,Fair
4/22/2024 14:00,150,508,228836,373652,658,602488,MONDAY,0,0,8.3,26,33.5,1016.5,Fair
4/22/2024 15:00,191,564,320674,401321,755,721995,MONDAY,0,0,10,22,18.4,1016.6,Fair
4/22/2024 16:00,246,882,467764,711861,1128,1179625,MONDAY,0,0,10.6,24,20.5,1016.6,Fair
4/22/2024 17:00,385,1249,588159,1186550,1634,1774709,MONDAY,0,0,12.2,21,9.4,1016.6,Fair
4/22/2024 18:00,311,1018,504909,1059568,1329,1564477,MONDAY,0,0,12.8,20,14.8,1016.5,Fair
4/22/2024 19:00,173,686,252119,589017,859,841136,MONDAY,0,0,12.8,20,14.8,1016.5,Fair
4/22/2024 20:00,104,458,136784,301834,562,438618,MONDAY,0,0,13.9,18,11.2,1016.7,Fair
4/22/2024 21:00,90,352,174373,206964,442,381337,MONDAY,0,0,11.1,32,5.4,1017.2,Fair
4/22/2024 22:00,62,219,57094,153558,281,210652,MONDAY,0,0,9.4,32,13,1017.8,Fair
4/22/2024 23:00,34,137,112947,100265,171,213212,MONDAY,0,0,8.3,52,11.2,1018.6,Fair
4/23/2024 0:00,7,75,3409,44054,82,47463,TUESDAY,0,0,8.3,56,11.2,1018.6,Fair
4/23/2024 1:00,23,42,46343,23360,65,69703,TUESDAY,0,0,7.2,63,13,1020.3,Fair
4/23/2024 2:00,7,34,4888,38936,41,43824,TUESDAY,0,0,6.7,67,13,1020.5,Fair
4/23/2024 3:00,3,20,2739,18711,23,21450,TUESDAY,0,0,6.1,73,11.2,1020.8,Clear
4/23/2024 4:00,3,25,2964,21986,28,24950,TUESDAY,0,0,6.1,73,11.2,1020.8,Clear
4/23/2024 5:00,14,78,11119,47470,92,58589,TUESDAY,0,0,5.6,76,9.4,1020.6,Clear
4/23/2024 6:00,41,286,38444,201085,327,239529,TUESDAY,0,0,5.6,79,9.4,1020.8,Clear
4/23/2024 7:00,95,614,67223,436973,709,504196,TUESDAY,0,0,5,86,7.6,1021,Clear
4/23/2024 8:00,153,1150,281573,808440,1303,1090013,TUESDAY,0,0,4.4,89,14.8,1021.6,Clear
4/23/2024 9:00,111,752,143834,528563,863,672397,TUESDAY,0,0,4.4,89,14.8,1021.6,Clear
4/23/2024 10:00,99,415,155869,293283,514,449152,TUESDAY,0,0,5,96,7.6,1022.4,Fair
4/23/2024 11:00,109,402,140360,275239,511,415599,TUESDAY,0,0,5,96,7.6,1022.4,Cloudy
4/23/2024 12:00,110,484,149020,349019,594,498039,TUESDAY,0,0,7.8,82,7.6,1023.1,Cloudy
4/23/2024 13:00,174,393,240941,276501,567,517442,TUESDAY,0,0,8.9,80,11.2,1022.7,Fair
4/23/2024 14:00,210,507,412310,365421,717,777731,TUESDAY,0,0,11.7,59,13,1022.1,Fair
4/23/2024 15:00,225,684,409576,500487,909,910063,TUESDAY,0,0,11.7,59,13,1022.1,Fair
4/23/2024 16:00,274,1009,471760,777596,1283,1249356,TUESDAY,0,0,12.2,57,24.1,1020.1,Fair
4/23/2024 17:00,454,1377,607569,1123272,1831,1730841,TUESDAY,0,0,13.3,53,35.3,1019.2,Fair
4/23/2024 18:00,390,1069,774352,895323,1459,1669675,TUESDAY,0,0,13.9,47,33.5,1017.7,Fair
4/23/2024 19:00,224,689,356952,609779,913,966731,TUESDAY,0,0,13.9,47,29.5,1017.7,Fair
4/23/2024 20:00,121,490,194049,424255,611,618304,TUESDAY,0,0,15,36,25.9,1016.6,Fair
4/23/2024 21:00,101,348,266516,296788,449,563304,TUESDAY,0,0,13.9,37,24.1,1016.7,Fair
4/23/2024 22:00,71,221,67173,167640,292,234813,TUESDAY,0,0,12.2,35,24.1,1016.6,Fair
4/23/2024 23:00,38,130,119271,182501,168,301772,TUESDAY,0,0,12.2,35,24.1,1016.6,Fair
4/24/2024 0:00,31,82,90849,72899,113,163748,WEDNESDAY,0,0,8.9,40,20.5,1016.7,Fair
4/24/2024 1:00,15,45,15556,30484,60,46040,WEDNESDAY,0,0,7.8,49,22.3,1016.9,Fair
4/24/2024 2:00,8,26,8276,16254,34,24530,WEDNESDAY,0,0,7.2,56,16.6,1016.3,Fair
4/24/2024 3:00,6,16,2967,11014,22,13981,WEDNESDAY,0,0,7.2,53,16.6,1015.6,Fair
4/24/2024 4:00,3,14,1056,6239,17,7295,WEDNESDAY,0,0,7.2,53,16.6,1015.6,Fair
4/24/2024 5:00,15,77,9791,52794,92,62585,WEDNESDAY,0,0,6.1,60,16.6,1014.3,Fair
4/24/2024 6:00,43,283,29104,199089,326,228193,WEDNESDAY,0,0,6.1,65,13,1013.2,Fair
4/24/2024 7:00,95,559,77050,398700,654,475750,WEDNESDAY,0,0,6.7,60,11.2,1012.3,Cloudy
4/24/2024 8:00,155,1149,133928,769529,1304,903457,WEDNESDAY,0,0,6.7,60,11.2,1012.3,Cloudy
4/24/2024 9:00,104,712,83524,473269,816,556793,WEDNESDAY,0,0,6.7,65,16.6,1011.6,Cloudy
4/24/2024 10:00,69,437,84274,308370,506,392644,WEDNESDAY,0,0,7.8,65,14.8,1010.7,Cloudy
4/24/2024 11:00,95,342,121858,213593,437,335451,WEDNESDAY,0,0,7.8,65,14.8,1010.7,Cloudy
4/24/2024 12:00,92,382,97795,236978,474,334773,WEDNESDAY,0,0,9.4,63,18.4,1009.9,Cloudy
4/24/2024 13:00,101,433,97170,278210,534,375380,WEDNESDAY,0,0,10.6,59,18.4,1009.8,Cloudy
4/24/2024 14:00,155,516,179124,350659,671,529783,WEDNESDAY,0,0,11.7,56,22.3,1009.7,Cloudy
4/24/2024 15:00,201,682,327723,468524,883,796247,WEDNESDAY,0,0,11.7,56,22.3,1009.7,Cloudy
4/24/2024 16:00,215,979,495913,738793,1194,1234706,WEDNESDAY,0,0,11.1,63,18.4,1009.3,Cloudy
4/24/2024 17:00,324,1167,436202,982594,1491,1418796,WEDNESDAY,0,0,12.8,62,18.4,1008.6,Cloudy
4/24/2024 18:00,263,999,533931,777036,1262,1310967,WEDNESDAY,0,0,15,51,18.4,1008.5,Cloudy
4/24/2024 19:00,186,698,199440,536131,884,735571,WEDNESDAY,0,0,17.2,45,18.4,1008,Cloudy
4/24/2024 20:00,90,468,175712,314978,558,490690,WEDNESDAY,0,0,18.3,39,27.7,1007.5,Cloudy
4/24/2024 21:00,103,344,94717,232078,447,326795,WEDNESDAY,0,0,16.7,44,31.7,1009,Cloudy
4/24/2024 22:00,51,264,87981,256828,315,344809,WEDNESDAY,0,0,13.9,62,33.5,1010.6,Cloudy
4/24/2024 23:00,29,136,149282,121205,165,270487,WEDNESDAY,0,0,11.7,54,18.4,1013.9,Cloudy
4/25/2024 0:00,25,69,29496,42265,94,71761,THURSDAY,0,0,11.7,54,31.7,1013.9,Fair
4/25/2024 1:00,20,35,16423,19556,55,35979,THURSDAY,0,0,7.2,49,27.7,1018.3,Fair
4/25/2024 2:00,12,18,12516,11574,30,24090,THURSDAY,0,0,5,45,27.7,1019.7,Fair
4/25/2024 3:00,2,6,496,4724,8,5220,THURSDAY,0,0,3.3,44,18.4,1021.2,Fair
4/25/2024 4:00,2,15,1271,8054,17,9325,THURSDAY,0,0,3.3,44,18.4,1021.2,Clear
4/25/2024 5:00,9,76,6653,45176,85,51829,THURSDAY,0,0,2.8,48,14.8,1023.1,Clear
4/25/2024 6:00,36,217,34765,141059,253,175824,THURSDAY,0,0,2.2,48,20.5,1023.4,Clear
4/25/2024 7:00,75,560,66840,399087,635,465927,THURSDAY,0,0,1.7,47,13,1023.8,Clear
4/25/2024 8:00,137,1022,116869,684517,1159,801386,THURSDAY,0,0,1.1,46,14.8,1024.6,Clear
4/25/2024 9:00,138,659,138139,430698,797,568837,THURSDAY,0,0,1.1,46,14.8,1024.6,Clear
4/25/2024 10:00,93,381,124670,268644,474,393314,THURSDAY,0,0,1.7,38,18.4,1026.3,Cloudy
4/25/2024 11:00,135,430,334739,446330,565,781069,THURSDAY,0,0,2.8,34,16.6,1027,Fair
4/25/2024 12:00,143,489,222662,397860,632,620522,THURSDAY,0,0,4.4,31,5.4,1027.8,Fair
4/25/2024 13:00,208,424,392652,380117,632,772769,THURSDAY,0,0,5,30,9.4,1028.2,Fair
4/25/2024 14:00,166,472,277112,411939,638,689051,THURSDAY,0,0,5,30,9.4,1028.2,Fair
4/25/2024 15:00,232,646,309063,542329,878,851392,THURSDAY,0,0,6.1,39,16.6,1027.9,Fair
4/25/2024 16:00,283,943,386583,736758,1226,1123341,THURSDAY,0,0,7.2,38,16.6,1027.2,Fair
4/25/2024 17:00,453,1354,519161,1076318,1807,1595479,THURSDAY,0,0,8.9,35,18.4,1026.6,Fair
4/25/2024 18:00,384,1065,566293,828455,1449,1394748,THURSDAY,0,0,8.9,35,18.4,1026.6,Fair
4/25/2024 19:00,226,747,358382,659824,973,1018206,THURSDAY,0,0,10,33,18.4,1025.1,Fair
4/25/2024 20:00,116,530,153626,351195,646,504821,THURSDAY,0,0,8.9,50,25.9,1025,Fair
4/25/2024 21:00,95,347,101502,286205,442,387707,THURSDAY,0,0,8.9,54,20.5,1025.1,Fair
4/25/2024 22:00,77,293,66677,193661,370,260338,THURSDAY,0,0,8.3,58,22.3,1025.1,Fair
4/25/2024 23:00,40,153,83038,90608,193,173646,THURSDAY,0,0,8.3,44,24.1,1026,Fair
4/26/2024 0:00,41,79,46159,55882,120,102041,FRIDAY,0,0,8.3,44,24.1,1026,Fair
4/26/2024 1:00,31,42,33109,47553,73,80662,FRIDAY,0,0,6.1,62,22.3,1028.1,Fair
4/26/2024 2:00,17,21,107145,15005,38,122150,FRIDAY,0,0,5.6,64,16.6,1028.6,Fair
4/26/2024 3:00,9,18,9988,14483,27,24471,FRIDAY,0,0,5,70,14.8,1029.1,Clear
4/26/2024 4:00,6,15,5068,7444,21,12512,FRIDAY,0,0,5,70,14.8,1029.1,Clear
4/26/2024 5:00,8,57,96508,36495,65,133003,FRIDAY,0,0,4.4,73,14.8,1029.3,Clear
4/26/2024 6:00,31,188,56168,121289,219,177457,FRIDAY,0,0,4.4,73,20.5,1029.3,Clear
4/26/2024 7:00,65,445,59857,295321,510,355178,FRIDAY,0,0,4.4,73,13,1029.8,Clear
4/26/2024 8:00,132,835,126536,582769,967,709305,FRIDAY,0,0,3.3,76,7.6,1030.3,Clear
4/26/2024 9:00,119,636,231681,457321,755,689002,FRIDAY,0,0,3.3,76,7.6,1030.3,Clear
4/26/2024 10:00,134,440,278102,279500,574,557602,FRIDAY,0,0,3.9,70,9.4,1032,Cloudy
4/26/2024 11:00,141,428,249691,287877,569,537568,FRIDAY,0,0,6.7,65,13,1032.5,Fair
4/26/2024 12:00,208,535,303198,534944,743,838142,FRIDAY,0,0,8.9,51,18.4,1032.9,Fair
4/26/2024 13:00,201,545,318961,459780,746,778741,FRIDAY,0,0,8.9,50,18.4,1033.2,Fair
4/26/2024 14:00,249,570,398618,392749,819,791367,FRIDAY,0,0,8.9,50,18.4,1033.2,Fair
4/26/2024 15:00,322,706,453967,573748,1028,1027715,FRIDAY,0,0,9.4,48,22.3,1032.9,Fair
4/26/2024 16:00,350,914,478715,693009,1264,1171724,FRIDAY,0,0,8.9,51,20.5,1032.4,Fair
4/26/2024 17:00,451,1160,652831,989693,1611,1642524,FRIDAY,0,0,10,44,20.5,1032.3,Fair
4/26/2024 18:00,460,832,630825,648188,1292,1279013,FRIDAY,0,0,10,46,22.3,1031.8,Fair
4/26/2024 19:00,267,634,294707,640731,901,935438,FRIDAY,0,0,10,46,22.3,1031.8,Fair
4/26/2024 20:00,160,399,377826,292421,559,670247,FRIDAY,0,0,10,33,24.1,1031.4,Fair
4/26/2024 21:00,191,361,249203,247053,552,496256,FRIDAY,0,0,10,37,24.1,1031.5,Fair
4/26/2024 22:00,139,256,244773,164196,395,408969,FRIDAY,0,0,9.4,46,18.4,1031.3,Fair
4/26/2024 23:00,81,182,77818,132583,263,210401,FRIDAY,0,0,9.4,46,18.4,1031.3,Fair
4/27/2024 0:00,92,127,109518,85422,219,194940,SATURDAY,1,0,8.9,47,16.6,1031.9,Fair
4/27/2024 1:00,99,83,101871,61548,182,163419,SATURDAY,1,0,8.3,49,18.4,1032.2,Fair
4/27/2024 2:00,73,63,97666,66124,136,163790,SATURDAY,1,0,7.2,49,13,1032.7,Fair
4/27/2024 3:00,3,24,1795,11547,27,13342,SATURDAY,1,0,6.7,55,14.8,1033.1,Clear
4/27/2024 4:00,3,18,2115,14868,21,16983,SATURDAY,1,0,6.7,55,14.8,1033.1,Clear
4/27/2024 5:00,9,27,7727,15531,36,23258,SATURDAY,1,0,6.1,51,14.8,1032.5,Clear
4/27/2024 6:00,18,63,30460,48098,81,78558,SATURDAY,1,0,5.6,62,11.2,1032.4,Clear
4/27/2024 7:00,34,129,52884,96537,163,149421,SATURDAY,1,0,4.4,70,7.6,1032.9,Clear
4/27/2024 8:00,88,243,152511,189959,331,342470,SATURDAY,1,0,3.9,76,13,1032.9,Clear
4/27/2024 9:00,186,369,359139,286815,555,645954,SATURDAY,1,0,3.9,76,13,1032.9,Clear
4/27/2024 10:00,311,470,632922,422102,781,1055024,SATURDAY,1,0,6.1,70,14.8,1034,Fair
4/27/2024 11:00,415,601,958530,957406,1016,1915936,SATURDAY,1,0,7.8,65,7.6,1034,Fair
4/27/2024 12:00,482,670,1167781,512005,1152,1679786,SATURDAY,1,0,9.4,56,0,1033.9,Fair
4/27/2024 13:00,599,674,1131408,615229,1273,1746637,SATURDAY,1,0,11.7,50,5.4,1033.5,Fair
4/27/2024 14:00,634,695,1297453,727419,1329,2024872,SATURDAY,1,0,11.7,50,5.4,1033.5,Fair
4/27/2024 15:00,676,747,1307622,650563,1423,1958185,SATURDAY,1,0,13.9,44,13,1032.1,Fair
4/27/2024 16:00,591,656,1288847,647235,1247,1936082,SATURDAY,1,0,15.6,37,14.8,1031.2,Fair
4/27/2024 17:00,576,620,1108476,622483,1196,1730959,SATURDAY,1,0,13.3,53,14.8,1030.6,Cloudy
4/27/2024 18:00,440,636,1100508,496577,1076,1597085,SATURDAY,1,0,13.3,51,25.9,1029.5,Cloudy
4/27/2024 19:00,404,542,551762,429277,946,981039,SATURDAY,1,0,13.3,51,31.7,1029.5,Cloudy
4/27/2024 20:00,226,353,346839,247381,579,594220,SATURDAY,1,0,12.8,57,18.4,1027.8,Cloudy
4/27/2024 21:00,142,278,156087,186864,420,342951,SATURDAY,1,0,15.6,37,18.4,1027,Cloudy
4/27/2024 22:00,114,229,229336,150266,343,379602,SATURDAY,1,0,15,38,29.5,1026.5,Cloudy
4/27/2024 23:00,147,193,215061,124158,340,339219,SATURDAY,1,0,15,38,29.5,1026.5,Cloudy
4/28/2024 0:00,125,142,235136,98475,267,333611,SUNDAY,1,0,12.8,37,22.3,1026.6,Cloudy
4/28/2024 1:00,140,102,361618,70009,242,431627,SUNDAY,1,0,12.2,34,27.7,1027.1,Cloudy
4/28/2024 2:00,37,42,65264,29382,79,94646,SUNDAY,1,0,11.1,36,24.1,1026.6,Cloudy
4/28/2024 3:00,9,17,8672,14017,26,22689,SUNDAY,1,0,10.6,38,14.8,1026.4,Cloudy
4/28/2024 4:00,4,9,2469,6664,13,9133,SUNDAY,1,0,10.6,38,14.8,1026.4,Cloudy
4/28/2024 5:00,8,15,6290,10906,23,17196,SUNDAY,1,0,10,50,24.1,1025.9,Cloudy
4/28/2024 6:00,12,57,14257,40357,69,54614,SUNDAY,1,0,7.8,73,22.3,1025.7,Cloudy
4/28/2024 7:00,28,96,37393,74090,124,111483,SUNDAY,1,0,7.2,80,22.3,1024.8,Cloudy
4/28/2024 8:00,73,216,78056,148581,289,226637,SUNDAY,1,0,7.2,76,18.4,1024.5,Cloudy
4/28/2024 9:00,155,349,213758,340673,504,554431,SUNDAY,1,0,7.2,80,16.6,1024.2,Cloudy
4/28/2024 10:00,256,441,592940,350381,697,943321,SUNDAY,1,0,7.8,79,14.8,1024,Cloudy
4/28/2024 11:00,341,555,611757,438479,896,1050236,SUNDAY,1,0,7.8,79,14.8,1024,Cloudy
4/28/2024 12:00,442,615,812480,499571,1057,1312051,SUNDAY,1,0,10,71,24.1,1023.6,Cloudy
4/28/2024 13:00,516,632,1206007,517162,1148,1723169,SUNDAY,1,0,11.7,69,25.9,1022.8,Cloudy
4/28/2024 14:00,589,700,1450348,857793,1289,2308141,SUNDAY,1,0,12.2,72,16.6,1021.9,Cloudy
4/28/2024 15:00,624,685,1229066,690284,1309,1919350,SUNDAY,1,0,12.8,72,13,1021.3,Cloudy
4/28/2024 16:00,606,686,1333178,667519,1292,2000697,SUNDAY,1,0,14.4,67,18.4,1019.9,Cloudy
4/28/2024 17:00,554,739,1077944,641272,1293,1719216,SUNDAY,1,0,16.1,62,20.5,1018.6,Cloudy
4/28/2024 18:00,457,619,1148698,479069,1076,1627767,SUNDAY,1,0,16.1,62,20.5,1018.6,Cloudy
4/28/2024 19:00,268,409,387950,341082,677,729032,SUNDAY,1,0,18.9,56,20.5,1016.4,Cloudy
4/28/2024 20:00,128,351,207495,225707,479,433202,SUNDAY,1,0,19.4,57,20.5,1015.7,Cloudy
4/28/2024 21:00,190,291,318239,203981,481,522220,SUNDAY,1,0,18.9,59,14.8,1015.7,Cloudy
4/28/2024 22:00,176,199,552968,326364,375,879332,SUNDAY,1,0,18.3,61,14.8,1015.1,Cloudy
4/28/2024 23:00,95,118,159915,78898,213,238813,SUNDAY,1,0,18.3,61,14.8,1015.1,Cloudy
4/29/2024 0:00,44,85,43422,90073,129,133495,MONDAY,0,0,17.2,67,14.8,1014.7,Cloudy
4/29/2024 1:00,44,28,54135,19965,72,74100,MONDAY,0,0,16.7,70,11.2,1014.4,Cloudy
4/29/2024 2:00,9,12,13842,5491,21,19333,MONDAY,0,0,16.7,70,11.2,1014.4,Cloudy
4/29/2024 3:00,8,9,17164,6095,17,23259,MONDAY,0,0,17.8,73,16.6,1013.6,Cloudy
4/29/2024 4:00,1,14,485,8206,15,8691,MONDAY,0,0,18.3,78,11.2,1013.2,Cloudy
4/29/2024 5:00,13,60,8256,35285,73,43541,MONDAY,0,0,18.3,78,11.2,1013.2,Cloudy
4/29/2024 6:00,34,271,32081,256723,305,288804,MONDAY,0,0,18.3,78,16.6,1012.5,Cloudy
4/29/2024 7:00,110,574,98433,412650,684,511083,MONDAY,0,0,18.3,78,5.4,1013,Cloudy
4/29/2024 8:00,154,1021,230072,758513,1175,988585,MONDAY,0,0,13.9,90,0,1013.6,Cloudy
4/29/2024 9:00,115,593,168576,395537,708,564113,MONDAY,0,0,10,89,0,1013.6,Cloudy
4/29/2024 10:00,166,356,355179,236191,522,591370,MONDAY,0,0,15,81,0,1014.6,Cloudy
4/29/2024 11:00,168,357,298989,228809,525,527798,MONDAY,0,0,19.4,68,16.6,1014.7,Cloudy
4/29/2024 12:00,155,419,225619,257593,574,483212,MONDAY,0,0,20.6,57,22.3,1015.2,Cloudy
4/29/2024 13:00,168,402,291796,262698,570,554494,MONDAY,0,0,20.6,57,22.3,1015.2,Cloudy
4/29/2024 14:00,186,465,249369,287164,651,536533,MONDAY,0,0,13.9,69,29.5,1016.8,Cloudy
4/29/2024 15:00,198,575,277068,377987,773,655055,MONDAY,0,0,12.2,77,18.4,1017.2,Cloudy
4/29/2024 16:00,266,839,377028,606227,1105,983255,MONDAY,0,0,11.1,77,14.8,1017.3,Cloudy
4/29/2024 17:00,388,1215,585298,905921,1603,1491219,MONDAY,0,0,11.1,77,14.8,1017.3,Cloudy
4/29/2024 18:00,358,976,663748,722278,1334,1386026,MONDAY,0,0,12.2,69,13,1016.5,Cloudy
4/29/2024 19:00,266,725,389994,691670,991,1081664,MONDAY,0,0,12.2,69,13,1016.5,Cloudy
4/29/2024 20:00,143,450,297628,294710,593,592338,MONDAY,0,0,13.3,64,13,1016.9,Cloudy
4/29/2024 21:00,91,335,92863,273162,426,366025,MONDAY,0,0,13.9,55,16.6,1016.7,Cloudy
4/29/2024 22:00,76,215,103089,150006,291,253095,MONDAY,0,0,12.8,64,11.2,1016.7,Cloudy
4/29/2024 23:00,56,133,67044,84433,189,151477,MONDAY,0,0,12.8,64,11.2,1016.7,Cloudy
4/30/2024 0:00,21,54,63100,27404,75,90504,TUESDAY,0,0,12.2,69,5.4,1017.5,Cloudy
4/30/2024 1:00,20,33,28023,22326,53,50349,TUESDAY,0,0,12.8,69,7.6,1017.6,Cloudy
4/30/2024 2:00,6,24,4518,15666,30,20184,TUESDAY,0,0,11.7,71,7.6,1017.6,Cloudy
4/30/2024 3:00,3,15,5249,7226,18,12475,TUESDAY,0,0,11.7,71,7.6,1017.6,Cloudy
4/30/2024 4:00,3,10,1136,4762,13,5898,TUESDAY,0,0,11.7,74,0,1017.9,Cloudy
4/30/2024 5:00,3,46,2227,22477,49,24704,TUESDAY,0,0,11.7,80,7.6,1017.1,Cloudy
4/30/2024 6:00,17,133,45714,78097,150,123811,TUESDAY,0,0,11.1,80,11.2,1016.7,Cloudy
4/30/2024 7:00,58,517,50259,365696,575,415955,TUESDAY,0,0,11.7,77,7.6,1017,Cloudy
4/30/2024 8:00,157,1087,125228,782907,1244,908135,TUESDAY,0,0,11.7,77,7.6,1017,Cloudy
4/30/2024 9:00,111,703,124117,490908,814,615025,TUESDAY,0,0,9.4,90,5.4,1019,Cloudy
4/30/2024 10:00,93,435,109218,279939,528,389157,TUESDAY,0,0,9.4,90,9.4,1018.1,Cloudy
4/30/2024 11:00,115,375,128590,235369,490,363959,TUESDAY,0,0,10,86,16.6,1018.4,Cloudy
4/30/2024 12:00,160,449,207793,247863,609,455656,TUESDAY,0,0,10,89,16.6,1018.5,Cloudy
4/30/2024 13:00,112,396,109418,238238,508,347656,TUESDAY,0,0,10,89,16.6,1018.5,Cloudy
4/30/2024 14:00,171,515,421995,333383,686,755378,TUESDAY,0,0,10,86,13,1019.1,Cloudy
4/30/2024 15:00,183,584,209259,406821,767,616080,TUESDAY,0,0,10,80,13,1017.7,Cloudy
4/30/2024 16:00,223,911,246804,652229,1134,899033,TUESDAY,0,0,10.6,68,24.1,1016.3,Cloudy
4/30/2024 17:00,360,1270,468786,1012170,1630,1480956,TUESDAY,0,0,11.7,69,14.8,1015.8,Cloudy
4/30/2024 18:00,319,938,585987,1027157,1257,1613144,TUESDAY,0,0,11.7,69,14.8,1015.8,Cloudy
4/30/2024 19:00,168,615,173426,586154,783,759580,TUESDAY,0,0,10.6,66,27.7,1014.7,Cloudy
4/30/2024 20:00,120,419,120848,333992,539,454840,TUESDAY,0,0,10.6,66,27.7,1014.7,Cloudy
4/30/2024 21:00,137,331,236333,252022,468,488355,TUESDAY,0,0,9.4,77,16.6,1014.4,Cloudy
4/30/2024 22:00,138,245,149543,167360,383,316903,TUESDAY,0,0,8.9,80,24.1,1014.1,Cloudy
4/30/2024 23:00,42,126,31660,73317,168,104977,TUESDAY,0,0,9.4,77,24.1,1013.8,Cloudy
5/1/2024 0:00,11,43,125716,23002,54,148718,WEDNESDAY,0,0,9.4,77,20.5,1014.2,Cloudy
5/1/2024 1:00,9,17,5344,11656,26,17000,WEDNESDAY,0,0,9.4,77,20.5,1014.2,Cloudy
5/1/2024 2:00,5,10,4001,6373,15,10374,WEDNESDAY,0,0,8.9,80,25.9,1013.5,Cloudy
5/1/2024 3:00,2,5,940,1868,7,2808,WEDNESDAY,0,0,8.9,80,25.9,1013.5,Cloudy
5/1/2024 4:00,4,11,1784,7405,15,9189,WEDNESDAY,0,0,8.3,80,14.8,1013.3,Cloudy
5/1/2024 5:00,10,61,6581,85678,71,92259,WEDNESDAY,0,0,7.8,86,16.6,1012,Rain
5/1/2024 6:00,27,202,24433,167721,229,192154,WEDNESDAY,0,0,7.8,93,11.2,1012.8,Rain
5/1/2024 7:00,82,518,72536,415288,600,487824,WEDNESDAY,0,0,7.8,89,11.2,1012.5,Cloudy
5/1/2024 8:00,149,1115,126363,799910,1264,926273,WEDNESDAY,0,0,7.8,89,13,1013,Cloudy
5/1/2024 9:00,101,729,122195,451633,830,573828,WEDNESDAY,0,0,7.8,89,13,1013,Cloudy
5/1/2024 10:00,87,369,101462,245767,456,347229,WEDNESDAY,0,0,7.2,93,13,1013.9,Cloudy
5/1/2024 11:00,96,391,195415,267653,487,463068,WEDNESDAY,0,0,7.2,93,13,1013.9,Cloudy
5/1/2024 12:00,98,396,119093,325025,494,444118,WEDNESDAY,0,0,8.3,86,11.2,1014.1,Cloudy
5/1/2024 13:00,165,398,259391,323862,563,583253,WEDNESDAY,0,0,7.8,93,13,1014.8,Cloudy
5/1/2024 14:00,176,450,310125,293214,626,603339,WEDNESDAY,0,0,8.9,86,14.8,1014.8,Cloudy
5/1/2024 15:00,152,598,256913,411758,750,668671,WEDNESDAY,0,0,8.9,86,16.6,1015.2,Cloudy
5/1/2024 16:00,256,994,329689,712744,1250,1042433,WEDNESDAY,0,0,9.4,83,18.4,1015.1,Cloudy
5/1/2024 17:00,390,1239,445907,922238,1629,1368145,WEDNESDAY,0,0,9.4,83,18.4,1015.1,Cloudy
5/1/2024 18:00,366,1003,515399,784736,1369,1300135,WEDNESDAY,0,0,8.9,86,11.2,1015.7,Cloudy
5/1/2024 19:00,233,688,258147,624415,921,882562,WEDNESDAY,0,0,10,80,18.4,1015.2,Cloudy
5/1/2024 20:00,124,448,127942,319773,572,447715,WEDNESDAY,0,0,9.4,83,13,1015.6,Cloudy
5/1/2024 21:00,165,386,166725,292965,551,459690,WEDNESDAY,0,0,8.9,83,7.6,1016,Cloudy
5/1/2024 22:00,90,245,90942,174185,335,265127,WEDNESDAY,0,0,8.9,83,7.6,1016,Cloudy
5/1/2024 23:00,59,134,81798,83243,193,165041,WEDNESDAY,0,0,7.8,83,7.6,1016.3,Cloudy
5/2/2024 0:00,46,45,43439,27378,91,70817,THURSDAY,0,0,7.8,83,7.6,1016.3,Cloudy
5/2/2024 1:00,25,24,73743,19437,49,93180,THURSDAY,0,0,7.8,86,7.6,1017.1,Cloudy
5/2/2024 2:00,14,15,17989,7751,29,25740,THURSDAY,0,0,7.8,86,5.4,1017,Cloudy
5/2/2024 3:00,0,7,0,3852,7,3852,THURSDAY,0,0,7.8,86,5.4,1017,Cloudy
5/2/2024 4:00,1,11,656,8028,12,8684,THURSDAY,0,0,8.9,83,7.6,1016.8,Cloudy
5/2/2024 5:00,16,71,11579,48992,87,60571,THURSDAY,0,0,8.9,83,11.2,1016.4,Cloudy
5/2/2024 6:00,45,244,41768,157214,289,198982,THURSDAY,0,0,9.4,83,9.4,1016.3,Cloudy
5/2/2024 7:00,126,670,96630,488824,796,585454,THURSDAY,0,0,9.4,86,9.4,1016,Cloudy
5/2/2024 8:00,209,1200,229456,877441,1409,1106897,THURSDAY,0,0,9.4,86,13,1015.5,Cloudy
5/2/2024 9:00,144,720,174392,549015,864,723407,THURSDAY,0,0,9.4,86,13,1015.5,Cloudy
5/2/2024 10:00,132,398,195817,356345,530,552162,THURSDAY,0,0,9.4,86,20.5,1015,Cloudy
5/2/2024 11:00,182,436,409359,345598,618,754957,THURSDAY,0,0,10.6,83,22.3,1014.4,Cloudy
5/2/2024 12:00,196,490,351783,310842,686,662625,THURSDAY,0,0,10.6,83,22.3,1014.4,Cloudy
5/2/2024 13:00,187,452,263951,312950,639,576901,THURSDAY,0,0,15,69,31.7,1014.1,Cloudy
5/2/2024 14:00,256,506,337851,400504,762,738355,THURSDAY,0,0,15,69,31.7,1014.1,Cloudy
5/2/2024 15:00,309,686,573418,638442,995,1211860,THURSDAY,0,0,16.1,70,18.4,1012.8,Cloudy
5/2/2024 16:00,500,1111,681382,895616,1611,1576998,THURSDAY,0,0,16.7,70,14.8,1012.3,Cloudy
5/2/2024 17:00,498,1297,674761,1266069,1795,1940830,THURSDAY,0,0,16.7,70,14.8,1012.3,Cloudy
5/2/2024 18:00,249,696,309624,502887,945,812511,THURSDAY,0,0,18.3,65,16.6,1011,Cloudy
5/2/2024 19:00,130,488,154657,337502,618,492159,THURSDAY,0,0,18.9,61,18.4,1010.9,Cloudy
5/2/2024 20:00,102,358,164828,236148,460,400976,THURSDAY,0,0,13.9,74,25.9,1012.2,Cloudy
5/2/2024 21:00,92,288,90719,188625,380,279344,THURSDAY,0,0,12.2,83,22.3,1012.9,Cloudy
5/2/2024 22:00,48,220,40864,233886,268,274750,THURSDAY,0,0,12.2,83,22.3,1012.9,Cloudy
5/2/2024 23:00,43,131,53195,86261,174,139456,THURSDAY,0,0,10.6,89,18.4,1016,Cloudy
5/3/2024 0:00,33,77,71649,43856,110,115505,FRIDAY,0,0,10,89,20.5,1018.1,Cloudy
5/3/2024 1:00,46,38,100236,24598,84,124834,FRIDAY,0,0,8.9,89,29.5,1019,Cloudy
5/3/2024 2:00,16,22,18802,18874,38,37676,FRIDAY,0,0,8.3,93,24.1,1019.1,Cloudy
5/3/2024 3:00,9,22,12708,10455,31,23163,FRIDAY,0,0,8.3,90,18.4,1019.4,Cloudy
5/3/2024 4:00,5,15,11920,9989,20,21909,FRIDAY,0,0,8.3,90,18.4,1019.4,Cloudy
5/3/2024 5:00,12,70,13227,53872,82,67099,FRIDAY,0,0,8.3,90,22.3,1020,Cloudy
5/3/2024 6:00,38,159,46943,102435,197,149378,FRIDAY,0,0,8.3,93,20.5,1020.2,Cloudy
5/3/2024 7:00,71,457,59213,376491,528,435704,FRIDAY,0,0,8.3,93,20.5,1020.2,Cloudy
5/3/2024 8:00,144,803,149935,596135,947,746070,FRIDAY,0,0,8.9,89,18.4,1020.4,Cloudy
5/3/2024 9:00,116,584,332539,370890,700,703429,FRIDAY,0,0,8.9,89,16.6,1021.2,Cloudy
5/3/2024 10:00,141,429,244209,277043,570,521252,FRIDAY,0,0,8.9,89,20.5,1022.1,Cloudy
5/3/2024 11:00,142,414,198297,274766,556,473063,FRIDAY,0,0,8.9,89,20.5,1022.1,Cloudy
5/3/2024 12:00,202,498,422363,331055,700,753418,FRIDAY,0,0,10,83,14.8,1023.6,Cloudy
5/3/2024 13:00,268,504,373039,349013,772,722052,FRIDAY,0,0,10,86,9.4,1024,Cloudy
5/3/2024 14:00,281,563,396524,472463,844,868987,FRIDAY,0,0,10,86,9.4,1024,Cloudy
5/3/2024 15:00,350,698,520052,515658,1048,1035710,FRIDAY,0,0,10.6,83,14.8,1024.5,Cloudy
5/3/2024 16:00,422,854,643302,722668,1276,1365970,FRIDAY,0,0,10.6,83,14.8,1024.5,Cloudy
5/3/2024 17:00,452,1097,628549,849809,1549,1478358,FRIDAY,0,0,10.6,77,22.3,1023.8,Cloudy
5/3/2024 18:00,460,922,859266,695280,1382,1554546,FRIDAY,0,0,10.6,77,22.3,1023.8,Cloudy
5/3/2024 19:00,316,657,577350,540296,973,1117646,FRIDAY,0,0,11.1,74,14.8,1023.5,Cloudy
5/3/2024 20:00,213,457,246860,316481,670,563341,FRIDAY,0,0,11.1,66,11.2,1023.5,Cloudy
5/3/2024 21:00,173,358,293595,257908,531,551503,FRIDAY,0,0,11.1,63,13,1023.2,Cloudy
5/3/2024 22:00,132,265,134075,184388,397,318463,FRIDAY,0,0,11.1,63,13,1023.2,Cloudy
5/3/2024 23:00,138,215,288779,151838,353,440617,FRIDAY,0,0,10.6,71,5.4,1023.1,Cloudy
5/4/2024 0:00,122,139,191759,87804,261,279563,SATURDAY,1,0,10,74,7.6,1023.3,Cloudy
5/4/2024 1:00,126,90,227518,161888,216,389406,SATURDAY,1,0,10.6,77,9.4,1023.6,Cloudy
5/4/2024 2:00,74,50,213791,33789,124,247580,SATURDAY,1,0,10.6,77,9.4,1023.6,Cloudy
5/4/2024 3:00,11,22,9419,13250,33,22669,SATURDAY,1,0,11.1,74,5.4,1024.2,Cloudy
5/4/2024 4:00,6,22,2787,17497,28,20284,SATURDAY,1,0,9.4,80,5.4,1024.2,Cloudy
5/4/2024 5:00,7,20,20203,17827,27,38030,SATURDAY,1,0,9.4,80,5.4,1024.2,Cloudy
5/4/2024 6:00,25,52,15793,41676,77,57469,SATURDAY,1,0,9.4,86,0,1025.2,Cloudy
5/4/2024 7:00,64,146,87185,134333,210,221518,SATURDAY,1,0,8.9,86,0,1025,Cloudy
5/4/2024 8:00,115,223,156618,173992,338,330610,SATURDAY,1,0,8.9,86,0,1025,Cloudy
5/4/2024 9:00,194,400,268041,391819,594,659860,SATURDAY,1,0,8.9,86,9.4,1025.9,Cloudy
5/4/2024 10:00,259,536,404360,378476,795,782836,SATURDAY,1,0,10,77,13,1026.9,Cloudy
5/4/2024 11:00,368,559,669862,529850,927,1199712,SATURDAY,1,0,10.6,80,14.8,1027.5,Cloudy
5/4/2024 12:00,413,589,696698,444748,1002,1141446,SATURDAY,1,0,10,77,14.8,1028.2,Cloudy
5/4/2024 13:00,452,641,919048,625248,1093,1544296,SATURDAY,1,0,10,77,14.8,1028.2,Cloudy
5/4/2024 14:00,461,654,850471,660315,1115,1510786,SATURDAY,1,0,11.1,74,18.4,1028.7,Cloudy
5/4/2024 15:00,478,637,787043,552365,1115,1339408,SATURDAY,1,0,11.1,71,20.5,1028.7,Cloudy
5/4/2024 16:00,462,641,867373,525987,1103,1393360,SATURDAY,1,0,11.1,74,20.5,1028.5,Cloudy
5/4/2024 17:00,340,619,591183,541307,959,1132490,SATURDAY,1,0,11.1,74,20.5,1028.5,Cloudy
5/4/2024 18:00,321,556,518587,427701,877,946288,SATURDAY,1,0,11.1,74,22.3,1029,Cloudy
5/4/2024 19:00,256,482,518117,345959,738,864076,SATURDAY,1,0,10,77,20.5,1029.1,Cloudy
5/4/2024 20:00,191,333,388094,230244,524,618338,SATURDAY,1,0,9.4,77,20.5,1028.9,Cloudy
5/4/2024 21:00,118,270,123462,193082,388,316544,SATURDAY,1,0,9.4,77,20.5,1028.9,Cloudy
5/4/2024 22:00,119,213,252128,223751,332,475879,SATURDAY,1,0,8.3,83,13,1029.2,Cloudy
5/4/2024 23:00,155,225,211078,153643,380,364721,SATURDAY,1,0,8.3,83,14.8,1028.9,Cloudy
5/5/2024 0:00,122,151,202565,100020,273,302585,SUNDAY,1,0,8.3,86,14.8,1028.9,Cloudy
5/5/2024 1:00,128,80,135670,63252,208,198922,SUNDAY,1,0,8.3,86,14.8,1028.9,Cloudy
5/5/2024 2:00,64,59,195422,41357,123,236779,SUNDAY,1,0,8.3,86,14.8,1029.2,Cloudy
5/5/2024 3:00,19,22,28603,15018,41,43621,SUNDAY,1,0,8.9,86,14.8,1029.2,Cloudy
5/5/2024 4:00,9,19,10225,14380,28,24605,SUNDAY,1,0,8.3,90,11.2,1028.7,Cloudy
5/5/2024 5:00,11,21,9317,20770,32,30087,SUNDAY,1,0,7.8,89,11.2,1028.7,Cloudy
5/5/2024 6:00,16,43,27560,28151,59,55711,SUNDAY,1,0,8.3,86,11.2,1028.2,Cloudy
5/5/2024 7:00,25,104,29223,69250,129,98473,SUNDAY,1,0,8.3,86,11.2,1028.2,Cloudy
5/5/2024 8:00,74,182,78522,109431,256,187953,SUNDAY,1,0,7.8,86,14.8,1027.9,Cloudy
5/5/2024 9:00,132,322,261960,227134,454,489094,SUNDAY,1,0,7.8,86,20.5,1028,Cloudy
5/5/2024 10:00,165,420,229813,286462,585,516275,SUNDAY,1,0,7.8,89,14.8,1028.2,Cloudy
5/5/2024 11:00,252,484,386706,359208,736,745914,SUNDAY,1,0,7.8,89,14.8,1028.2,Cloudy
5/5/2024 12:00,328,479,452561,360598,807,813159,SUNDAY,1,0,8.9,83,11.2,1027.8,Cloudy
5/5/2024 13:00,316,550,492412,412508,866,904920,SUNDAY,1,0,9.4,80,16.6,1027.6,Cloudy
5/5/2024 14:00,319,560,644611,398529,879,1043140,SUNDAY,1,0,9.4,80,16.6,1026.9,Cloudy
5/5/2024 15:00,287,535,485781,413338,822,899119,SUNDAY,1,0,10,80,22.3,1026.4,Cloudy
5/5/2024 16:00,154,414,255787,283801,568,539588,SUNDAY,1,0,10,80,22.3,1026.4,Rain
5/5/2024 17:00,99,253,104248,173507,352,277755,SUNDAY,1,0,10,86,24.1,1025.6,Rain
5/5/2024 18:00,62,249,140171,151664,311,291835,SUNDAY,1,0,10,86,20.5,1024.8,Rain
5/5/2024 19:00,45,167,43785,95537,212,139322,SUNDAY,1,0,10.6,83,16.6,1024.1,Rain
5/5/2024 20:00,20,75,18292,49314,95,67606,SUNDAY,1,0,11.1,83,13,1023.5,Rain
5/5/2024 21:00,22,89,20346,55763,111,76109,SUNDAY,1,0,11.1,83,13,1023.5,Rain
5/5/2024 22:00,19,81,15981,43740,100,59721,SUNDAY,1,0,10,89,18.4,1022.7,Rain
5/5/2024 23:00,10,45,6348,20078,55,26426,SUNDAY,1,0,9.4,97,16.6,1022.3,Rain
5/6/2024 0:00,12,22,7159,13015,34,20174,MONDAY,0,0,8.9,100,11.2,1022.5,Rain
5/6/2024 1:00,14,16,11316,11543,30,22859,MONDAY,0,0,8.9,100,11.2,1022.5,Rain
5/6/2024 2:00,13,4,29105,2896,17,32001,MONDAY,0,0,8.9,100,14.8,1022.1,Rain
5/6/2024 3:00,3,9,1456,6006,12,7462,MONDAY,0,0,9.4,100,5.4,1021.6,Rain
5/6/2024 4:00,3,9,3667,6394,12,10061,MONDAY,0,0,9.4,100,11.2,1021.1,Rain
5/6/2024 5:00,15,62,9619,37055,77,46674,MONDAY,0,0,9.4,100,7.6,1018.9,Cloudy
5/6/2024 6:00,36,208,27217,135937,244,163154,MONDAY,0,0,9.4,100,9.4,1018.9,Rain
5/6/2024 7:00,99,537,132805,391350,636,524155,MONDAY,0,0,10,100,9.4,1017.8,Rain
5/6/2024 8:00,162,1048,170240,836876,1210,1007116,MONDAY,0,0,10,100,9.4,1017.8,Cloudy
5/6/2024 9:00,123,598,183902,453419,721,637321,MONDAY,0,0,10.6,100,9.4,1017.2,Cloudy
5/6/2024 10:00,126,378,227391,343261,504,570652,MONDAY,0,0,10.6,100,9.4,1017.2,Cloudy
5/6/2024 11:00,161,441,272110,394136,602,666246,MONDAY,0,0,11.1,100,14.8,1016.6,Cloudy
5/6/2024 12:00,202,446,367921,323808,648,691729,MONDAY,0,0,12.8,89,13,1016.6,Cloudy
5/6/2024 13:00,214,473,354933,317334,687,672267,MONDAY,0,0,15.6,80,11.2,1015.9,Cloudy
5/6/2024 14:00,228,478,552425,363822,706,916247,MONDAY,0,0,18.3,73,11.2,1015.2,Cloudy
5/6/2024 15:00,308,660,571488,581290,968,1152778,MONDAY,0,0,20,70,9.4,1014.4,Cloudy
5/6/2024 16:00,380,982,565919,831713,1362,1397632,MONDAY,0,0,20,73,11.2,1013.3,Cloudy
5/6/2024 17:00,538,1333,893918,1123775,1871,2017693,MONDAY,0,0,19.4,71,9.4,1012.5,Cloudy
5/6/2024 18:00,472,1020,730908,872762,1492,1603670,MONDAY,0,0,19.4,71,9.4,1012.5,Cloudy
5/6/2024 19:00,349,769,499219,611216,1118,1110435,MONDAY,0,0,23.9,55,18.4,1010.8,Cloudy
5/6/2024 20:00,225,487,355301,359814,712,715115,MONDAY,0,0,24.4,54,13,1010.1,Cloudy
5/6/2024 21:00,153,355,227144,247420,508,474564,MONDAY,0,0,23.9,54,18.4,1009.9,Cloudy
5/6/2024 22:00,135,218,162618,163126,353,325744,MONDAY,0,0,23.3,57,13,1009.5,Cloudy
5/6/2024 23:00,58,152,56664,94175,210,150839,MONDAY,0,0,22.8,59,13,1009.4,Cloudy
5/7/2024 0:00,58,88,78207,67142,146,145349,TUESDAY,0,0,21.1,68,14.8,1009.4,Cloudy
5/7/2024 1:00,33,36,148080,17766,69,165846,TUESDAY,0,0,21.1,68,14.8,1009.4,Cloudy
5/7/2024 2:00,13,16,10815,13667,29,24482,TUESDAY,0,0,21.1,66,14.8,1009.6,Cloudy
5/7/2024 3:00,13,17,19693,29282,30,48975,TUESDAY,0,0,19.4,71,7.6,1009.1,Cloudy
5/7/2024 4:00,10,17,10338,11035,27,21373,TUESDAY,0,0,18.3,70,14.8,1008.9,Cloudy
5/7/2024 5:00,27,92,23380,54958,119,78338,TUESDAY,0,0,17.8,68,16.6,1008.7,Cloudy
5/7/2024 6:00,74,317,69821,210688,391,280509,TUESDAY,0,0,16.7,72,13,1008.5,Cloudy
5/7/2024 7:00,170,786,155332,557954,956,713286,TUESDAY,0,0,16.1,75,9.4,1008.4,Cloudy
5/7/2024 8:00,252,1283,253189,948922,1535,1202111,TUESDAY,0,0,16.1,75,9.4,1008.4,Cloudy
5/7/2024 9:00,171,785,221214,705240,956,926454,TUESDAY,0,0,16.1,67,14.8,1008.5,Cloudy
5/7/2024 10:00,150,455,282929,348356,605,631285,TUESDAY,0,0,15.6,67,9.4,1009.4,Cloudy
5/7/2024 11:00,209,440,331650,300284,649,631934,TUESDAY,0,0,16.7,62,16.6,1009.6,Cloudy
5/7/2024 12:00,232,477,501638,430031,709,931669,TUESDAY,0,0,16.7,62,16.6,1009.6,Fair
5/7/2024 13:00,282,482,415672,356423,764,772095,TUESDAY,0,0,17.8,54,14.8,1009.7,Fair
5/7/2024 14:00,288,549,464963,397401,837,862364,TUESDAY,0,0,17.2,56,16.6,1009.2,Fair
5/7/2024 15:00,406,677,703280,594137,1083,1297417,TUESDAY,0,0,17.2,60,16.6,1008.4,Fair
5/7/2024 16:00,508,1173,1155445,1088299,1681,2243744,TUESDAY,0,0,17.2,60,16.6,1008.4,Fair
5/7/2024 17:00,668,1490,1058921,1358683,2158,2417604,TUESDAY,0,0,17.2,63,20.5,1006.8,Fair
5/7/2024 18:00,602,1156,1360743,967496,1758,2328239,TUESDAY,0,0,17.2,60,22.3,1005.6,Fair
5/7/2024 19:00,457,857,833516,733538,1314,1567054,TUESDAY,0,0,17.2,63,16.6,1004.8,Fair
5/7/2024 20:00,295,577,470487,472520,872,943007,TUESDAY,0,0,18.3,56,14.8,1004.3,Cloudy
5/7/2024 21:00,226,430,326958,320320,656,647278,TUESDAY,0,0,18.3,56,14.8,1004.3,Cloudy
5/7/2024 22:00,132,289,164872,341870,421,506742,TUESDAY,0,0,19.4,51,11.2,1004.3,Cloudy
5/7/2024 23:00,80,158,144556,106185,238,250741,TUESDAY,0,0,19.4,51,9.4,1004.8,Cloudy
5/8/2024 0:00,49,91,227116,66955,140,294071,WEDNESDAY,0,0,17.2,63,16.6,1005.4,Cloudy
5/8/2024 1:00,36,33,123704,19582,69,143286,WEDNESDAY,0,0,17.2,63,16.6,1005.4,Cloudy
5/8/2024 2:00,24,21,49464,17129,45,66593,WEDNESDAY,0,0,15.6,72,14.8,1005.8,Cloudy
5/8/2024 3:00,8,16,11744,10030,24,21774,WEDNESDAY,0,0,14.4,78,13,1005.5,Cloudy
5/8/2024 4:00,12,12,13154,4487,24,17641,WEDNESDAY,0,0,14.4,78,13,1005.5,Cloudy
5/8/2024 5:00,19,80,14555,51227,99,65782,WEDNESDAY,0,0,15,75,0,1005.8,Cloudy
5/8/2024 6:00,63,305,52938,201232,368,254170,WEDNESDAY,0,0,15,75,0,1005.8,Cloudy
5/8/2024 7:00,142,747,110347,553844,889,664191,WEDNESDAY,0,0,12.2,90,7.6,1005.3,Cloudy
5/8/2024 8:00,221,1196,322007,846678,1417,1168685,WEDNESDAY,0,0,11.7,89,0,1005.2,Cloudy
5/8/2024 9:00,43,322,31932,199213,365,231145,WEDNESDAY,0,0,11.7,93,0,1005.2,Cloudy
5/8/2024 10:00,28,146,26369,117895,174,144264,WEDNESDAY,0,0,12.2,93,7.6,1004.7,Cloudy
5/8/2024 11:00,29,140,20108,89582,169,109690,WEDNESDAY,0,0,12.2,93,7.6,1004.7,Cloudy
5/8/2024 12:00,50,199,61667,117363,249,179030,WEDNESDAY,0,0,13.3,87,9.4,1003.9,Rain
5/8/2024 13:00,72,229,152048,137143,301,289191,WEDNESDAY,0,0,13.3,87,9.4,1003.9,Rain
5/8/2024 14:00,84,366,87862,240115,450,327977,WEDNESDAY,0,0,12.2,97,7.6,1004.1,Rain
5/8/2024 15:00,131,496,126700,345767,627,472467,WEDNESDAY,0,0,13.3,100,7.6,1002.1,Rain
5/8/2024 16:00,177,825,288032,580155,1002,868187,WEDNESDAY,0,0,13.3,100,7.6,1002.1,Rain
5/8/2024 17:00,137,605,118451,444728,742,563179,WEDNESDAY,0,0,13.3,100,9.4,1001.5,Cloudy
5/8/2024 18:00,154,732,178013,606185,886,784198,WEDNESDAY,0,0,13.9,100,7.6,1001.1,Cloudy
5/8/2024 19:00,141,499,263156,332394,640,595550,WEDNESDAY,0,0,15,93,9.4,1000.5,Cloudy
5/8/2024 20:00,73,273,69658,177229,346,246887,WEDNESDAY,0,0,15,93,9.4,1000.5,Rain
5/8/2024 21:00,35,201,36272,132144,236,168416,WEDNESDAY,0,0,12.2,97,14.8,1000.9,Rain
5/8/2024 22:00,52,172,69152,137879,224,207031,WEDNESDAY,0,0,12.2,97,14.8,1000.9,Cloudy
5/8/2024 23:00,31,125,24538,92345,156,116883,WEDNESDAY,0,0,10.6,96,22.3,1000.8,Cloudy
5/9/2024 0:00,21,56,26056,43454,77,69510,THURSDAY,0,0,10.6,96,14.8,1001,Cloudy
5/9/2024 1:00,23,33,32965,16386,56,49351,THURSDAY,0,0,10.6,100,9.4,1002,Cloudy
5/9/2024 2:00,11,14,14404,10769,25,25173,THURSDAY,0,0,11.1,100,9.4,1002.7,Cloudy
5/9/2024 3:00,8,14,6739,11537,22,18276,THURSDAY,0,0,10,100,16.6,1001.9,Cloudy
5/9/2024 4:00,8,14,7363,8599,22,15962,THURSDAY,0,0,10.6,100,14.8,1002.2,Cloudy
5/9/2024 5:00,14,73,12755,48683,87,61438,THURSDAY,0,0,10.6,100,14.8,1002.2,Cloudy
5/9/2024 6:00,50,262,35488,192530,312,228018,THURSDAY,0,0,12.2,100,9.4,1003,Cloudy
5/9/2024 7:00,126,718,199873,504005,844,703878,THURSDAY,0,0,12.2,100,7.6,1003,Cloudy
5/9/2024 8:00,224,1231,196323,904570,1455,1100893,THURSDAY,0,0,12.8,93,14.8,1003,Cloudy
5/9/2024 9:00,150,737,166945,517986,887,684931,THURSDAY,0,0,13.3,84,16.6,1003.6,Cloudy
5/9/2024 10:00,138,453,171078,351991,591,523069,THURSDAY,0,0,12.8,77,16.6,1004.8,Cloudy
5/9/2024 11:00,166,415,228570,387396,581,615966,THURSDAY,0,0,12.8,77,16.6,1004.8,Cloudy
5/9/2024 12:00,181,519,427325,370939,700,798264,THURSDAY,0,0,13.9,62,22.3,1005.6,Cloudy
5/9/2024 13:00,215,480,292126,357258,695,649384,THURSDAY,0,0,15,60,20.5,1006.3,Cloudy
5/9/2024 14:00,243,532,334366,378874,775,713240,THURSDAY,0,0,15.6,55,20.5,1006.5,Cloudy
5/9/2024 15:00,269,673,314305,460110,942,774415,THURSDAY,0,0,15.6,55,20.5,1006.5,Cloudy
5/9/2024 16:00,400,1086,526617,889954,1486,1416571,THURSDAY,0,0,16.7,52,14.8,1006.9,Cloudy
5/9/2024 17:00,580,1422,818404,1159984,2002,1978388,THURSDAY,0,0,16.7,52,14.8,1006.9,Cloudy
5/9/2024 18:00,457,1134,625135,940680,1591,1565815,THURSDAY,0,0,12.2,80,22.3,1007.4,Cloudy
5/9/2024 19:00,304,755,403522,610728,1059,1014250,THURSDAY,0,0,12.8,77,20.5,1007.5,Cloudy
5/9/2024 20:00,147,489,136921,338701,636,475622,THURSDAY,0,0,12.8,74,24.1,1007.8,Cloudy
5/9/2024 21:00,166,386,196528,265299,552,461827,THURSDAY,0,0,12.8,74,24.1,1007.8,Cloudy
5/9/2024 22:00,148,290,167339,198795,438,366134,THURSDAY,0,0,11.1,80,22.3,1009.5,Cloudy
5/9/2024 23:00,70,166,79343,90683,236,170026,THURSDAY,0,0,10,83,20.5,1010.1,Cloudy
5/10/2024 0:00,75,77,156952,45359,152,202311,FRIDAY,0,0,10,83,16.6,1010.6,Cloudy
5/10/2024 1:00,34,30,139988,22311,64,162299,FRIDAY,0,0,10,83,16.6,1010.6,Cloudy
5/10/2024 2:00,41,28,47615,20089,69,67704,FRIDAY,0,0,9.4,83,11.2,1010.8,Cloudy
5/10/2024 3:00,8,12,4207,9647,20,13854,FRIDAY,0,0,9.4,86,11.2,1010.7,Cloudy
5/10/2024 4:00,8,8,4695,3862,16,8557,FRIDAY,0,0,9.4,86,11.2,1010.7,Cloudy
5/10/2024 5:00,19,64,13474,41204,83,54678,FRIDAY,0,0,8.9,86,16.6,1010.6,Cloudy
5/10/2024 6:00,54,194,54996,119308,248,174304,FRIDAY,0,0,8.9,80,11.2,1010.4,Cloudy
5/10/2024 7:00,92,443,84490,322113,535,406603,FRIDAY,0,0,8.9,83,13,1009.4,Cloudy
5/10/2024 8:00,136,831,110802,746247,967,857049,FRIDAY,0,0,8.9,80,14.8,1009.2,Cloudy
5/10/2024 9:00,124,650,119818,425517,774,545335,FRIDAY,0,0,8.9,80,11.2,1009.7,Cloudy
5/10/2024 10:00,129,454,182756,297458,583,480214,FRIDAY,0,0,8.9,80,11.2,1009.7,Cloudy
5/10/2024 11:00,191,464,243179,331726,655,574905,FRIDAY,0,0,9.4,74,18.4,1010.4,Cloudy
5/10/2024 12:00,213,562,265636,379886,775,645522,FRIDAY,0,0,10,74,18.4,1010.1,Cloudy
5/10/2024 13:00,291,499,681326,354804,790,1036130,FRIDAY,0,0,11.7,69,18.4,1010.4,Cloudy
5/10/2024 14:00,279,581,578568,461571,860,1040139,FRIDAY,0,0,11.7,66,24.1,1010.2,Cloudy
5/10/2024 15:00,411,694,638201,543956,1105,1182157,FRIDAY,0,0,11.7,66,24.1,1010.2,Cloudy
5/10/2024 16:00,406,909,670420,696218,1315,1366638,FRIDAY,0,0,11.7,56,22.3,1010.1,Cloudy
5/10/2024 17:00,513,985,815152,785695,1498,1600847,FRIDAY,0,0,11.7,64,22.3,1010.6,Cloudy
5/10/2024 18:00,461,844,689156,854323,1305,1543479,FRIDAY,0,0,12.2,61,25.9,1009.7,Cloudy
5/10/2024 19:00,317,604,572262,427704,921,999966,FRIDAY,0,0,12.2,61,25.9,1009.7,Cloudy
5/10/2024 20:00,166,446,250445,310817,612,561262,FRIDAY,0,0,10.6,68,24.1,1009.9,Cloudy
5/10/2024 21:00,162,339,157054,424459,501,581513,FRIDAY,0,0,10,71,24.1,1010.3,Cloudy
5/10/2024 22:00,187,297,172404,210167,484,382571,FRIDAY,0,0,9.4,69,13,1010.7,Cloudy
5/10/2024 23:00,123,227,133034,199075,350,332109,FRIDAY,0,0,8.3,71,13,1011,Cloudy
5/11/2024 0:00,123,160,242382,118021,283,360403,SATURDAY,1,0,8.3,74,13,1011.5,Cloudy
5/11/2024 1:00,79,101,274201,84582,180,358783,SATURDAY,1,0,8.3,74,13,1011.5,Cloudy
5/11/2024 2:00,65,46,129197,60433,111,189630,SATURDAY,1,0,8.3,74,11.2,1011.1,Cloudy
5/11/2024 3:00,30,21,39115,15408,51,54523,SATURDAY,1,0,8.3,74,13,1011.2,Cloudy
5/11/2024 4:00,6,13,7553,10800,19,18353,SATURDAY,1,0,7.2,80,11.2,1011.1,Cloudy
5/11/2024 5:00,21,35,39877,23897,56,63774,SATURDAY,1,0,8.3,76,11.2,1011.1,Cloudy
5/11/2024 6:00,9,55,5211,37895,64,43106,SATURDAY,1,0,8.3,76,11.2,1011.1,Cloudy
5/11/2024 7:00,49,128,56178,86535,177,142713,SATURDAY,1,0,7.2,82,11.2,1011.2,Cloudy
5/11/2024 8:00,98,275,108812,169302,373,278114,SATURDAY,1,0,6.7,82,13,1011.2,Cloudy
5/11/2024 9:00,207,387,508373,325144,594,833517,SATURDAY,1,0,6.7,85,7.6,1011.4,Cloudy
5/11/2024 10:00,278,478,631746,393302,756,1025048,SATURDAY,1,0,6.7,85,7.6,1011.4,Cloudy
5/11/2024 11:00,353,578,550922,596976,931,1147898,SATURDAY,1,0,9.4,77,13,1011.9,Fair
5/11/2024 12:00,476,666,979082,715366,1142,1694448,SATURDAY,1,0,10,74,18.4,1011.9,Fair
5/11/2024 13:00,410,560,986824,543753,970,1530577,SATURDAY,1,0,10,74,18.4,1011.9,Cloudy
5/11/2024 14:00,499,653,1033701,656488,1152,1690189,SATURDAY,1,0,10,77,25.9,1012.2,Cloudy
5/11/2024 15:00,453,633,800500,637862,1086,1438362,SATURDAY,1,0,11.1,74,25.9,1011.7,Cloudy
5/11/2024 16:00,455,613,952153,533988,1068,1486141,SATURDAY,1,0,10,77,22.3,1011.9,Cloudy
5/11/2024 17:00,517,575,1041976,492949,1092,1534925,SATURDAY,1,0,10.6,74,18.4,1011.8,Cloudy
5/11/2024 18:00,472,586,1140964,633148,1058,1774112,SATURDAY,1,0,10.6,74,18.4,1011.8,Cloudy
5/11/2024 19:00,355,424,495057,489985,779,985042,SATURDAY,1,0,10.6,68,24.1,1011.2,Cloudy
5/11/2024 20:00,192,302,415795,334655,494,750450,SATURDAY,1,0,10.6,68,24.1,1011.2,Cloudy
5/11/2024 21:00,154,233,233308,217988,387,451296,SATURDAY,1,0,10,71,14.8,1011.7,Cloudy
5/11/2024 22:00,128,225,292982,170071,353,463053,SATURDAY,1,0,9.4,71,11.2,1011.8,Cloudy
5/11/2024 23:00,131,178,215967,126550,309,342517,SATURDAY,1,0,8.3,76,7.6,1011.9,Cloudy
5/12/2024 0:00,96,109,109347,74521,205,183868,SUNDAY,1,0,8.3,76,7.6,1011.9,Cloudy
5/12/2024 1:00,132,68,180354,54974,200,235328,SUNDAY,1,0,8.9,71,0,1011.9,Cloudy
5/12/2024 2:00,81,62,126930,72475,143,199405,SUNDAY,1,0,8.3,76,0,1012,Cloudy
5/12/2024 3:00,17,24,19841,12486,41,32327,SUNDAY,1,0,8.3,74,5.4,1012.2,Cloudy
5/12/2024 4:00,9,16,11387,13049,25,24436,SUNDAY,1,0,7.2,86,7.6,1012.1,Cloudy
5/12/2024 5:00,15,25,17746,24613,40,42359,SUNDAY,1,0,6.7,85,7.6,1011.8,Cloudy
5/12/2024 6:00,18,64,17619,45455,82,63074,SUNDAY,1,0,6.7,85,7.6,1011.8,Cloudy
5/12/2024 7:00,27,100,26672,56086,127,82758,SUNDAY,1,0,6.7,85,9.4,1011.6,Cloudy
5/12/2024 8:00,70,216,87794,137441,286,225235,SUNDAY,1,0,7.2,82,5.4,1011.7,Cloudy
5/12/2024 9:00,130,319,206691,271006,449,477697,SUNDAY,1,0,7.2,82,5.4,1011.7,Cloudy
5/12/2024 10:00,210,436,363210,300637,646,663847,SUNDAY,1,0,8.3,83,9.4,1012.2,Cloudy
5/12/2024 11:00,306,468,643365,382621,774,1025986,SUNDAY,1,0,8.9,77,7.6,1012.5,Cloudy
5/12/2024 12:00,352,517,584314,410462,869,994776,SUNDAY,1,0,10,74,5.4,1012.6,Cloudy
5/12/2024 13:00,462,549,740501,506955,1011,1247456,SUNDAY,1,0,10.6,66,9.4,1012.6,Cloudy
5/12/2024 14:00,396,510,704357,414706,906,1119063,SUNDAY,1,0,12.8,59,7.6,1012.4,Cloudy
5/12/2024 15:00,366,506,893295,418663,872,1311958,SUNDAY,1,0,12.8,59,7.6,1012.4,Cloudy
5/12/2024 16:00,365,578,686268,471384,943,1157652,SUNDAY,1,0,13.3,60,11.2,1012.2,Cloudy
5/12/2024 17:00,338,583,675781,564018,921,1239799,SUNDAY,1,0,13.3,60,13,1011.9,Cloudy
5/12/2024 18:00,285,587,360618,502578,872,863196,SUNDAY,1,0,12.8,69,16.6,1011.7,Cloudy
5/12/2024 19:00,173,398,228266,368628,571,596894,SUNDAY,1,0,12.8,64,13,1011.8,Cloudy
5/12/2024 20:00,124,281,149444,182561,405,332005,SUNDAY,1,0,12.2,69,11.2,1011.8,Cloudy
5/12/2024 21:00,139,254,150032,220805,393,370837,SUNDAY,1,0,12.2,69,11.2,1011.8,Cloudy
5/12/2024 22:00,73,173,67498,129026,246,196524,SUNDAY,1,0,13.3,62,14.8,1012.4,Cloudy
5/12/2024 23:00,38,112,69731,66096,150,135827,SUNDAY,1,0,12.8,66,13,1012.8,Cloudy
5/13/2024 0:00,29,60,27114,36444,89,63558,MONDAY,0,0,13.3,64,18.4,1013.5,Cloudy
5/13/2024 1:00,26,39,32548,24199,65,56747,MONDAY,0,0,13.3,64,18.4,1013.5,Cloudy
5/13/2024 2:00,4,17,2880,10863,21,13743,MONDAY,0,0,11.7,74,11.2,1013.9,Cloudy
5/13/2024 3:00,0,8,0,3830,8,3830,MONDAY,0,0,11.1,77,13,1014.2,Cloudy
5/13/2024 4:00,5,11,4065,6363,16,10428,MONDAY,0,0,11.1,77,11.2,1014.4,Cloudy
5/13/2024 5:00,9,65,4733,42479,74,47212,MONDAY,0,0,11.1,77,11.2,1014.4,Cloudy
5/13/2024 6:00,40,224,38276,147618,264,185894,MONDAY,0,0,10,89,13,1014.8,Cloudy
5/13/2024 7:00,97,593,87716,434533,690,522249,MONDAY,0,0,10,86,9.4,1015.2,Cloudy
5/13/2024 8:00,147,1067,138171,787622,1214,925793,MONDAY,0,0,10,86,7.6,1015.4,Cloudy
5/13/2024 9:00,133,637,144632,417308,770,561940,MONDAY,0,0,11.1,80,9.4,1016.1,Cloudy
5/13/2024 10:00,131,361,204806,245470,492,450276,MONDAY,0,0,12.2,72,11.2,1016.4,Cloudy
5/13/2024 11:00,167,376,365840,257709,543,623549,MONDAY,0,0,12.2,72,11.2,1016.4,Cloudy
5/13/2024 12:00,180,438,297116,282470,618,579586,MONDAY,0,0,15,62,0,1017.2,Fair
5/13/2024 13:00,223,442,398956,300080,665,699036,MONDAY,0,0,15.6,62,9.4,1017.1,Fair
5/13/2024 14:00,235,457,355373,342485,692,697858,MONDAY,0,0,15.6,62,9.4,1017.1,Fair
5/13/2024 15:00,286,621,502624,484640,907,987264,MONDAY,0,0,16.1,58,24.1,1017.1,Fair
5/13/2024 16:00,321,989,476746,786312,1310,1263058,MONDAY,0,0,15,67,29.5,1017.2,Fair
5/13/2024 17:00,461,1393,714421,1153585,1854,1868006,MONDAY,0,0,16.1,58,29.5,1017.2,Fair
5/13/2024 18:00,483,1073,650605,852581,1556,1503186,MONDAY,0,0,16.7,58,25.9,1016.5,Fair
5/13/2024 19:00,285,752,341982,542572,1037,884554,MONDAY,0,0,16.7,58,25.9,1016.5,Cloudy
5/13/2024 20:00,185,515,203362,359329,700,562691,MONDAY,0,0,15.6,67,35.3,1015.8,Cloudy
5/13/2024 21:00,154,379,189114,292005,533,481119,MONDAY,0,0,15,69,35.3,1015.6,Cloudy
5/13/2024 22:00,154,235,302698,164803,389,467501,MONDAY,0,0,15,67,18.4,1015.6,Cloudy
5/13/2024 23:00,61,118,103421,81608,179,185029,MONDAY,0,0,16.7,50,24.1,1016.4,Cloudy
5/14/2024 0:00,45,58,63317,34369,103,97686,TUESDAY,0,0,16.7,50,24.1,1016.4,Cloudy
5/14/2024 1:00,25,21,53327,18213,46,71540,TUESDAY,0,0,14.4,67,20.5,1017.1,Cloudy
5/14/2024 2:00,10,8,65221,5140,18,70361,TUESDAY,0,0,13.9,72,14.8,1016.6,Cloudy
5/14/2024 3:00,6,8,3433,4408,14,7841,TUESDAY,0,0,12.8,80,11.2,1017.4,Cloudy
5/14/2024 4:00,8,15,9339,6886,23,16225,TUESDAY,0,0,12.2,83,14.8,1017.3,Fair
5/14/2024 5:00,16,94,9043,92511,110,101554,TUESDAY,0,0,12.2,83,14.8,1017.3,Fair
5/14/2024 6:00,60,306,50372,211304,366,261676,TUESDAY,0,0,11.1,89,7.6,1017.1,Cloudy
5/14/2024 7:00,123,751,107728,527521,874,635249,TUESDAY,0,0,11.1,89,16.6,1016.6,Cloudy
5/14/2024 8:00,218,1286,246769,959369,1504,1206138,TUESDAY,0,0,11.7,86,16.6,1016.5,Cloudy
5/14/2024 9:00,147,708,194429,526123,855,720552,TUESDAY,0,0,11.7,86,16.6,1016.5,Cloudy
5/14/2024 10:00,138,441,337385,359543,579,696928,TUESDAY,0,0,11.7,86,14.8,1016.4,Cloudy
5/14/2024 11:00,161,440,348049,331393,601,679442,TUESDAY,0,0,13.3,80,13,1016.6,Cloudy
5/14/2024 12:00,243,489,459779,542075,732,1001854,TUESDAY,0,0,13.9,81,13,1016.9,Cloudy
5/14/2024 13:00,262,440,452928,330988,702,783916,TUESDAY,0,0,17.2,70,14.8,1016.4,Cloudy
5/14/2024 14:00,265,492,413189,408965,757,822154,TUESDAY,0,0,17.2,70,14.8,1016.4,Cloudy
5/14/2024 15:00,344,709,682698,546774,1053,1229472,TUESDAY,0,0,22.2,51,25.9,1015.5,Cloudy
5/14/2024 16:00,465,1163,878829,985605,1628,1864434,TUESDAY,0,0,23.9,48,25.9,1014.5,Cloudy
5/14/2024 17:00,682,1565,1124961,1395047,2247,2520008,TUESDAY,0,0,24.4,47,20.5,1013.8,Fair
5/14/2024 18:00,578,1193,1052754,998179,1771,2050933,TUESDAY,0,0,24.4,47,20.5,1013.8,Fair
5/14/2024 19:00,353,809,526970,796408,1162,1323378,TUESDAY,0,0,24.4,50,27.7,1012.5,Fair
5/14/2024 20:00,236,552,335250,526447,788,861697,TUESDAY,0,0,24.4,50,27.7,1012.5,Fair
5/14/2024 21:00,193,410,210171,325888,603,536059,TUESDAY,0,0,22.8,51,29.5,1011.8,Fair
5/14/2024 22:00,172,259,233785,205774,431,439559,TUESDAY,0,0,20.6,57,25.9,1012,Fair
5/14/2024 23:00,79,142,88406,96357,221,184763,TUESDAY,0,0,18.9,61,24.1,1012.4,Cloudy
5/15/2024 0:00,27,83,31037,54917,110,85954,WEDNESDAY,0,0,17.8,65,25.9,1012.8,Cloudy
5/15/2024 1:00,35,53,29531,27940,88,57471,WEDNESDAY,0,0,17.8,65,25.9,1012.8,Cloudy
5/15/2024 2:00,17,19,21513,14258,36,35771,WEDNESDAY,0,0,16.7,72,24.1,1013.1,Cloudy
5/15/2024 3:00,4,12,9723,6575,16,16298,WEDNESDAY,0,0,16.1,78,22.3,1013.1,Cloudy
5/15/2024 4:00,8,20,7660,10596,28,18256,WEDNESDAY,0,0,16.1,78,22.3,1013,Cloudy
5/15/2024 5:00,25,99,30545,53409,124,83954,WEDNESDAY,0,0,16.1,78,22.3,1013,Cloudy
5/15/2024 6:00,58,288,40404,194197,346,234601,WEDNESDAY,0,0,15.6,80,9.4,1012.9,Cloudy
5/15/2024 7:00,147,727,150230,535834,874,686064,WEDNESDAY,0,0,15.6,80,14.8,1012.9,Cloudy
5/15/2024 8:00,221,1250,197405,908881,1471,1106286,WEDNESDAY,0,0,16.7,75,16.6,1012.5,Cloudy
5/15/2024 9:00,141,792,241761,558460,933,800221,WEDNESDAY,0,0,16.7,75,16.6,1012.5,Cloudy
5/15/2024 10:00,163,472,234270,410126,635,644396,WEDNESDAY,0,0,15.6,83,9.4,1012.8,Cloudy
5/15/2024 11:00,186,422,288031,372619,608,660650,WEDNESDAY,0,0,15.6,83,9.4,1012.8,Cloudy
5/15/2024 12:00,193,494,237490,323986,687,561476,WEDNESDAY,0,0,20.6,66,0,1012.7,Cloudy
5/15/2024 13:00,196,432,327057,297919,628,624976,WEDNESDAY,0,0,19.4,71,9.4,1012.5,Cloudy
5/15/2024 14:00,158,421,305578,283075,579,588653,WEDNESDAY,0,0,19.4,71,9.4,1012.5,Cloudy
5/15/2024 15:00,203,651,269382,448959,854,718341,WEDNESDAY,0,0,19.4,68,11.2,1012.5,Cloudy
5/15/2024 16:00,332,1058,509335,802101,1390,1311436,WEDNESDAY,0,0,18.3,73,14.8,1012.2,Cloudy
5/15/2024 17:00,486,1466,634868,1190398,1952,1825266,WEDNESDAY,0,0,17.8,90,14.8,1012.3,Cloudy
5/15/2024 18:00,426,1045,713929,864383,1471,1578312,WEDNESDAY,0,0,18.9,78,13,1011.9,Cloudy
5/15/2024 19:00,266,681,329092,533695,947,862787,WEDNESDAY,0,0,18.9,78,13,1011.9,Cloudy
5/15/2024 20:00,204,530,303058,411316,734,714374,WEDNESDAY,0,0,18.9,78,7.6,1011.2,Rain
5/15/2024 21:00,180,396,287172,403487,576,690659,WEDNESDAY,0,0,18.3,81,9.4,1011.1,Rain
5/15/2024 22:00,54,153,112407,88126,207,200533,WEDNESDAY,0,0,16.1,84,13,1010.8,Cloudy
5/15/2024 23:00,21,58,49844,31310,79,81154,WEDNESDAY,0,0,16.1,84,13,1010.8,Cloudy
5/16/2024 0:00,9,25,10679,21729,34,32408,THURSDAY,0,0,14.4,93,9.4,1010.9,Rain
5/16/2024 1:00,11,20,13981,14043,31,28024,THURSDAY,0,0,14.4,93,9.4,1010.9,Rain
5/16/2024 2:00,6,10,3664,9534,16,13198,THURSDAY,0,0,13.9,96,20.5,1010.9,Rain
5/16/2024 3:00,1,2,1390,1062,3,2452,THURSDAY,0,0,12.8,96,18.4,1010.5,Rain
5/16/2024 4:00,3,4,1513,1949,7,3462,THURSDAY,0,0,12.8,96,18.4,1010.5,Rain
5/16/2024 5:00,5,15,6676,7908,20,14584,THURSDAY,0,0,12.8,96,18.4,1009.3,Rain
5/16/2024 6:00,24,107,19870,70630,131,90500,THURSDAY,0,0,13.3,97,18.4,1008.4,Rain
5/16/2024 7:00,64,350,68842,233593,414,302435,THURSDAY,0,0,13.3,97,27.7,1008.4,Rain
5/16/2024 8:00,115,768,105162,515365,883,620527,THURSDAY,0,0,12.2,97,25.9,1008.9,Rain
5/16/2024 9:00,77,537,168618,318907,614,487525,THURSDAY,0,0,12.2,97,29.5,1008.7,Rain
5/16/2024 10:00,43,245,59165,149692,288,208857,THURSDAY,0,0,13.3,93,22.3,1009.2,Rain
5/16/2024 11:00,52,259,153809,140980,311,294789,THURSDAY,0,0,13.9,90,25.9,1009.5,Rain
5/16/2024 12:00,50,222,54381,137763,272,192144,THURSDAY,0,0,13.9,90,25.9,1009.5,Rain
5/16/2024 13:00,48,168,39124,97537,216,136661,THURSDAY,0,0,13.9,87,20.5,1009.7,Rain
5/16/2024 14:00,67,261,101944,160976,328,262920,THURSDAY,0,0,13.9,90,27.7,1010.2,Rain
5/16/2024 15:00,125,442,130833,309450,567,440283,THURSDAY,0,0,13.3,90,24.1,1010.9,Rain
5/16/2024 16:00,235,825,394718,580648,1060,975366,THURSDAY,0,0,13.3,90,24.1,1010.9,Rain
5/16/2024 17:00,366,1156,503282,1128099,1522,1631381,THURSDAY,0,0,13.3,93,24.1,1010.9,Rain
5/16/2024 18:00,329,930,489604,742144,1259,1231748,THURSDAY,0,0,13.3,93,22.3,1010.8,Rain
5/16/2024 19:00,267,703,584787,535133,970,1119920,THURSDAY,0,0,15,83,25.9,1010.9,Rain
5/16/2024 20:00,172,479,285498,356225,651,641723,THURSDAY,0,0,15.6,83,22.3,1011.2,Rain
5/16/2024 21:00,146,347,347417,251189,493,598606,THURSDAY,0,0,14.4,81,25.9,1011.9,Rain
5/16/2024 22:00,162,233,257689,164166,395,421855,THURSDAY,0,0,13.9,83,22.3,1012.3,Cloudy
5/16/2024 23:00,64,162,83197,116249,226,199446,THURSDAY,0,0,12.8,87,18.4,1012.9,Cloudy
5/17/2024 0:00,57,73,260306,82849,130,343155,FRIDAY,0,0,12.8,87,18.4,1012.9,Cloudy
5/17/2024 1:00,54,42,60924,63710,96,124634,FRIDAY,0,0,12.8,89,11.2,1013.6,Cloudy
5/17/2024 2:00,17,26,12939,19372,43,32311,FRIDAY,0,0,12.2,90,14.8,1013.9,Cloudy
5/17/2024 3:00,4,7,40586,3367,11,43953,FRIDAY,0,0,12.2,90,13,1013.9,Cloudy
5/17/2024 4:00,4,14,2593,8353,18,10946,FRIDAY,0,0,11.7,93,13,1013.5,Cloudy
5/17/2024 5:00,16,73,12118,49224,89,61342,FRIDAY,0,0,11.7,93,13,1013.5,Fair
5/17/2024 6:00,52,227,84424,163717,279,248141,FRIDAY,0,0,11.1,93,14.8,1013,Cloudy
5/17/2024 7:00,115,507,99412,395566,622,494978,FRIDAY,0,0,11.1,93,14.8,1013.2,Cloudy
5/17/2024 8:00,150,886,250215,625083,1036,875298,FRIDAY,0,0,11.1,93,16.6,1013.4,Cloudy
5/17/2024 9:00,157,634,237438,430994,791,668432,FRIDAY,0,0,11.7,89,14.8,1014.2,Cloudy
5/17/2024 10:00,193,491,346608,351793,684,698401,FRIDAY,0,0,11.7,89,14.8,1014.2,Cloudy
5/17/2024 11:00,209,470,535601,367542,679,903143,FRIDAY,0,0,13.3,84,13,1016.6,Cloudy
5/17/2024 12:00,272,554,451289,394865,826,846154,FRIDAY,0,0,15.6,72,18.4,1016.1,Cloudy
5/17/2024 13:00,336,551,711156,401055,887,1112211,FRIDAY,0,0,17.8,65,18.4,1015.9,Cloudy
5/17/2024 14:00,334,638,605080,599427,972,1204507,FRIDAY,0,0,17.8,65,16.6,1015.3,Cloudy
5/17/2024 15:00,435,691,666626,623435,1126,1290061,FRIDAY,0,0,16.7,70,25.9,1015.3,Cloudy
5/17/2024 16:00,440,960,722988,739302,1400,1462290,FRIDAY,0,0,16.7,70,25.9,1015.3,Cloudy
5/17/2024 17:00,555,1104,931196,929792,1659,1860988,FRIDAY,0,0,17.2,67,24.1,1015.4,Cloudy
5/17/2024 18:00,509,885,857857,676799,1394,1534656,FRIDAY,0,0,17.2,67,24.1,1015.4,Cloudy
5/17/2024 19:00,377,747,553199,756294,1124,1309493,FRIDAY,0,0,15,78,24.1,1015.9,Cloudy
5/17/2024 20:00,231,462,291400,319401,693,610801,FRIDAY,0,0,16.1,67,20.5,1015.9,Cloudy
5/17/2024 21:00,161,329,169677,240823,490,410500,FRIDAY,0,0,15,67,18.4,1015.9,Cloudy
5/17/2024 22:00,217,323,514329,217638,540,731967,FRIDAY,0,0,14.4,78,14.8,1016.1,Cloudy
5/17/2024 23:00,141,228,161411,173136,369,334547,FRIDAY,0,0,14.4,78,14.8,1016.1,Cloudy
5/18/2024 0:00,113,183,314688,177822,296,492510,SATURDAY,1,0,13.9,72,13,1016,Cloudy
5/18/2024 1:00,111,115,320766,91171,226,411937,SATURDAY,1,0,13.9,74,13,1016.3,Cloudy
5/18/2024 2:00,91,81,272668,73375,172,346043,SATURDAY,1,0,12.8,80,16.6,1016,Cloudy
5/18/2024 3:00,16,22,18465,11667,38,30132,SATURDAY,1,0,12.2,83,18.4,1016.2,Cloudy
5/18/2024 4:00,11,17,13905,12062,28,25967,SATURDAY,1,0,12.2,86,14.8,1015.6,Cloudy
5/18/2024 5:00,9,19,17621,12266,28,29887,SATURDAY,1,0,12.2,86,14.8,1015.6,Cloudy
5/18/2024 6:00,33,100,29611,167190,133,196801,SATURDAY,1,0,12.8,83,18.4,1015.4,Cloudy
5/18/2024 7:00,39,150,41618,89907,189,131525,SATURDAY,1,0,12.8,80,14.8,1015.5,Cloudy
5/18/2024 8:00,84,186,113968,210878,270,324846,SATURDAY,1,0,12.8,80,18.4,1015.4,Cloudy
5/18/2024 9:00,170,345,208812,277154,515,485966,SATURDAY,1,0,12.8,80,18.4,1015.4,Cloudy
5/18/2024 10:00,226,459,426502,343429,685,769931,SATURDAY,1,0,12.8,83,16.6,1016.3,Cloudy
5/18/2024 11:00,297,511,589448,424182,808,1013630,SATURDAY,1,0,12.8,83,22.3,1016.5,Cloudy
5/18/2024 12:00,360,544,844926,416923,904,1261849,SATURDAY,1,0,13.3,87,16.6,1016.9,Cloudy
5/18/2024 13:00,324,558,585136,451806,882,1036942,SATURDAY,1,0,13.3,87,18.4,1016.9,Cloudy
5/18/2024 14:00,359,579,648309,483726,938,1132035,SATURDAY,1,0,13.3,87,18.4,1016.9,Cloudy
5/18/2024 15:00,343,584,503097,450322,927,953419,SATURDAY,1,0,13.9,83,22.3,1017.1,Cloudy
5/18/2024 16:00,359,552,824177,394183,911,1218360,SATURDAY,1,0,14.4,84,22.3,1017,Rain
5/18/2024 17:00,180,484,352826,352047,664,704873,SATURDAY,1,0,14.4,84,22.3,1017,Rain
5/18/2024 18:00,190,439,227598,311608,629,539206,SATURDAY,1,0,14.4,81,24.1,1016.6,Rain
5/18/2024 19:00,149,327,160372,323492,476,483864,SATURDAY,1,0,14.4,81,24.1,1016.6,Rain
5/18/2024 20:00,93,221,95364,140889,314,236253,SATURDAY,1,0,13.3,84,24.1,1016.6,Rain
5/18/2024 21:00,49,136,48624,88639,185,137263,SATURDAY,1,0,12.2,93,25.9,1016.6,Rain
5/18/2024 22:00,56,114,93195,70746,170,163941,SATURDAY,1,0,12.2,93,25.9,1016.6,Rain
5/18/2024 23:00,55,84,111769,103642,139,215411,SATURDAY,1,0,12.2,97,18.4,1016.5,Rain
5/19/2024 0:00,38,77,40833,48613,115,89446,SUNDAY,1,0,11.7,96,20.5,1016.2,Rain
5/19/2024 1:00,47,70,72042,50321,117,122363,SUNDAY,1,0,12.2,97,16.6,1016.8,Rain
5/19/2024 2:00,67,32,63090,21217,99,84307,SUNDAY,1,0,12.2,97,16.6,1016.8,Rain
5/19/2024 3:00,14,15,24825,9805,29,34630,SUNDAY,1,0,11.7,96,22.3,1016.5,Rain
5/19/2024 4:00,16,8,14521,4069,24,18590,SUNDAY,1,0,11.7,96,22.3,1015.7,Rain
5/19/2024 5:00,9,15,9373,10101,24,19474,SUNDAY,1,0,11.7,96,22.3,1015.7,Rain
5/19/2024 6:00,24,50,47919,37033,74,84952,SUNDAY,1,0,12.2,97,16.6,1015.5,Cloudy
5/19/2024 7:00,44,89,54591,76427,133,131018,SUNDAY,1,0,11.7,100,16.6,1015.4,Cloudy
5/19/2024 8:00,63,167,106427,127519,230,233946,SUNDAY,1,0,11.7,100,16.6,1015.4,Cloudy
5/19/2024 9:00,111,222,165877,147855,333,313732,SUNDAY,1,0,11.7,100,18.4,1016.1,Cloudy
5/19/2024 10:00,123,284,158527,185077,407,343604,SUNDAY,1,0,11.7,100,18.4,1016.1,Cloudy
5/19/2024 11:00,154,358,217138,295096,512,512234,SUNDAY,1,0,11.7,100,22.3,1016.7,Cloudy
5/19/2024 12:00,180,434,386264,302752,614,689016,SUNDAY,1,0,11.7,100,22.3,1016.7,Cloudy
5/19/2024 13:00,251,489,375848,406848,740,782696,SUNDAY,1,0,11.7,96,20.5,1017,Cloudy
5/19/2024 14:00,269,517,516951,392672,786,909623,SUNDAY,1,0,12.2,97,24.1,1017.2,Cloudy
5/19/2024 15:00,327,572,635086,438021,899,1073107,SUNDAY,1,0,12.8,93,22.3,1017.9,Cloudy
5/19/2024 16:00,299,606,640872,767502,905,1408374,SUNDAY,1,0,12.8,93,20.5,1017.5,Cloudy
5/19/2024 17:00,326,565,668688,512618,891,1181306,SUNDAY,1,0,13.3,87,16.6,1017.3,Cloudy
5/19/2024 18:00,205,526,223893,372683,731,596576,SUNDAY,1,0,13.3,87,16.6,1017.3,Cloudy
5/19/2024 19:00,139,320,282870,218643,459,501513,SUNDAY,1,0,13.3,90,16.6,1016.8,Cloudy
5/19/2024 20:00,108,300,142418,219072,408,361490,SUNDAY,1,0,12.8,89,22.3,1017,Cloudy
5/19/2024 21:00,84,230,111007,155655,314,266662,SUNDAY,1,0,12.8,89,22.3,1017,Cloudy
5/19/2024 22:00,102,187,168775,224664,289,393439,SUNDAY,1,0,11.1,97,16.6,1017.7,Cloudy
5/19/2024 23:00,60,99,232044,63206,159,295250,SUNDAY,1,0,11.1,97,16.6,1017.7,Cloudy
5/20/2024 0:00,33,57,43356,38258,90,81614,MONDAY,0,0,11.1,97,11.2,1017.9,Cloudy
5/20/2024 1:00,32,44,32079,31351,76,63430,MONDAY,0,0,11.1,93,9.4,1018.5,Cloudy
5/20/2024 2:00,15,21,13306,14621,36,27927,MONDAY,0,0,11.1,93,5.4,1018.1,Cloudy
5/20/2024 3:00,5,13,4089,8855,18,12944,MONDAY,0,0,11.1,93,5.4,1018.1,Cloudy
5/20/2024 4:00,10,17,43768,35694,27,79462,MONDAY,0,0,11.1,93,5.4,1017.8,Cloudy
5/20/2024 5:00,20,66,102764,52124,86,154888,MONDAY,0,0,11.1,93,9.4,1017.8,Cloudy
5/20/2024 6:00,45,257,36772,186185,302,222957,MONDAY,0,0,11.1,89,11.2,1017.2,Cloudy
5/20/2024 7:00,88,584,79031,429768,672,508799,MONDAY,0,0,11.1,89,9.4,1017.3,Cloudy
5/20/2024 8:00,175,1100,175227,785339,1275,960566,MONDAY,0,0,11.1,89,9.4,1017.5,Cloudy
5/20/2024 9:00,121,595,233747,396141,716,629888,MONDAY,0,0,11.1,89,9.4,1017.5,Cloudy
5/20/2024 10:00,132,404,257855,276001,536,533856,MONDAY,0,0,12.2,90,9.4,1017.8,Cloudy
5/20/2024 11:00,141,392,202570,265033,533,467603,MONDAY,0,0,13.9,83,9.4,1018.1,Cloudy
5/20/2024 12:00,183,477,399267,320613,660,719880,MONDAY,0,0,14.4,81,13,1018.3,Cloudy
5/20/2024 13:00,213,438,472569,406200,651,878769,MONDAY,0,0,14.4,81,13,1018.3,Cloudy
5/20/2024 14:00,271,494,475141,447286,765,922427,MONDAY,0,0,13.9,83,14.8,1018.2,Cloudy
5/20/2024 15:00,316,600,557951,528720,916,1086671,MONDAY,0,0,14.4,81,11.2,1018.5,Cloudy
5/20/2024 16:00,365,958,736031,794845,1323,1530876,MONDAY,0,0,14.4,84,16.6,1018.3,Cloudy
5/20/2024 17:00,459,1301,570075,1034611,1760,1604686,MONDAY,0,0,15.6,80,14.8,1017.9,Cloudy
5/20/2024 18:00,435,1017,755164,774639,1452,1529803,MONDAY,0,0,15.6,80,14.8,1017.9,Cloudy
5/20/2024 19:00,276,759,390148,592902,1035,983050,MONDAY,0,0,14.4,84,16.6,1017.4,Cloudy
5/20/2024 20:00,152,449,313770,322649,601,636419,MONDAY,0,0,13.3,84,16.6,1016.8,Cloudy
5/20/2024 21:00,127,313,140411,214261,440,354672,MONDAY,0,0,13.3,84,14.8,1016.6,Cloudy
5/20/2024 22:00,83,203,173727,155376,286,329103,MONDAY,0,0,13.3,84,16.6,1016.2,Cloudy
5/20/2024 23:00,52,148,54815,101254,200,156069,MONDAY,0,0,12.2,90,13,1016,Cloudy
5/21/2024 0:00,46,53,84013,73400,99,157413,TUESDAY,0,0,13,89,9,1016,Cloudy
5/21/2024 1:00,17,35,14323,21968,52,36291,TUESDAY,0,0,12.8,89,11.2,1016.6,Cloudy
5/21/2024 2:00,8,11,14535,5929,19,20464,TUESDAY,0,0,12.8,89,9.4,1016.6,Fair
5/21/2024 3:00,6,12,9218,10463,18,19681,TUESDAY,0,0,12.8,89,11.2,1016.2,Fair
5/21/2024 4:00,2,24,724,14707,26,15431,TUESDAY,0,0,12,93,7,1016,Fair
5/21/2024 5:00,22,100,65671,75413,122,141084,TUESDAY,0,0,12.2,93,13,1015.3,Cloudy
5/21/2024 6:00,62,326,76710,291748,388,368458,TUESDAY,0,0,11.7,96,13,1015,Cloudy
5/21/2024 7:00,170,762,270423,638750,932,909173,TUESDAY,0,0,12,96,11,1015,Cloudy
5/21/2024 8:00,261,1297,233833,1120431,1558,1354264,TUESDAY,0,0,11.7,96,14.8,1015,Cloudy
5/21/2024 9:00,151,763,191310,544505,914,735815,TUESDAY,0,0,12.2,97,11.2,1015.1,Cloudy
5/21/2024 10:00,177,447,263579,330694,624,594273,TUESDAY,0,0,13.3,93,11.2,1015.2,Cloudy
5/21/2024 11:00,181,411,401509,287540,592,689049,TUESDAY,0,0,14.4,90,13,1015.2,Cloudy
5/21/2024 12:00,215,510,374713,365290,725,740003,TUESDAY,0,0,18.3,73,13,1015.1,Cloudy
5/21/2024 13:00,215,503,410985,413270,718,824255,TUESDAY,0,0,21,68,7,1015,Cloudy
5/21/2024 14:00,271,508,404096,374009,779,778105,TUESDAY,0,0,22.2,68,14.8,1014.4,Cloudy
5/21/2024 15:00,342,703,583805,555790,1045,1139595,TUESDAY,0,0,22.8,66,14.8,1014,Cloudy
5/21/2024 16:00,487,1114,723134,921312,1601,1644446,TUESDAY,0,0,22,68,13,1013.3,Cloudy
5/21/2024 17:00,617,1500,848390,1394320,2117,2242710,TUESDAY,0,0,21.6,65,18.5,1013.6,Cloudy
5/21/2024 18:00,579,1214,1097116,1028603,1793,2125719,TUESDAY,0,0,25,62,16.6,1011.9,Cloudy
5/21/2024 19:00,419,875,787768,739413,1294,1527181,TUESDAY,0,0,28.9,49,18.4,1011.5,Cloudy
5/21/2024 20:00,290,630,466081,486458,920,952539,TUESDAY,0,0,27.2,57,18.4,1011.5,Cloudy
5/21/2024 21:00,210,424,344311,338048,634,682359,TUESDAY,0,0,26.1,58,18.4,1011.5,Cloudy
5/21/2024 22:00,109,236,222747,205823,345,428570,TUESDAY,0,0,24,60,22,1012,Cloudy
5/21/2024 23:00,136,253,125591,187619,389,313210,TUESDAY,0,0,22.2,66,16.6,1012.6,Cloudy
5/22/2024 0:00,66,73,121705,75555,139,197260,WEDNESDAY,0,0,22,64,17,1014,Cloudy
5/22/2024 1:00,23,49,18178,25869,72,44047,WEDNESDAY,0,0,21.1,68,11.2,1013.6,Cloudy
5/22/2024 2:00,8,18,8269,13473,26,21742,WEDNESDAY,0,0,20,70,20,1013,Cloudy
5/22/2024 3:00,11,11,10111,14182,22,24293,WEDNESDAY,0,0,18,78,17,1014,Cloudy
5/22/2024 4:00,3,20,2190,17918,23,20108,WEDNESDAY,0,0,17.2,81,16.6,1013.2,Fair
5/22/2024 5:00,21,111,14370,65633,132,80003,WEDNESDAY,0,0,17.2,84,5.4,1013,Cloudy
5/22/2024 6:00,75,310,103261,222412,385,325673,WEDNESDAY,0,0,18,81,13,1013,Cloudy
5/22/2024 7:00,175,705,171737,532610,880,704347,WEDNESDAY,0,0,17.8,84,14.8,1012.8,Fair
5/22/2024 8:00,232,1223,333038,933918,1455,1266956,WEDNESDAY,0,0,17,87,15,1013,Fair
5/22/2024 9:00,186,777,524465,526261,963,1050726,WEDNESDAY,0,0,16.1,90,13,1013.7,Fair
5/22/2024 10:00,126,474,198211,346663,600,544874,WEDNESDAY,0,0,17.2,84,9.4,1014.5,Fair
5/22/2024 11:00,195,484,416983,343427,679,760410,WEDNESDAY,0,0,20.6,73,13,1014.3,Fair
5/22/2024 12:00,209,498,336962,354194,707,691156,WEDNESDAY,0,0,24.4,60,14.8,1013.8,Fair
5/22/2024 13:00,196,515,430696,372334,711,803030,WEDNESDAY,0,0,27,52,22,1014,Fair
5/22/2024 14:00,260,492,506819,434629,752,941448,WEDNESDAY,0,0,28.3,48,25.9,1013.1,Fair
5/22/2024 15:00,286,715,600693,601893,1001,1202586,WEDNESDAY,0,0,29.4,43,24.1,1012.5,Fair
5/22/2024 16:00,404,1043,612409,850525,1447,1462934,WEDNESDAY,0,0,30,39,27.7,1011.6,Fair
5/22/2024 17:00,627,1498,1264340,1265360,2125,2529700,WEDNESDAY,0,0,31,35,20,1011,Fair
5/22/2024 18:00,603,1210,1045729,1051811,1813,2097540,WEDNESDAY,0,0,31.1,35,22.3,1010.3,Fair
5/22/2024 19:00,441,840,710082,775286,1281,1485368,WEDNESDAY,0,0,30,45,20.5,1009.9,Fair
5/22/2024 20:00,321,670,664555,577901,991,1242456,WEDNESDAY,0,0,28.3,51,25.9,1009.6,Fair
5/22/2024 21:00,211,451,356352,378461,662,734813,WEDNESDAY,0,0,27.8,51,29.5,1009.8,Fair
5/22/2024 22:00,122,283,144867,221585,405,366452,WEDNESDAY,0,0,25.6,56,27.7,1010,Fair
5/22/2024 23:00,86,156,138523,128462,242,266985,WEDNESDAY,0,0,24,58,26,1011,Fair
5/23/2024 0:00,28,99,29556,71774,127,101330,THURSDAY,0,0,22.2,61,22.3,1010.8,Fair
5/23/2024 1:00,26,39,126631,30164,65,156795,THURSDAY,0,0,21.7,63,20.5,1011,Fair
5/23/2024 2:00,14,22,12756,17412,36,30168,THURSDAY,0,0,22,61,28,1011,Fair
5/23/2024 3:00,16,16,41968,9650,32,51618,THURSDAY,0,0,21,68,22,1011,Fair
5/23/2024 4:00,12,16,14882,5827,28,20709,THURSDAY,0,0,20,70,22.3,1010.4,Fair
5/23/2024 5:00,33,103,27927,68840,136,96767,THURSDAY,0,0,19.4,73,18.4,1010.3,Fair
5/23/2024 6:00,87,298,76711,195936,385,272647,THURSDAY,0,0,18.9,75,18.4,1010.2,Fair
5/23/2024 7:00,134,660,318771,480211,794,798982,THURSDAY,0,0,18.3,78,13,1009.9,Fair
5/23/2024 8:00,243,1120,261121,847455,1363,1108576,THURSDAY,0,0,18.3,81,14.8,1009.7,Cloudy
5/23/2024 9:00,167,746,302380,512722,913,815102,THURSDAY,0,0,19,79,11,1010,Cloudy
5/23/2024 10:00,142,415,181361,292057,557,473418,THURSDAY,0,0,20,76,18.4,1010,Cloudy
5/23/2024 11:00,147,456,251340,330762,603,582102,THURSDAY,0,0,21.1,76,11.2,1009.7,Cloudy
5/23/2024 12:00,91,196,69417,212418,287,281835,THURSDAY,0,0,22,76,15,1010,Cloudy
5/23/2024 13:00,27,124,24959,72146,151,97105,THURSDAY,0,0,23,73,17,1010,Cloudy
5/23/2024 14:00,113,337,155020,231824,450,386844,THURSDAY,0,0,23.3,76,18.4,1009.5,Cloudy
5/23/2024 15:00,224,593,315946,468691,817,784637,THURSDAY,0,0,25,71,19,1009,Cloudy
5/23/2024 16:00,350,979,461756,812907,1329,1274663,THURSDAY,0,0,23.3,82,24.1,1010,Cloudy
5/23/2024 17:00,539,1364,852333,1224297,1903,2076630,THURSDAY,0,0,20,90,27.7,1010.2,Cloudy
5/23/2024 18:00,540,1075,896325,902124,1615,1798449,THURSDAY,0,0,18,93,24,1007,Cloudy
5/23/2024 19:00,444,783,580306,631914,1227,1212220,THURSDAY,0,0,22.8,84,0,1008.7,Cloudy
5/23/2024 20:00,265,601,517857,465415,866,983272,THURSDAY,0,0,23.9,74,16.6,1008.1,Cloudy
5/23/2024 21:00,221,399,452440,355580,620,808020,THURSDAY,0,0,25,64,24.1,1007.5,Cloudy
5/23/2024 22:00,206,319,260274,247122,525,507396,THURSDAY,0,0,25,69,24,1008,Cloudy
5/23/2024 23:00,128,192,256014,147215,320,403229,THURSDAY,0,0,23.9,74,20.5,1007.8,Cloudy
5/24/2024 0:00,82,99,132003,76746,181,208749,FRIDAY,0,0,23.3,74,18.4,1008,Cloudy
5/24/2024 1:00,53,45,82935,30814,98,113749,FRIDAY,0,0,23.9,64,13,1009,Cloudy
5/24/2024 2:00,23,25,31969,18128,48,50097,FRIDAY,0,0,23.3,40,18.4,1009,Cloudy
5/24/2024 3:00,16,11,28398,9810,27,38208,FRIDAY,0,0,23,41,17,1010,Cloudy
5/24/2024 4:00,8,17,7444,13816,25,21260,FRIDAY,0,0,21,47,13,1010,Fair
5/24/2024 5:00,24,81,27482,47096,105,74578,FRIDAY,0,0,20,49,11.2,1009.6,Fair
5/24/2024 6:00,71,236,60581,218883,307,279464,FRIDAY,0,0,18.3,56,7.6,1009.6,Fair
5/24/2024 7:00,105,448,118983,443340,553,562323,FRIDAY,0,0,16,72,13,1010,Fair
5/24/2024 8:00,195,782,322828,577690,977,900518,FRIDAY,0,0,16.7,67,7.6,1009.6,Fair
5/24/2024 9:00,190,603,221075,432221,793,653296,FRIDAY,0,0,18.3,61,11.2,1010,Fair
5/24/2024 10:00,245,465,530216,338448,710,868664,FRIDAY,0,0,20,55,14.8,1010.1,Fair
5/24/2024 11:00,269,457,487661,443967,726,931628,FRIDAY,0,0,21.7,49,13,1010.1,Fair
5/24/2024 12:00,308,560,552589,492960,868,1045549,FRIDAY,0,0,23.3,41,13,1009.9,Fair
5/24/2024 13:00,396,555,1010647,404379,951,1415026,FRIDAY,0,0,25,40,17,1010,Fair
5/24/2024 14:00,414,608,859826,453489,1022,1313315,FRIDAY,0,0,26.1,35,24.1,1008.5,Fair
5/24/2024 15:00,488,721,911838,579584,1209,1491422,FRIDAY,0,0,27.2,28,25.9,1007.6,Fair
5/24/2024 16:00,481,866,752576,744898,1347,1497474,FRIDAY,0,0,28,27,32,1007,Fair
5/24/2024 17:00,556,1016,894495,943465,1572,1837960,FRIDAY,0,0,28.3,24,33,1006.3,Fair
5/24/2024 18:00,579,796,1201574,684201,1375,1885775,FRIDAY,0,0,28.9,28,27.7,1005.7,Fair
5/24/2024 19:00,437,649,789000,588332,1086,1377332,FRIDAY,0,0,29,26,30,1005,Fair
5/24/2024 20:00,356,486,547037,412940,842,959977,FRIDAY,0,0,28.3,26,33,1005.1,Fair
5/24/2024 21:00,315,390,576313,309515,705,885828,FRIDAY,0,0,28.3,28,30,1005.3,Fair
5/24/2024 22:00,419,382,687037,332410,801,1019447,FRIDAY,0,0,29,24,24,1006,Fair
5/24/2024 23:00,264,264,513448,216838,528,730286,FRIDAY,0,0,26.7,28,18.4,1006.3,Fair
5/25/2024 0:00,148,127,536712,97585,275,634297,SATURDAY,1,0,25,30,22,1008,Fair
5/25/2024 1:00,101,87,154554,64684,188,219238,SATURDAY,1,0,24.4,30,28,1008.2,Fair
5/25/2024 2:00,88,69,199831,56360,157,256191,SATURDAY,1,0,23,34,19,1009,Fair
5/25/2024 3:00,16,24,17800,14193,40,31993,SATURDAY,1,0,21.1,42,20.5,1009.3,Fair
5/25/2024 4:00,11,24,6245,16467,35,22712,SATURDAY,1,0,19.4,47,14.8,1010.2,Fair
5/25/2024 5:00,10,27,14751,20745,37,35496,SATURDAY,1,0,17.8,52,13,1010.6,Fair
5/25/2024 6:00,34,95,51274,51870,129,103144,SATURDAY,1,0,17.2,54,11.2,1011.2,Fair
5/25/2024 7:00,74,118,97351,96562,192,193913,SATURDAY,1,0,17,50,15,1011,Fair
5/25/2024 8:00,115,254,326337,194083,369,520420,SATURDAY,1,0,15.6,57,11.2,1011.1,Fair
5/25/2024 9:00,225,387,579338,328458,612,907796,SATURDAY,1,0,15.6,53,7.6,1011.5,Fair
5/25/2024 10:00,388,484,977515,377542,872,1355057,SATURDAY,1,0,16.1,52,14.8,1012.1,Cloudy
5/25/2024 11:00,466,495,1117190,409764,961,1526954,SATURDAY,1,0,17.8,46,11.2,1012.5,Fair
5/25/2024 12:00,574,517,1198573,480800,1091,1679373,SATURDAY,1,0,19,42,9,1013,Fair
5/25/2024 13:00,608,614,1454653,573876,1222,2028529,SATURDAY,1,0,20,39,7.6,1012.3,Fair
5/25/2024 14:00,664,586,1455520,646816,1250,2102336,SATURDAY,1,0,19,44,15,1013,Fair
5/25/2024 15:00,584,607,1451539,610924,1191,2062463,SATURDAY,1,0,19.4,45,17,1012.2,Fair
5/25/2024 16:00,559,565,1057823,625495,1124,1683318,SATURDAY,1,0,21,49,19,1012,Fair
5/25/2024 17:00,527,573,1004502,507321,1100,1511823,SATURDAY,1,0,19,51,20,1011,Fair
5/25/2024 18:00,610,559,1337732,612275,1169,1950007,SATURDAY,1,0,18.9,54,26,1010.5,Fair
5/25/2024 19:00,551,516,1275437,428576,1067,1704013,SATURDAY,1,0,19.4,57,22.3,1010.4,Fair
5/25/2024 20:00,403,404,900352,328060,807,1228412,SATURDAY,1,0,20,55,24,1010.4,Fair
5/25/2024 21:00,251,278,369069,214285,529,583354,SATURDAY,1,0,18.3,70,16.6,1010,Cloudy
5/25/2024 22:00,258,226,686621,225791,484,912412,SATURDAY,1,0,22,53,22,1010,Cloudy
5/25/2024 23:00,253,220,511642,251633,473,763275,SATURDAY,1,0,20,55,18.4,1010.3,Cloudy
5/26/2024 0:00,103,103,165055,77872,206,242927,SUNDAY,1,0,18.9,56,20.5,1010.9,Cloudy
5/26/2024 1:00,138,71,199317,49972,209,249289,SUNDAY,1,0,17.8,58,13,1011.6,Cloudy
5/26/2024 2:00,82,53,248775,40274,135,289049,SUNDAY,1,0,17.2,58,0,1011.7,Cloudy
5/26/2024 3:00,20,20,109856,39266,40,149122,SUNDAY,1,0,17,60,9,1012,Cloudy
5/26/2024 4:00,17,13,333049,13200,30,346249,SUNDAY,1,0,16.1,65,11.2,1011.8,Cloudy
5/26/2024 5:00,12,24,102654,15978,36,118632,SUNDAY,1,0,16.1,67,9.4,1011.5,Cloudy
5/26/2024 6:00,16,31,12758,17983,47,30741,SUNDAY,1,0,16.1,70,11.2,1011.5,Cloudy
5/26/2024 7:00,22,78,43926,49588,100,93514,SUNDAY,1,0,17,63,7,1012,Cloudy
5/26/2024 8:00,86,179,113648,160459,265,274107,SUNDAY,1,0,15.6,83,14.8,1011.5,Cloudy
5/26/2024 9:00,191,271,337800,216311,462,554111,SUNDAY,1,0,16.1,78,7.6,1012,Cloudy
5/26/2024 10:00,339,402,871169,317031,741,1188200,SUNDAY,1,0,16.2,78,7.4,1012.5,Cloudy
5/26/2024 11:00,498,497,1195593,448164,995,1643757,SUNDAY,1,0,16,90,13,1014,Cloudy
5/26/2024 12:00,641,554,1688979,513311,1195,2202290,SUNDAY,1,0,17.2,84,7.6,1013.4,Cloudy
5/26/2024 13:00,680,501,1530695,492763,1181,2023458,SUNDAY,1,0,18.3,84,7.6,1013.7,Cloudy
5/26/2024 14:00,711,607,1638955,592263,1318,2231218,SUNDAY,1,0,19.4,79,11.2,1014,Cloudy
5/26/2024 15:00,695,519,1621964,518863,1214,2140827,SUNDAY,1,0,19.4,79,14.8,1013.9,Fair
5/26/2024 16:00,681,591,1687383,571163,1272,2258546,SUNDAY,1,0,19.4,79,14.8,1013.8,Cloudy
5/26/2024 17:00,629,597,1223746,556171,1226,1779917,SUNDAY,1,0,19,81,19,1014,Cloudy
5/26/2024 18:00,616,586,1173415,536705,1202,1710120,SUNDAY,1,0,19.4,81,16.6,1013.7,Cloudy
5/26/2024 19:00,487,456,1091302,421983,943,1513285,SUNDAY,1,0,19.4,81,16.6,1013.6,Cloudy
5/26/2024 20:00,349,349,813431,347518,698,1160949,SUNDAY,1,0,18.9,81,11.2,1013.9,Cloudy
5/26/2024 21:00,278,257,470571,211561,535,682132,SUNDAY,1,0,17.2,87,13,1014.4,Cloudy
5/26/2024 22:00,314,227,774130,173581,541,947711,SUNDAY,1,0,17,90,13,1015,Cloudy
5/26/2024 23:00,317,181,553991,154282,498,708273,SUNDAY,1,0,16.7,90,7.6,1014.6,Cloudy
5/27/2024 0:00,95,82,132402,68001,177,200403,MONDAY,0,1,17,90,7,1015,Cloudy
5/27/2024 1:00,73,53,101509,55958,126,157467,MONDAY,0,1,17.8,87,5.4,1015.9,Cloudy
5/27/2024 2:00,28,38,32763,28427,66,61190,MONDAY,0,1,18.3,87,5.4,1015.7,Cloudy
5/27/2024 3:00,6,9,4779,10682,15,15461,MONDAY,0,1,17,93,15,1016,Cloudy
5/27/2024 4:00,3,21,2975,21483,24,24458,MONDAY,0,1,17.2,90,9.4,1015.7,Cloudy
5/27/2024 5:00,33,50,36149,44702,83,80851,MONDAY,0,1,17,93,13,1016,Cloudy
5/27/2024 6:00,51,99,71085,74101,150,145186,MONDAY,0,1,16,97,15,1016,Cloudy
5/27/2024 7:00,69,115,136861,91538,184,228399,MONDAY,0,1,15,100,14.8,1015.8,Cloudy
5/27/2024 8:00,96,209,230909,152677,305,383586,MONDAY,0,1,15.6,96,9.4,1015.9,Cloudy
5/27/2024 9:00,148,297,301897,258272,445,560169,MONDAY,0,1,15,100,11.2,1016.5,Cloudy
5/27/2024 10:00,253,339,560243,239173,592,799416,MONDAY,0,1,15,100,16.6,1016.5,Cloudy
5/27/2024 11:00,320,394,597953,326362,714,924315,MONDAY,0,1,15,96,19,1017,Cloudy
5/27/2024 12:00,368,450,965577,474690,818,1440267,MONDAY,0,1,15,100,14.8,1016.4,Cloudy
5/27/2024 13:00,401,506,952136,446966,907,1399102,MONDAY,0,1,15,100,18.4,1015.8,Cloudy
5/27/2024 14:00,449,501,858558,426033,950,1284591,MONDAY,0,1,15.6,100,14.8,1016.1,Cloudy
5/27/2024 15:00,510,543,1133990,404834,1053,1538824,MONDAY,0,1,15.6,100,18.4,1015.2,Cloudy
5/27/2024 16:00,396,580,952951,450947,976,1403898,MONDAY,0,1,16,97,15,1015,Cloudy
5/27/2024 17:00,433,622,863841,503208,1055,1367049,MONDAY,0,1,17.2,93,13,1013.9,Cloudy
5/27/2024 18:00,380,580,670504,510134,960,1180638,MONDAY,0,1,19.4,84,11.2,1012.6,Cloudy
5/27/2024 19:00,233,417,451311,344377,650,795688,MONDAY,0,1,22.2,76,18.4,1011.6,Cloudy
5/27/2024 20:00,225,345,371589,250222,570,621811,MONDAY,0,1,22.8,76,30,1011,Cloudy
5/27/2024 21:00,134,248,148568,180371,382,328939,MONDAY,0,1,23,76,24,1011,Rain
5/27/2024 22:00,70,130,227649,82543,200,310192,MONDAY,0,1,21.1,87,30,1010,Rain
5/27/2024 23:00,6,27,3960,11493,33,15453,MONDAY,0,1,20.6,90,22.3,1008.9,Rain
5/28/2024 0:00,19,29,14911,15044,48,29955,TUESDAY,0,0,20,90,24,1009,Rain
5/28/2024 1:00,6,20,4411,11610,26,16021,TUESDAY,0,0,20,90,18.4,1009,Rain
5/28/2024 2:00,6,11,3360,9272,17,12632,TUESDAY,0,0,20,93,27.7,1007.8,Rain
5/28/2024 3:00,3,4,3124,2847,7,5971,TUESDAY,0,0,19.4,97,22.3,1007.4,Rain
5/28/2024 4:00,7,23,4282,16309,30,20591,TUESDAY,0,0,18.9,96,14.8,1006.5,Rain
5/28/2024 5:00,20,84,17169,54962,104,72131,TUESDAY,0,0,19,96,20,1006,Rain
5/28/2024 6:00,45,281,41885,203515,326,245400,TUESDAY,0,0,18.9,96,16.6,1004.8,Rain
5/28/2024 7:00,135,667,126503,501112,802,627615,TUESDAY,0,0,19,93,15,1005,Rain
5/28/2024 8:00,204,1244,256192,990938,1448,1247130,TUESDAY,0,0,18.9,100,13,1004.7,Rain
5/28/2024 9:00,175,712,208604,549374,887,757978,TUESDAY,0,0,19,97,19,1005,Cloudy
5/28/2024 10:00,165,442,242689,344440,607,587129,TUESDAY,0,0,20,93,14.8,1004.4,Cloudy
5/28/2024 11:00,206,426,459094,357308,632,816402,TUESDAY,0,0,21.1,87,24.1,1004.4,Cloudy
5/28/2024 12:00,225,492,404997,384918,717,789915,TUESDAY,0,0,22,81,22,1005,Cloudy
5/28/2024 13:00,243,467,450929,351518,710,802447,TUESDAY,0,0,22.2,79,16.6,1004,Cloudy
5/28/2024 14:00,288,463,534004,340658,751,874662,TUESDAY,0,0,24.4,71,22.3,1003.9,Cloudy
5/28/2024 15:00,315,661,544043,540448,976,1084491,TUESDAY,0,0,26.1,62,24.1,1003.7,Cloudy
5/28/2024 16:00,430,1082,610666,914376,1512,1525042,TUESDAY,0,0,27,60,32,1004,Cloudy
5/28/2024 17:00,543,1596,703694,1364719,2139,2068413,TUESDAY,0,0,26.7,54,27.7,1003.6,Cloudy
5/28/2024 18:00,495,1185,719048,1078460,1680,1797508,TUESDAY,0,0,26.4,51,22.2,1003.3,Cloudy
5/28/2024 19:00,401,900,680750,784938,1301,1465688,TUESDAY,0,0,28.3,44,22.3,1002.6,Fair
5/28/2024 20:00,300,591,386190,468991,891,855181,TUESDAY,0,0,28,46,22,1003,Fair
5/28/2024 21:00,195,401,215533,321359,596,536892,TUESDAY,0,0,27.2,44,22.3,1003,Fair
5/28/2024 22:00,133,250,164615,182139,383,346754,TUESDAY,0,0,26.7,41,25.9,1003.5,Cloudy
5/28/2024 23:00,79,129,136065,96248,208,232313,TUESDAY,0,0,25.6,43,20.5,1004.2,Cloudy
5/29/2024 0:00,56,81,59783,51289,137,111072,WEDNESDAY,0,0,23.9,48,24.1,1005.6,Fair
5/29/2024 1:00,21,33,23134,19895,54,43029,WEDNESDAY,0,0,23,51,22,1006,Fair
5/29/2024 2:00,12,21,47687,17409,33,65096,WEDNESDAY,0,0,21.7,55,24.1,1006.8,Fair
5/29/2024 3:00,5,9,3899,5299,14,9198,WEDNESDAY,0,0,21,57,19,1007,Fair
5/29/2024 4:00,4,28,5409,21492,32,26901,WEDNESDAY,0,0,20,59,20.5,1007.3,Fair
5/29/2024 5:00,24,103,17434,71408,127,88842,WEDNESDAY,0,0,19,63,16.7,1007.8,Fair
5/29/2024 6:00,73,335,102169,264533,408,366702,WEDNESDAY,0,0,18,68,19,1008,Fair
5/29/2024 7:00,163,766,182287,587855,929,770142,WEDNESDAY,0,0,18,68,20,1009,Fair
5/29/2024 8:00,288,1294,363426,1017895,1582,1381321,WEDNESDAY,0,0,17.2,72,16.6,1009,Fair
5/29/2024 9:00,223,786,375284,624882,1009,1000166,WEDNESDAY,0,0,17.2,72,13,1009.5,Fair
5/29/2024 10:00,145,460,174569,318866,605,493435,WEDNESDAY,0,0,17.8,70,14.8,1009.9,Cloudy
5/29/2024 11:00,220,487,329930,333160,707,663090,WEDNESDAY,0,0,19,59,9,1011,Fair
5/29/2024 12:00,259,523,529099,372683,782,901782,WEDNESDAY,0,0,20.6,57,11.2,1011,Fair
5/29/2024 13:00,252,473,513330,337116,725,850446,WEDNESDAY,0,0,21.7,49,13,1011.3,Fair
5/29/2024 14:00,271,485,575844,361597,756,937441,WEDNESDAY,0,0,22,49,15,1012,Fair
5/29/2024 15:00,321,681,553236,496000,1002,1049236,WEDNESDAY,0,0,22,55,11,1012,Fair
5/29/2024 16:00,466,1099,802384,1008593,1565,1810977,WEDNESDAY,0,0,21.1,55,9.4,1011.8,Fair
5/29/2024 17:00,629,1523,918297,1475660,2152,2393957,WEDNESDAY,0,0,23.3,45,7.6,1011.4,Fair
5/29/2024 18:00,533,1202,877546,1060325,1735,1937871,WEDNESDAY,0,0,22.9,43,18.4,1011.4,Fair
5/29/2024 19:00,429,792,667954,717861,1221,1385815,WEDNESDAY,0,0,20,65,18.4,1010.9,Fair
5/29/2024 20:00,311,581,526953,456368,892,983321,WEDNESDAY,0,0,19,68,17,1011,Fair
5/29/2024 21:00,194,407,319084,310632,601,629716,WEDNESDAY,0,0,20,63,20.5,1010.6,Fair
5/29/2024 22:00,123,267,138885,221849,390,360734,WEDNESDAY,0,0,19.4,68,14.8,1011.1,Cloudy
5/29/2024 23:00,91,139,173860,151570,230,325430,WEDNESDAY,0,0,18.9,70,11.2,1011.4,Cloudy
5/30/2024 0:00,26,58,28258,47488,84,75746,THURSDAY,0,0,17.2,78,9.4,1011.6,Fair
5/30/2024 1:00,19,36,117530,28586,55,146116,THURSDAY,0,0,16.7,84,9.4,1012,Fair
5/30/2024 2:00,9,13,8909,10996,22,19905,THURSDAY,0,0,16,87,13,1012,Cloudy
5/30/2024 3:00,4,6,5810,6128,10,11938,THURSDAY,0,0,16.1,90,11.2,1012.4,Cloudy
5/30/2024 4:00,6,12,4680,8276,18,12956,THURSDAY,0,0,15.6,90,11.2,1012.3,Cloudy
5/30/2024 5:00,8,33,6699,21408,41,28107,THURSDAY,0,0,15,93,5.4,1012.5,Cloudy
5/30/2024 6:00,21,111,33304,70560,132,103864,THURSDAY,0,0,15,90,9,1012,Rain
5/30/2024 7:00,27,173,50008,117039,200,167047,THURSDAY,0,0,15.6,90,9.4,1011.7,Rain
5/30/2024 8:00,17,205,14425,138399,222,152824,THURSDAY,0,0,15.6,90,5.4,1012,Rain
5/30/2024 9:00,17,91,19975,56523,108,76498,THURSDAY,0,0,14.9,76,13,1012.8,Rain
5/30/2024 10:00,10,76,9616,47782,86,57398,THURSDAY,0,0,13.9,90,16.6,1012,Rain
5/30/2024 11:00,49,228,47427,137817,277,185244,THURSDAY,0,0,13,93,22,1013,Rain
5/30/2024 12:00,45,202,52081,125091,247,177172,THURSDAY,0,0,12.8,93,20.5,1013,Rain
5/30/2024 13:00,88,236,107190,151097,324,258287,THURSDAY,0,0,12,93,20,1014,Rain
5/30/2024 14:00,72,257,78635,192797,329,271432,THURSDAY,0,0,11.7,93,27.7,1014,Rain
5/30/2024 15:00,184,494,213791,359832,678,573623,THURSDAY,0,0,12.8,89,22.3,1013.6,Rain
5/30/2024 16:00,344,891,384699,719880,1235,1104579,THURSDAY,0,0,12.8,93,18.4,1013.5,Rain
5/30/2024 17:00,546,1232,740336,1088960,1778,1829296,THURSDAY,0,0,13,87,24,1014,Rain
5/30/2024 18:00,457,1001,693314,872931,1458,1566245,THURSDAY,0,0,13.3,90,18.4,1014,Rain
5/30/2024 19:00,305,720,475121,747066,1025,1222187,THURSDAY,0,0,14.4,84,24.1,1014,Cloudy
5/30/2024 20:00,259,481,391657,407250,740,798907,THURSDAY,0,0,15.6,75,18.4,1014,Cloudy
5/30/2024 21:00,178,403,339400,473918,581,813318,THURSDAY,0,0,15,67,14.8,1014.4,Cloudy
5/30/2024 22:00,159,283,262118,230148,442,492266,THURSDAY,0,0,14.4,72,9.4,1014.6,Cloudy
5/30/2024 23:00,91,161,166692,116522,252,283214,THURSDAY,0,0,13.9,74,9.4,1015,Cloudy
5/31/2024 0:00,78,88,105982,62274,166,168256,FRIDAY,0,0,12.8,80,7.6,1015.4,Cloudy
